運転手が子供を乗せたベビーカーにバックで突っ込み、走り去る。	運転手が母親と子供を乗せたベビーカーに衝突し、そのまま走り去る。
スペインの王女、歴史的な詐欺事件で証言	スペインの王女、歴史的な詐欺事件で証言
米上院、オバマ大統領が指名した重要控訴裁の候補者を承認	米上院、オバマ大統領が指名した重要控訴裁の候補者を承認
国連人権長官、ムルシ氏拘束でエジプトに圧力をかける	国連人権長官、モルシ氏拘束でエジプトに圧力をかける
米上院、ジャネット・イエレン氏を米連邦準備制度理事会議長に選出	上院、次期連邦準備制度理事会議長にジャネット・イエレンを選出
シリア北部で反体制派が交戦	シリア北部で反体制派が交戦
マヤワティ、カシミール地方に大統領制を要求	マヤワティ氏、ジャンムー・カシミール州の大統領制を要求
ウガンダ大統領、反同性愛法案に署名	ウガンダの大統領、厳しい反同性愛法に署名
タイの抗議デモが過熱し、石や催涙ガスが飛び交う。	タイの抗議デモが過熱し、石や催涙ガスが飛び交う。
ボストン爆破事件の容疑者がバージニア州に埋葬された。	ボストン爆弾の容疑者がヴァージニア州の墓地に埋葬されている。
フィリピンのレストランで爆発、6人死亡	フィリピンのレストランで爆発、6人死亡
中国陸軍新聞、米国のプリズム・プログラムを非難	中国陸軍新聞、米国のプリズム・プログラムを非難
シルヴィオ・ベルルスコーニ、イタリア議会から追放	シルビオ・ベルルスコーニ、国会から追放される
バーレーンの自動車爆発で2人死亡	バーレーンの自動車爆発で2人死亡
ロシアは、ウクライナで権益が攻撃された場合、対応すると警告している。	ロシアは、ウクライナの権益が攻撃された場合、「対応」すると警告している。
ホスニ・ムバラクの再審は6月8日まで延期された。	ムバラク再審は6月に延期された
米無人機攻撃、ワジリスタンで8人死亡	米無人機攻撃、パキスタンで11人死亡
エジプトのデモ隊、内閣の脅しに反し、座り込みを終了させる	エジプトのデモ隊が内閣の脅しに反抗
英国初のサイエントロジー・ウェディングを挙げるカップル誕生	英国初のサイエントロジー・ウェディングを挙げるカップル誕生
ロシア野党指導者自宅軟禁	ロシア野党指導者自宅軟禁
米上院、イエレン氏を連邦準備制度理事会議長に選出	上院、次期連邦準備制度理事会議長にジャネット・イエレンを選出
カタール首長、息子に政権を譲る	カタール首長、息子のタミム氏に政権を譲る
フィリピンの台風による死者は7000人に達するおそれ	フィリピンの台風による死者数が5,000人を超える。
エジプト、大虐殺の後、「怒りの金曜日」に備える	エジプト、流血の弾圧を受け、怒りの金曜日を迎える
レッドソックスがタイガースを5-2で下し、ワールドシリーズ進出を決めた。	レッドソックスがタイガースを破り、ワールドシリーズに進出。
中国、月面に玉兎型ロボット探査機を着陸させる	中国、月面にロボット探査機を着陸させる
ウクライナ議会、大統領を解任	ウクライナ議会、大統領解任を決議
ベネズエラ、選挙が緊迫する中、議員同士が乱闘。	ベネズエラ、選挙をめぐり議員が乱闘。
北朝鮮が南部にいる外国人に警告、避難を勧告	北朝鮮、南部にいる外国人に避難を警告
沈没した韓国フェリーの船長を逮捕	韓国フェリー転覆事故の船長を逮捕
i-5橋の崩落で車とドライバーが川に落下。	橋の崩落で車が川に転落
イスラエル、シリアへの攻撃は武器を狙ったものと確認	イスラエル政府：シリアへの攻撃は武器を対象としていた
シリアでの死者数が10万人を突破しました。	シリアでの死者数は10万人以上
フィリピン警察が反乱軍に襲撃され、7人が死亡。	共産主義者ら、フィリピン警察8人を殺害
エジプト・モルシ氏、脱獄・殺人容疑で裁判に直面 検察当局が発表	エジプトのモルシ氏、脱獄の罪で裁判にかけられる
イラン核協議、3日目に突入	イラン核協議、3日目に突入
陪審員はジョディ・アリアスに死刑を宣告	ジョディ・アリアスに死刑の可能性、陪審員が判断
タイ軍、戒厳令を発令	タイ軍が戒厳令を発令、クーデターは否定
テキサスでジェットコースターに乗っていた女性が死亡	テキサス遊園地のジェットコースターで女性死亡
ノーベル賞作家ドリス・レッシング、94歳で死去	ノーベル賞受賞作家ドリス・レッシング氏死去
台風がフィリピン中部を襲い、100人以上の死者を出した。	台風がフィリピンを直撃し、少なくとも100人が死亡。
チェンナイに郵便局貯金銀行のATMが開店	インド初の郵便局貯金銀行のATMがチェンナイにオープン
イスラエル、12時間の停戦に合意	イスラエル、24時間のガザ休戦に合意
ベネズエラでTwitterがブロックされたとの報告	ベネズエラで画像がブロックされたとツイッターで発表
インドネシア・スマトラ島沖でマグニチュード6.2の地震発生 - USGS	インドネシア島沖でマグニチュード6.9の地震が発生
米最高裁判所、大統領の休会任命権を制限	高等法院、大統領の休会任命権を牽制
英国人スタントマンがウィングスーツの事故で転落死	英国人スタントマンがアルプスでウィングスーツの事故により死亡
ユーロ危機は終わったと、フランスのオランド大統領は述べた。	ユーロ圏の債務危機は終わったとフランス大統領
ジャイプール・リット・フェスティバル討論会	ジャイプール文学祭で「インドに投票させるものは何か？
ホワイトダイヤモンド、香港のオークションで記録更新	ホワイトダイヤモンド、香港のオークションで史上最高値の3400万ドル
中国の衛星が捜索範囲に大きな物体を発見	マレーシア : 中国の人工衛星が海中の物体を発見
ゴアのビル崩壊、死者数15人に	インドの建物崩壊による死者は14人に
パコパコ宗教団体、未成年者の結婚を支持	CIIは未成年者の結婚を支持する
国庫案では所得税が1.5％引き上げられる	国庫、予算で所得税1.5％引き上げを提案
EUの雇用・社会政策担当大臣は、雇用を促進し、社会・経済政策を統合する方法について議論する。	EUの雇用・社会政策担当相、雇用促進戦略について議論へ
ハマース、ヒズボラに対しシリアから戦闘員を引き揚げるよう要請	ハマース、ヒズボラに対しシリアからの軍撤退を要請
米露、シリアの化学兵器に関する協定に合意	中国、シリアの化学兵器に関する米露の合意を歓迎
PsniはRUCの役員を失望させたと法廷に報告された。	13 : 23 Psni「失敗したRUCオフィサーファミリー
警察のヘリコプターがスコットランドのパブに墜落	グラスゴーのバーの上に警察のヘリコプターが墜落。
国連がガザ停戦を要求する中、米国はイスラエルへの圧力を強める	米国と国連は、ガザをめぐるイスラエルへの圧力を強化。
オーストラリア首相、ブラックボックスからの信号であることを「非常に確信する」と発言	豪州首相、音は370便のものであると確信
MT GOX、20万枚の「忘れ去られた」ビットコインの持ち出しを明らかに	MT GOX、「忘れ去られた」20万枚のビットコインを発見
マンデラ氏の病状は「改善」している	マンデラ氏の病状は「過去48時間で悪化」している。
中国の月探査機が月面に着陸	中国、月面にロボット探査機を着陸させる
大学構内で性犯罪を起こした少年（14歳）を逮捕	マンチェスター大学キャンパスで性犯罪が相次ぎ、2人のティーンエイジャーが逮捕される。
フィリップがベルギーの王となる	フィリップが分割ベルギーの王位に就く
インド反腐敗党、ニューデリーで指揮を執る	インドの反腐敗政党がデリーで政権を樹立
スペインで中絶規制の新法が承認される	スペイン政府、人工妊娠中絶の厳しい規制を承認
オバマ大統領、シリアのガス攻撃について調査を指示	国連、シリアのガス攻撃視察を要請
アテネのドイツ大使公邸が銃撃される	アテネのドイツ大使公邸で発砲事件が発生
ウクライナの野党の象徴であるティモシェンコが釈放された。	ウクライナの野党党首、さらなる抗議行動を望む
オクラホマ州、失敗した死刑執行の失敗を検証する	オクラホマ州、死刑執行に失敗した受刑者が心臓発作で死亡
ナポリターノ氏、イタリア大統領に2期目当選	ナポリターノ大統領、2期目の当選を果たす
テキサス州の工場で爆発、100人以上が負傷	テキサス州の肥料工場で爆発、数百人が負傷したとみられる。
国連裁判所、ボスニア・クロアチア人6人を残虐行為で有罪に	国連戦争犯罪裁判所、ボスニア人・クロアチア人6人に有罪判決
デトロイト空港で圧力鍋を持ったサウジアラビア人男性を逮捕	圧力鍋を所持していたサウジアラビアの男を逮捕
北朝鮮、米国民を裁判にかけると発言	北朝鮮、拘束された米国人観光客に裁判を受けさせると発表
タイの抗議運動が激化、暴力沙汰に	タイデモ隊がゼネストを要請
エジプト、95人死亡で非常事態を発令	エジプト、1ヶ月間の非常事態を全国に発表
トレイボンのための正義を求める集会	全米で「トレイボンのための正義」を求める集会が開催されました。
国連、シリアのホムスで女性や子どもの窮状を警告	ユニセフ、ホムスの女性や子どもたちに安全なアクセスの即時提供を要請
レッドフォード、党首選を前にアルバータ州の経済をアピール	レッドフォード、党大会にて指導部見直しに言及
ヘーゲル、デンプシー、国防予算で議会と対立	ヘーゲル、米国防予算の "政治的 "変更を嘆く
ソニー、PC部門を売却し、人員削減へ	ソニー、PC部門を廃止し、大規模な事業再編を実施
カリフォルニア州で男が4人を殺害し、警察が射殺。	警察 : カリフォルニアで銃乱射、6人死亡
韓国、高齢の米国人を強制送還	北朝鮮、拘束された米軍退役軍人を強制送還
マレーシア航空機の行方不明に関する調査結果について、捜索リーダーは注意を促している。	マレーシアの旅客機から電波が届くことを期待している。
マンデラ氏、家族から追悼される スタジアムでの追悼式が計画される	マンデラ氏の遺族、国民と世界の支援に感謝
ジマーマン無罪判決後の抗議行動	ジマーマンに無罪判決
ウクライナ大統領府、危機管理協議で合意に達したと発表	ウクライナのライバルが危機打開のための協定に調印
オバマ大統領、シリアへの限定的軍事行動を検討	オバマ大統領は、シリアに対する軍事行動を促すが、議会の承認を求める予定である。
シリア首相、暗殺未遂を免れる 政権側発表	シリアの首相、暗殺未遂から生還
オバマ大統領、シリア攻撃で譲歩	英国、シリア支援で各国に要請
ヨルダン、国連安全保障理事会のサウジの後任に選出される	ヨルダン、サウジアラビアが拒否した国連安保理の議席に選出される
モルディブで大統領選の投票が開始される。	危機的状況にあるモルディブで新大統領選が実施される
イラクのモスク爆撃で少なくとも18人が死亡	イラクの葬儀で60人以上死亡
G8を控えたベルファストで、警察がデモ隊を取り囲んでいる。	ベルファストで反G8平和的抗議行動を実施
ジョージ・ジマーマン、トレイボン・マーティン殺害で無罪判決	ジョージ・ジマーマン評決でケーブルニュースがトークラジオモードに
ウォーターフォードとダブリンの海岸で10人が救助された。	ダブリン湾でボートが転覆し、6人が救助された。
マンデラ氏、入院3日目を迎える	マンデラ氏、3日目の入院
カイロのムスリム兄弟団事務所で衝突、1人死亡	エジプト : デモ隊がムスリム兄弟団の本部を襲撃
サウジアラビア女性、運転禁止に抗議	サウジアラビアの女性たちが抗議のために運転しても、ほとんど問題はない。
オバマ大統領、オランド大統領、米仏関係の変化を歓迎	オランド、米国訪問のため到着
ロシア議会、プーチンのウクライナでの軍事利用を容認	オバマ大統領、ロシアにウクライナから手を引くよう警告
ネルソン・マンデラ病院、「不正確」とする報告書を発表	ネルソン・マンデラ氏、入院を終え帰国
世界株高、FRBの景気刺激策維持への期待で	FEDは景気刺激策を維持すると予想
制裁戦争に勝者なし	ロシアへの制裁の影響
韓国兵、北朝鮮との国境で仲間5人を殺害し逃走と報道される	韓国兵、仲間を殺して逃亡
ワールドカップ、新スタジアムの死闘に見舞われる	ワールドカップ競技場で作業員が死亡
タタ・ナノをはじめとするインドの小型車、衝突試験に不合格	世界最安値のクルマの衝突試験結果は？
ギリシャがトロイカと合意、救済措置は数日以内に実施される見込み	債務検査官、ギリシャと合意に達する
マリー、77年ぶりのイギリス優勝	マレーがウインブルドンで優勝、英国の77年にわたる苦悩に終止符を打つ
マレーシア航空機がウクライナとロシアの国境で墜落 - ライブ中継	米国：ロシアがウクライナ国境に軍隊を集結させる
ウクライナで勝利を収め、EUに未来を求めることを約束したタイクーン	ウクライナ大統領選の投票所がオープン
シリアによる化学兵器使用の程度を判断するために、私たちは	シリア内戦における化学兵器について、これまでに判明していること
パキスタンの秘密戦争	パキスタン南西部を震源とする新たな大規模地震
シリア、化学兵器の放棄に合意	英国キャメロン首相：シリアとロシアは、化学兵器に関する提案が本物であることを示す必要がある。
ロシアのプーチン大統領は、ウクライナに侵攻する権限があると主張している。	クレムリン：プーチンはまだウクライナでのロシア軍の使用を決定していない。
中国共産党高官、Dprk首脳の特使に会う	北朝鮮指導者が中国に「特使」を送る
トルコ、公園での抗議活動を停止するも、騒動は続く	トルコのエルドアン首相、イスタンブール公園の抗議デモの取り締まりを命じる「義務」を表明
ローマ法王、回勅の草稿で気候変動への行動を呼びかけ	ローマ法王、回勅の草稿で気候変動への行動を促す
シンガポール株、木曜日は0.28％安でスタート	シンガポール株、木曜日は0.19％高でスタート
ジハード・ジョンとは何者なのか？	ジハディ・ジョンとは何者か？'
イラン、IAEA高官が3月の核開発期限を前に会談	イランとIAEAの高官、3月の核開発期限前に会談：イザナミ
10月4日付イラン主要紙見出し	10月19日付イラン各紙の見出し
イラクの首都で爆弾テロ、9人が死亡	イラクで爆弾テロ、19人死亡
米司法長官ホルダが辞任	米司法長官エリック・ホルダーが辞任へ
米国とEU、ロシアに対する制裁を拡大	米EU、ロシアへの制裁を強化
水曜日のための10のこと	木曜日に知っておくべき10のこと
2:30 p.m.（日本時間）のアジアのトップニュース	アジアのトップニュース 1 : 25 p.m.g.m.
水曜日のダウ平均はどうだった？	月曜のダウ平均はどうだった？
ハッジはクレーンの倒壊にもかかわらず実施されると当局が発表した。	ハッジはクレーンの崩壊にもかかわらず実行されます。
米下院共和党、ポール・ライアンを議長に選出	米下院共和党、消極的なライアンを議長候補に指名
アジアのトップニュース @ 4 : 00 p.m. GMT	アジアのトップニュース 8 : 39 a.m.g.t.
シンガポール株式、水曜日は0.83%高でスタート	シンガポール株式、火曜日は0.06％安でスタート
中国国債先物、火曜日は高値で始まる	中国国債先物、水曜日の終値はまちまち。
米司法長官ホルダが辞任	エリック・ホルダー司法長官が辞任へ
9月27日付イラン主要紙見出し	10月19日付イラン各紙の見出し
アッヴィ、税制改正後、550億ドルのシャイアー社との取引に難色を示す	アッヴィ、米国の税制変更を受けて550億ドルのシャイアー社との取引を冷静に判断
中国、台風カルマエギに厳戒態勢	中国、台風24号（カルマエギ）に対して黄色警報を発令
サウジアラビア主導の空爆がイエメンの首都を襲う	イエメンの首都でサウジの空爆、29人が死亡
中央アフリカ共和国の新UniPKO主任に就任	国連、中央アフリカ共和国の平和維持を引き継ぐ
アフガニスタンからの武装勢力の攻撃により、アッパーディール州で4人が死亡。	アフガニスタンからの武装勢力の攻撃により、バロチスタンでFCの兵士が殺害される。
マリ、ジハード主義者のナイトクラブ殺人犯を捜索	マリ、ナイトクラブの殺人犯を追って武装勢力が国連を襲撃
ネパールでマグニチュード7.3の地震が発生	インドネシア沖でマグニチュード6.6の地震が発生
東京株式、米国市場の好調を受け高値でスタート	東京株式は、米国での上昇を引き継いで高く始まります。
イラン議会、核合意案を支持	イラン強硬派、核合意を攻撃
ハワイ、22年ぶりのハリケーンに備える	22年ぶりに接近するハリケーンに備えるハワイ州
イラクの爆弾テロ、少なくとも26人が死亡	イラクの自爆テロ、少なくとも12人が死亡
シエラレオネがエボラ出血熱で閉鎖状態に	シエラレオネ、エボラ出血熱封鎖の最終日を迎える
東京株式、米国市場の好調を受け高値でスタート	東京株式は、米国の好調な業績を受け、高値で始まる。
原油はアジア取引で下落	原油価格はアジア取引で下落
イスラエル軍、ヘブロンでパレスチナ人議員を拘束	イスラエル軍、夜間の逮捕捜査でパレスチナ人2人を拘束
中国南部で交通事故、4人死亡・数人負傷	ライウィンド交通事故、2人死亡・17人負傷
地中海の海上で救助された移民は3,400人以上	地中海の木造船から2,000人以上の移民を救助
ルイス・ハミルトン、ロシアGPでポールポジション獲得	ルイス・ハミルトン、ロシアGPで初優勝
国連安全保障理事会、イエメン特使の最終報告に耳を傾ける	国連安全保障理事会、イエメンのフーシ派に停止を要請...
イスラエル軍が一晩で21人のパレスチナ人を逮捕し、地元住民と衝突。	イスラエル治安部隊、西岸で夜間掃討作戦により8人のパレスチナ人を逮捕
アフガニスタンのテロ攻撃で13人が死亡	アフガニスタンの首都でモスクが襲撃され、6人が死亡。
中国東部で交通事故、4人死亡・3人負傷	イスラエル中部で交通事故、2人死亡・8人負傷
Rev 's Early Reads : 3月2日	rev.' s early reads : sept .3rd , 2015
マーケットライブ：中国データ待ち	マーケットライブ : 中国が足を引っ張る
パレスチナ人、イスラエル警察がエルサレムのアル・アクサで衝突	東エルサレムでイスラエル警察に撃たれたパレスティナ人が死亡
ナイジェリアでボコ・ハラムとみられる自爆テロ、24人が死亡	ナイジェリアでボコ・ハラムとみられる攻撃により数十人が死亡
香港のデモは終わったのか？	英国、香港のデモに懸念
ロシア軍機がシリア国内を空爆	シリアにおけるロシアンルーレット
チュニジア美術館襲撃事件の犯人のCCTV。	チュニスの美術館襲撃で19人死亡
ライブドアブログ：危機的状況にあるウクライナ	ライブブログ : 混乱するイラク
イスラエル警察、エルサレムの聖地でパレスチナのデモ隊と衝突	イスラエル警察、エルサレムでパレスチナ人と衝突
ナイジェリア、大統領選で大接戦	ギニア人、大統領選挙に臨む
プリンス・ウィリアム、日本ツアーでサムライ・ギアを身につける	英国のウィリアム王子、北京に到着
ローマ法王、2人のパレスチナ人を列福	スウェーデン、パレスチナの国家を承認
ロサンゼルスの銃乱射事件で3人死亡、4人負傷	サウジアラビアの銃乱射事件で5人死亡
ミクロネシア副大統領、中国訪問へ	ボリビア副大統領が中国を訪問
イスラム国、米軍人質斬首のビデオを公開	イスラム国、英国の人質に関する2つ目のプロパガンダビデオを投稿
イラン、パキスタンとの協力協定を終了	イランとタジキスタン、協力協定に調印
ティーンエイジャー、エボラ出血熱に否定的	テキサス州の病院職員がエボラ出血熱の陽性反応を示す
テキサス州、シリア難民をめぐり提訴	トルコ ' エクスプロイト ' シリア難民
海外のサイバー攻撃者を対象とした米国の新たな制裁措置について	中国、海外のサイバー攻撃者に対する米国の制裁措置に同意せず
イスラエルによるガザでの空爆で5人が死亡	イラクで武装勢力38人が死亡、衝突と空爆で
ウクライナ東部の炭鉱で爆発事故が発生	ウクライナ東部での停戦にもかかわらず、12人が死亡。
ギリシャ救済の不確実性が世界市場の重荷に	ギリシャ懸念がアジア市場の足を引っ張る
イアン・ペイズリー氏の葬儀がベルファストで行われる。	MH17の犠牲者、リアム・スウィーニー氏の葬儀がニューカッスルで執り行われました。
マンUがエバートンを3-0で破り、プレミアリーグでルーニーが活躍。	プレミアリーグでウェストハムがニューカッスルを2-0で破った。
ユダヤ教強硬派リーダー、エルサレムで撃たれる	イスラエル指導者、エルサレムで冷静さを求める
ワバ氏、NLC新社長に就任	次期大統領待ち
イスラム国との戦いが拡大し、舞台裏の動きが活発化	イスラム国との戦いにおいて、さまざまな進展が報告されている。
エジプト : Ipi、ベルリンで逮捕されたアルジャジーラ記者の釈放を要請	エジプト、アルジャジーラ記者に実刑判決
パレスチナ占領地：イスラエル軍、オプトでパレスチナ人の血を流し続ける	パレスチナ自治区：イスラエル、ガザ停戦協議再開に伴い、安全確保を警告
米国による5回の空爆でイスラム国戦闘員が標的	クルド人、トルコがイスラム国との戦いを妨げていると考える
リビア：国連、リビアの人権侵害について調査を指示	インド最高裁判所、雇用詐欺と死因の調査を命令
台湾沿岸警備隊、南シナ海の緊張高まる中、新型艦を投入	中国軍、南シナ海の緊張の中、手を差し伸べる
ブルンジ警察、デモ隊に催涙ガスを発射	モンテネグロ警察、反対派を鎮圧するため催涙弾を発射
ネパール地震の死者数が7000人を突破	ネパール地震の死者、8000人超に
アシャの両親が引き渡し審問に到着	アシャ・キング氏の両親がスペインの刑務所から解放される
ナイジェリア、エボラ出血熱への対応の遅れを認める	米国、エボラ出血熱の危機への対応を強化
数千人がオーストリアとハンガリーの国境を越える	ロシア人国外脱出者数
クラニツァル、モゼス率いるストークを相手に、土壇場で逆転勝利	ハリー・ケイン、土壇場でトッテナム・ホットスパーに勝ち点1をもたらす
オスカー・ピストリウスに5年の実刑判決	アウシュビッツの帳簿係」に4年の実刑判決
親パレスチナの活動家が国連本部をデモ行進	ガザ封鎖解除のための船団を準備する親パレスチナの活動家たち
ベンゼマ、セックス・テープ事件で起訴の可能性	メネンデス、汚職容疑の可能性
米上院、イラン核見直し法案を前進させることを決定	米科学者ら、イラン核合意を評価
ロシア旅客機墜落事故、224人全員死亡	ロシア旅客機墜落時に検知された熱フラッシュ
政府がFTIIの学生と会談を実施	キャメロン首相、英国の将来についてスタージョン首相と会談へ
LI NAが引退を発表	米上院議員テッド・クルーズ、大統領選への出馬を表明へ
ガナーズ、チャンピオンズリーグで活躍するも敗退	EPLのクラブは、チャンピオンズリーグの苦境を避けるために。
火星に水が存在することを科学者が証明	NASAは火星に水を発見したのか？
イラン大統領、核合意を賞賛	イラン、原発付近のスパイ数人を逮捕
ボコ・ハラム、ナイジェリアの選挙を妨害	プレスはナイジェリア総選挙で一杯です。
南朝鮮、北の会談拒否を遺憾に思う	韓国で14人目の水銀中毒患者が死亡、新たに12人が発症
墜落現場捜索は夜間に中止された	ツール・ド・フランス第15ステージのパックがスタート
世界のエディターがトルコにメディア保護を要請	メディアの自由が危うい、トルコの反乱軍との戦い
オバマ大統領、中国との港湾取引についてターンブル氏に問いただす	スペインの雄牛は7人を殺害する
中国の100万ドル入札は、マレーシアで大きな利益を生むと見られている。	虎視眈々
ヒズボラ、シリアとの国境に集結するカイダを攻撃	ベラルーシ、ウクライナとの国境で警備を強化
韓国、新たに7人のメルス感染者を報告	マース患者と接触した韓国人女性、死亡
オバマ大統領、反ISの国際戦線を呼びかけ	オバマ大統領、山に取り残されたイラク人を救うことを誓う
米軍、シリアとイラクでISに対する空爆を実施と発表	観測所、ロシアによる空爆でシリアで45人死亡と発表
空港でボーイングを3機も捨てたのは誰だ？	レソトで警察が駐屯地を放棄、人命が心配される
北朝鮮、米国民を裁判にかける	北朝鮮に新たな制裁を科す
香港当局、抗議の声が薄れる中、仕事を再開	香港の学生リーダー、抗議活動の撤退を検討
英国エボラ出血熱：エボラ出血熱の疑いのある患者の後、NHSの職員は「パニック」に陥った。	英国、メルス菌の疑いのある2人の患者を調査中と発表
英国指導者、シリアでのISへの空爆を支持すると表明	キプロスがキャメロンのシリア空爆を支持する理由
フィリピンとカナダ、さらなる関係強化を約束	フィリピン、フェリー沈没で100人救助
イスラエル、パレスチナ人をエルサレム旧市街に立ち入らせない	パレスチナとイスラエルの二国間解決策 空のパイ
シークレットサービスのことをどれだけ知っている？	衆参両院議員、シークレットサービスに憤慨
韓国、南との会談に合意	ジョホール州に5人目のスルタンが誕生
ロシアにとって重要なパートナーであるイラン：ノバク氏	イラン、イラクとシリアへの支援を改めて表明
台湾総統、李承晩を弔うため飛行機をチャーター	ポーランド大統領、挑戦者に敗れる
ケリー訪日を前にしたイスラエル人襲撃でパレスチナ人2名が死亡	パレスチナ政府高官、イスラエルの投石法案を非難
トーマス・クック、顧客よりコストを優先させたと非難	フロリダ大学の男子学生が負傷した退役軍人に唾を吐きかけたとして非難されている。
ナレンドラ・モディ氏、チェンナイ洪水訪問の写真を加工した画像が話題に	ナレンドラ・モディ首相、無差別と平等について語る
国連総長、ギニアの平和的な大統領選挙を歓迎	国連事務総長、マリでの平和維持要員に対する攻撃を非難
オバマ大統領、イラン協議再開でサウジの不安をなだめるのに苦慮	ミャンマー、日曜日の投票に向け、有権者リストの確定に苦心
パキスタンの死刑執行が国際的な非難を浴びる	パキスタンはインドによる停戦違反に抗議している。
韓国、メルス感染症の終息を宣言	北朝鮮代表団、南朝鮮当局者と会談
プラナブ、国家による平和への努力の必要性を強調	WTO : インド、先進国の行動に遺憾の意
フォルクスワーゲン、公害問題で赤字に転落	フォルクスワーゲン、ディーゼル車オーナーに「親善の証」。
ケニアでバスが川に転落、豪州人2人が死亡	ドイツで起きた列車事故、2人が死亡に関連するパーマリンク
フランス、同時多発テロ事件でモスク閉鎖、男性を逮捕	ニューデリーの教会でテロ事件発生後、警備が強化された。
エジプトでロシア機が墜落したと報道される。	英国で米軍機が墜落、パイロット死亡
空爆の報復としてエジプト人数十人がリビアのテロリストによって人質に取られた。	エジプト船事故、死者数が増加 ナイル川でさらに遺体発見
大統領、バーレーンへ	習主席：中国、エボラ出血熱対策への支援を継続
中国、インド、二国間関係をさらに強化することを誓う	中国、動揺する株式トレーダーを安心させるために奔走
オバマ大統領は正しい：アフリカにはもっと良いリーダーシップが必要だ	オバマ大統領は中間選挙を待って司法長官を指名する。
プーチン大統領報道官：ドーピング容疑は杞憂に終わったようだ	悪天候の最新情報 : 竜巻によりテキサス州で1名死亡
警察官が精神障害者を殴る映像が公開される	ニューヨークの警官が手斧で攻撃され重傷を負った。
