"彼女を過小評価するのは間違いである。	"過小評価するのは間違いである。
オペレーターの選択肢は残念ながら悲惨で、ほとんどの場合、ラジオチューブに限定されています。	答えは簡単で、競争がないのです。
Googleが遺伝子データの基地であるという事実は、次世代のSFのための良い原料を与えることができます。 コリー・ドクトロウによる有名な小説は、半分オーウェリアン調で、人がGoogleからのデータによってのみ接近できる未来を記述しています。	Googleは遺伝子のデータであるという事実は、SFの次の世代のための良い原料を与えることができます。 有名な、ハーフトーンorwelliensと書いて、小説コーリーdoctorowは、男が唯一のGoogleからのデータを通してとても法外な接近することができる未来を説明した。
そして、おそらく私たちは、自分たちが他のヨーロッパ諸国よりも物価が高いと呼ぶのをやめるでしょう。	そして、おそらく我々は、ヨーロッパの残りの部分よりも高価な呼び出しを継続する。
約18年間、宇宙掘削穴 "ユリシーズ "は、この地域で盗まれています。	スペースシャトル「ユリシーズ」は、約18年間、宇宙を飛行しています。
財団ESELYブダペストalapítvány 、フィアタルbaloldalのグループの要求で - ifjú szocialisták 、財団の順序で法案を設立しているharmadik együtt évezredért 、400万hufのための合計を。	ブダペストのための財団チャンスは、若い左翼 - 若い社会主義者のグループの要求に応じて、第三千年のための財団一緒に、合計400万HUFのための法案の順序を作った。
2週間前に投資銀行リーマンブラザーズの崩壊と、銀行間の充当の配分は再び大幅に一定の、彼らの流動性を蓄積してきた銀行を表明している。	2週間前に投資銀行リーマンブラザーズの崩壊で、銀行間の割り当てが再び大幅に遅れている、銀行は彼らの流動性を蓄積している。
確かに、出発が楽しみです。	確かに、発売が楽しみです。
聯合議員、ジョージ・ブッシュ大統領のプロジェクトへの呼びかけを支持する。	ブッシュ大統領自身、交渉の進展を喜んでいる。
さらに、ナオミの右側に惹かれるのであれば。	" なぜならそれは私を魅了するから "
インタビュー - 血は再び確かなものとなる	インタビュー、du bloodになるコース
我々は常に警戒しなければならない」、dre décaryは続けて、供給の安全性の上に、héma-quebecは適切な供給も提供しなければならないと強調した。	我々は常に警戒する必要があります" 、ストレスの前にdre décaryを継続し、供給のセキュリティは、 héma -ケベック州はまた、適切な供給を提供する必要があります。
これは必ずしも悪いことではないが、もし移動するのであれば、すべてを（レース用の電子チップも含めて）渡されたほうがいい。	これは間違っていないが、彼らはあなたが移動する場合、彼らはあなたを与える場合、それは良いだろう（電子チップショップを含む）。
マルセルは、その優れたコットン、ユニセックスなルックス、特徴的なロゴ、そして最も有名なジャージが首にかけているベルギーの国旗（ほとんど認識できない）により、他のジャージとは一線を画しているのです。	マルセルは、彼の綿優れた、彼の親指unisexeによって、その独特のロゴとベルギーの旗（ほとんど認識可能）で、体のシャツは、首の最もよく知られていることによって、他とは異なります。
と言っています。	と言っています。
評議会議長職のすべての機関への設置は、パレ・シーギで完了しました。	評議会議長のすべての機関への設置は、パレ・チギで完了しました。
一日のうちにポイントを失ったのは、史上最大の出来事だった。	同時に、ヨーロッパでは、危機のグローバルな性質がさらに証明されました。
その可能性については、すでにチェコのすべての携帯電話会社と何度も交渉しています。	問題は、すべてのチェコの携帯電話会社の商法が、そのような再販を禁止していることです。
しかし、携帯電話事業者の態度を考えると、チェコの規制当局の無関心は不愉快です。	それどころか、携帯電話会社はチェコの市場が非常に競争的であることを訴えたがっています。
彼は制御下にある当局に話されていた後、性別は輝き6ヶ月の禁止を課している、フランスからスペインに行くために、その意図。	グリッターがフランス経由でスペインに行くことを当局に話した後、判事は6ヶ月間の禁止令を課した。
彼らはそれについて多くのことを言う、私は知っている、多くのことは真実ではありません。	しかし、それを証明する方法がわからない。
しかし、この金額は一度に支払われるのではなく、分割で支払われなければなりません。	2010年には、それが倍増する可能性があり、全体の年の利息を支払う必要があります。
肝炎の症状は、一般的に、汚染された食品の消費の後に2〜3週間表示され、弱さの悪い状態一般、胃の不調と吐き気を伴う。	肝炎の症状は、一般的に、汚染された食品の消費の2〜3週間後に表示され、一般的に悪い健康、弱さ、胃の不調や吐き気を伴っている。
この文章は、「悪意の不在」で彼と共演した女優のサリー・フィールドが語ったもので、ニューマンがもはやこの世にいないという印象的な考えに直面したアメリカ映画界、そしてアメリカ全体の絶望を物語っている。	この文は、女優のサリーフィールドは、彼と一緒に働いている'悪意の不在 "で、アメリカ映画の絶望を説明し、アメリカは、ニューマンはもはや世界にないことを打つアイデアで直面している。
高速道路のプロジェクトは、イートンビルで最も有名な少女がその魅力を取り戻したときに起こった。	イートンビルで最も有名な少女がその魅力を取り戻したとき、高速道路のプロジェクトは起こったのです。
一部の例外を除き、この通りはいつも同じような外観をしています。	は、いくつかの例外を除いて、通りは常に同じペースを持っています。
これが、より多くのお客様を呼び込むことにつながると考えています。	これは、お客様の視点から最も貢献度の高いものだと考えています。
この作品では、ガルシは賞を取ることを期待していない。	この映画では、GARCIは価格を期待していない。
そのような競合の出現を促すことが何になるのでしょうか？	そのような競合他社を出現させることに何の意味があるのでしょうか？
サッカー - 準決勝でのインパクト	その影響は、準決勝のバンクーバー・ホワイトキャップスで測られるでしょう。
この量は、原子力発電所の生産量の2倍に相当します。	この量は、原子力発電所の生産量の2倍に相当します。
というフレーズは、ナンバープレート上のマジャスクルに刻まれています。	ナンバープレートには大文字で「you don't think」と書かれています。
一方、アントニオ・ダマシオは、原始的な活動から生じる感覚は、大脳皮質の身体感覚の領域と脳のコアで生まれると考えています。	反対は、例えばアントニオダマシオは、原始的な活動から感覚が脳の皮質とコアの身体の感覚の分野で生まれていると信じて、しかし、ジャークpankseepのように、脳のシラバスにもっと焦点を当てています。
機械の画面上で彼らは彼らの文書の有効性についてのすべての情報を見つけるでしょう。	つまり , 装置の画面上に , それは彼らの文書の有効性に関する情報を表示します .
The total immersion in english languageは、授業でほぼ常に英語を使うことに重点を置いています。	調査における英語の使用頻度がほぼ一定であることに着目し、英語によるダンピングの総体。
この記事に存在する写真は、マイクロソフトのレッドモンドに従業員のために予約残りの部屋の一つで、今月初めに撮影されました。	この記事の写真は、今月初め、レッドモンドにあるマイクロソフトの従業員用の部屋の一つで撮影されたものです。
ファッション界で最も権威のある賞	一流ファッションの価格
今日がスタートで、3月で終わり、6月に合計を出します。	今日、私たちは3月に開始されている我々は終わり、6月に我々は合計を学びます。
野党は、結果を考慮して抗議のアクションを提供していません。 それはむしろ有権者に経済改革の必要性についてのメッセージを取得しようとしている。	野党は、結果を考慮して抗議のアクションを提供していません。 それはむしろ有権者に経済改革の必要性について彼のメッセージを取得しようとしている。
それは300度の角度で、すべての方向に見ることができるので、蜂の眼は、重要な役割を果たしている。	それはすべての方向で見ることができるので、蜂の側面への目は、重要な役割を果たしている , 300度で .
本物のパーティーがなければ、誕生日とは言えない。	正真正銘のバースデーパーティーとなるのでしょうか。
正確な数字はありませんが、アルプスの山々を駆け抜け、ビール瓶に身を沈める5万人の観客のことを指しています。	がない正確な数字;私たちは、アルプスとビール、訪問者の10％のニューススタンドで崩壊を通じて途中である50 000について話すことは、この週末にイタリアに来る表現だろう。
ポール・ニューマンもその一人だった。"	ポール・ニューマン ザ・スパンダフル
しかし、私はそう思っていません。	しかし、それを証明する方法がわからない。
「そう、私たちは深刻な問題を抱えているのです。	" 私たちは大きな進歩を遂げました。
電子バウチャーは、首都だけでなく、都市の周辺地域で明日から有効である。	電子バウチャーは、首都だけでなく、明日から有効です , しかし、また、都市の周辺地域 .
グレープフルーツジュース、オレンジジュース、アップルジュースにはご注意ください。	オレンジジュース、および骨への菌の注意。
野党に言わせれば、そんなことはないのだが...。	野党の議員が国会にいるとすれば、それは選挙で選ばれたのではなく、任命されたからである。
彼らのために、彼らは本です - józsefvárosに手形市場、kiskunhalasにfabriquaient切手ながら。	また、切手はキスクンハラスで製造されたものであったが、これらはヨゼフヴァロスの市場で購入した。
このシステムに対する援助の総額は、2つの部分に分けられるべきである。	システムの援助への総額は、2つの部分に分割する必要があります。
誰にも知られないように、ソサエティーワークスチームから受け取った5枚の架空請求書をTMAに提出しました。	そのため、社会事業チームの架空請求が5件、MRIに提示されました。
そのため、議員たちは、ジョージ・ブッシュ大統領のプロジェクトへの呼びかけを拒否した。	聯合議員、ジョージ・ブッシュ大統領のプロジェクトへの呼びかけを支持する。
ゴールとシンプルな方法で、SVハンブルグはリーグ戦の首位に立ちました。	ゴールとシンプルな方法で、SVハンブルグはリーグで1位になりました。
ディエゴ・エル・シガラ、チャノ・ロバト、クリスティーナ・オヨス、エンリケ・モレンテ、エル・レブリハノ、アントニオ・カナレス、ビセンテ・アミーゴなどのフラメンコのスターが、約70人のアーティストを撮影したセレクションに含まれています。	ディエゴ・エル・シガラ、チャノ・ロバト、クリスティーナ・オヨス、エンリケ・モレンテ、エル・レブリハーノ、アントニオ・カナレス、ビセンテ・アミーゴなどのフラメンコの精神を酔わせるスターたちは、約70人のアーティストが撮影した中から選出されています。
いいえ、私はスペイン人ですが、ここに住んで2年になります。	私はスペイン人ですが、2年間ここに住んでいます。
他の多くのポール・ニューマンが歴史に名を残しています。	ポール・ニューマンもその一員でした。"
携帯電話を購入した方が良いということは明らかなようです。	このようなコンセプトが家庭で機能する可能性があるかどうか、言うのは難しい。
あなたは人々の前でtrouves 、時にはあなたが知らない文字の、またはあなたがそれらを写真にするためにわずか数分である。	あなたは、人々の前で自分自身を見つける、時にはあなたが知らない、またはそれらを撮影するためにわずか数分を与える文字の。
もう人質を集めるしかない」と思っていたら、突然、「このサプライズ」が起こった。	人質を回収するにも、もう何も残っていない」、その時、突然、「この驚き」が起こりました。
試験 被験者は、MRIスキャンで30分を費やしている一方、ペイント宗教問題を見ながら、投稿する4つの部分で20ショックを受けている、より一般的な発行するものである。	被験者は30分ほどMRIスキャナーに乗り、宗教画か一般的な絵画を見ながら、4回に分けて20回のショックを受けました。
「人々はゾラに会うのをいつも喜んでいた」と彼は言った。	「私はとても幸せです」と彼は記者団に語った。
このようなコンセプトは、家庭で歩く可能性がある場合は、言うことは困難です。	私にとって、それは私が一日旅行されなければならなかったことは明らかであった。
証人は午後4時30分に、ロックリアは "アクセルの物質に基づいて、ノイズの多くをやって、車のガレージから出ようとすると、後方に数回、彼女は彼のサングラスをroula "と述べた。	目撃者によると、午後4時30分、ロックリアは「アクセルを強く踏み、大きな音を立て、ガレージから出ようとし、何度も後ずさりした。
自殺に追い込まれた父親への虐待	義父の虐待が自殺につながった
トウスさん、恥はこの放棄にあるのであって、他のところにあるのではありません。	恥ずかしながら、トウスさん、それはこの場合であって、他の場所ではありません。
このケースは、彼女の.comに寄せられた多くの告発の一つです。	これは、彼女に対する多くの非難の一つである。
2009年の利益は、今年の9月末から3月末までの7ヶ月をカバーしています。	2009年の利益は、9月の終わりから3月末までの7ヶ月をカバーしています。
目の機能を模倣するために、エンジニアは、レーザー距離計のアイデアを打ち出した。	の肖像画 , カメラや機器の選択のおかげで , 写真の古典を与えられた .
unipol : ローマ裁判所、ダニーロ・コッポラはグロッタフェッラータに残っている。	unipol : ローマ裁判所、ダニーロ・コッポラはグロッタフェッラータに残っている。
このプロセス全体は、ミツバチが他のミツバチを避けるために何をするのかを反映したものでなければなりません。	この全体のプロセスは、蜂が他の蜂を避けるために何をしたかを反映する必要があります。
彼らはある , 確かに , 建設の比較的高いコストの自由 , 運用と保守モバイルネットワーク .	彼らは、確かに , 建設のコストの自由 , 操作とモバイルネットワークを維持する , 比較的高い .
この合意が発表されたとき、人は真に革命的な一歩だと思ったことでしょう。	という合意が発表されたとき、真の革命家ではない。
私たちが最も高価でなくなるとき	最も物価の高い国から脱却するとき
「私は彼女を追悼したかったのです。なぜなら、その時代に大きな影響力を持ちながら、今では誰もその仕事を知らず、取り上げていない女性たちがいるからです」とバヨンは言います。	「私はそれが彼らの時代に巨大な影響力を持っているこれらの女性だと思うので、私は背中にしたかったし、今では誰も知らないと彼の作品を強調し、 "バヨンは言う。
彼らは彼について多くのことを言う、私は知っている、多くのことは真実ではありません。	しかし、私はそう思っていません。
寛大さ、人生への愛は、この俳優の活力ある特徴でした。	寛大さ、人生への愛は、消えた俳優の活気のある特徴です。
そして、ダンサーになったとき、私はお金を払うために自分の道を切り開こうとしていました。	私にとって、それは私が一日旅行されなければならなかったことは明らかであった。
そして、ダンサーになったとき、私はお金を払うために自分の道を切り開こうとしていました。	「しかし、この仕事が危険なものであるという印象を持てば、私は支持します。
マルハナバチの飛行を模倣したインテリジェントカー	ブルドンエミュレートのインテリジェントカー窃盗団
オーランドの開発により、州間高速道路4号線はすでに市の西部にまで達しています。	オーランドの開発は、すでに高速道路4号線を市の西側まで促しています。
マイクロソフトは正しい、その運用システムも重要だが、そのソフトウェアも重要である。	マイクロソフトは正しい、その運用システムは重要性を失っているが、そのソフトウェアも。
サルコジ、漁民の会合で怒る	ニコラス・サルコジは、漁師たちによって地面に降ろされることが予想される。
襟の労働者が起こるために彼らのサンドイッチmatinier商人を買うためにキューに続けて、そしてそれは16hと週の19hの間にタクシーを見つけることは不可能である。	オフィスワーカーは朝のサンドイッチを買うために移動販売車に並び、平日の16時から19時の間はタクシーも拾えない。
我々は、もちろん、マップメモリに直接音楽を作ることができますが、少しカードリーダーは、削減せずに行く知っている、モバイルで使用される寸法小さなメモリカードを与えられた。	もちろん、メモリーカードに直接音楽を録音することもできますが、携帯電話のメモリーカードは小さいので、カードリーダーで対処する方法はあまり知られていません。
選択する方法をアドバイスします。	conseillera , How you choose
七十歳を過ぎたマケイン氏は、外交政策における紛れもない経験を繰り返し強調する一方で、この最初の論争の中心となったこれらの事柄における相手の「素朴さ」を強調している。	septuagénaire mccainは繰り返し、この最初のコンテストの中心部にあったこれらの問題で彼の相手の "ナイーブ "を強調しながら、外交政策における議論の余地のない経験を進めてきました。
あなたは何も達成されません , ので、眠っている , 彼は十分に彼の思考を整理するために認識されていません。	あなたは何も達成しませんが、寝ている間に、それは彼の思考を保持するために認識されていないため。
ロッキー・グラツィアーノは、不良で、苦悩に満ちた、暴力的な、忘れがたい人物で、『Somebody up there likes me』（憎悪の刻印）や、ジェームズ・ディーンのために作られた役で、彼の死後に再開され、1956年にニューマンを本格的に始動させました。	このboxeurロッキーGraziano 、犯罪者、苦悩、暴力、そこに誰かがDrを（憎悪によってマーク）、ロバート-ワイズ、ジェームズ-ディーンのための役割は、彼の死後に再開、1956年に本当にニューマン立ち上げた。
この曲は、カテリーナ・ネーヴズヴィーンコヴァーとアダム・プラチェトカによって歌われます。	この曲は、Katerˇina KneˇzˇínkováとAdam plachetkaによって演奏されています。
そして、私はあなたにその例を示します。	そして、私はあなたにその例を示します。
多くの人にとって、音楽を再生する携帯電話の主な利点は、その価格です。	多くの人にとって、携帯電話の音楽の主な利点は、その価格です。
スーダン兵はこの日曜日、スーダン、チャド、エジプト間の国境地帯で6人の誘拐犯を行い、そのうちの2人を逮捕した。	スーダン兵はこの日曜日、スーダン、チャド、エジプト間の国境地帯で6人の誘拐犯を殺害し、そのうち2人を逮捕した。
その直後、最初は女優に気づかなかった目撃者は、ロッククリアが高速道路の真ん中で停車し、車から降りるのを目撃しました。	その直後、最初は女優を認識していなかった目撃者が、ロッククリアが高速道路の真ん中で逮捕され、彼の車から出ていることを教えてくれました。
1950 年代と 1960 年代の映画私たちまぶしいと私たちのコレクションの多くを聞かせてください。	1950年代と1960年代の映画は私たちを魅了し、私たちの作品の多くはそれに触発されています。
「私は変わった、リスクは冒したくない」。	「しかし、この仕事が危険なものであるという印象を持てば、私は支持します。
このような例は、それほど多くありません。	私たちは、その例を探すのにそれほど遠くへ行く必要はありません。
しかし、イルフージアンのゴールテンダーはその喜びを長く味わうことができず、十数分後に更衣室に戻らざるを得なくなり、チームメイトが一人少なくなってしまったのだ。	しかし、buteur illhousiensは、長い彼の幸せを楽しむことができないだろうし、更衣室に十数分後に戻り、デジタル劣等感でそのcoequipiersを残すことを余儀なくされます。
この方が、まだ体力が必要なので。	それは、例えば、彼らはまだ力を必要とする方が良いです。
右翼陣営は無傷だが、党内で有権者の意識が高まり、批判的で頑固になっただけである。	右翼陣営はそのまま、有権者がより意識し、より批判的でより頑固になっている唯一の党である。
マイクロソフトがバーチャル ( 参照 ) を募集しています。	マイクロソフトでは、受付担当（バーチャル）を募集しています。
他の研究 - カリフォルニア大学、バークレー校は、新しい接着剤で研究していることも主張している。	もう一つの研究-カリフォルニア大学バークレー校、そしてそれはまた、新しい削除のための検索で。
タイ当局に入国審査で止められ、結局、香港に行くことになった。	当局のthaiiはパスポートコントロール、および最終的に、それは香港をbloquèrent。
専門家は、技術はまだ初期段階にあると言う , 海洋エネルギーは、環境への影響についての懸念を払拭するという事実から .	専門家は、それがまだ初期段階にある技術であると言う , 海洋エネルギーは、その環境への影響についての不安を払拭していないという事実から .
国民は、グーグルがその本質を明らかにするときを、隠すことなく待っているのです。	国民は、Googleがその本質を明らかにするとき、本当に隠れていることなく、期待しています。
原油価格は7％下落し、1バレル99.80ドル。今朝の販売中にニューヨーク商業取引所。	原油の先物は、7％減の$ 99.80バレルに。 ニューヨーク商品取引所 , 今朝の売上高で .
ポソブランコのネズミを台無しにする悪いタイミング	悪天候のためポソブランコで開催されたフェアが台無しに。
.人のサインは通りを示す.	.道路を示す標識がない.
というのも、そうするとブロックが出来てしまうので、同じベンチに黄色いキャップを置くのではなく、ホールに分散させなければならないのです!'	前にではなく、それ以外の場合はブロック、および同じベンチ上のすべての黄色のキャップは、我々は、チャンバーでそれらを配布する必要があります'
ワルシャワ証券取引所、プラハ証券取引所の買収を提案	この除外の原因は、ワルシャワの証券取引所が国によって所有されていることです。
壁の上を歩く超大型巨人	壁の上を歩くための瞬間接着剤 .
をサポートするためには、年間1600万から1800万が必要です。	をサポートするために、それは年間16〜1800万でなければなりません。
しかし、コースが始まる前に、それは私が表示するためだった。	私にとって、それは私が一日旅行されなければならなかったことは明らかであった。
つまり、しかしコバレフに勝利したのです。	つまり、コバレフの勝利のゴール。
バイエルン州議会での選挙が終わった今、バイエルン州とバーデン＝ヴッテンベルク州の銀行との連合が先決だ。	バイエルン州議会の選挙が終わった今、バイエルン州とバーデン＝ヴッテンベルク州の銀行との合併が間もなく実現するかもしれませんね。
これが、より多くのお客様を呼び込むことにつながると考えています。	この方が、まだ体力が必要なので。
カメラとフォームや顔の認識のシステムでは、この" 見る "は、彼らがいる場所、どのように多くの人々を知ることができます - 彼らは位置を占めるものを覚えて含む - と聞いて、彼らの会話のキーワードを聞く。	カメラと顔認識システムで、この「受付係」は、その場所に何人いるか、誰がいるか、どのポストにいるか、会話のキーワードを聞き取ることができます。
イタリア人の週末」として知られるビール祭りの2週目の週末です。	ビール祭りの第2週目の週末は、イタリアの週末としても知られています。
1998年9月28日に設立されて以来、ヘマ・ケベックは予防原則を適用しています。	このエピソードは、適用された予防原則が理にかなっていることを示しています。"
ポーランドのサッカーリーグpzpnの理事会は、多くの不祥事の後、国立オリンピック委員会によって中断され、ロバート-ザウロッキ、独立した管理者に置き換えられました。	ポーランドのサッカーリーグ pzpn の方向は、国立オリンピック委員会によって多くの不祥事の後に中断され、ロバートザウロッキ、管理者独立に置き換えられました。
ボーダフォンは、むしろ自社の3Gライセンスに対する要求のパフォーマンスに注目している。	ボーダフォンは、むしろ自社の3G免許の取得に注力しています。
しかし、携帯電話事業者の態度を考えると、チェコの規制当局の無関心は不愉快です。	問題は、すべての携帯電話事業者のチェコの貿易は、このような転売を禁止していることです。
チェコのどの事業者も、このような市場において支配的な地位を占めていない。	問題は、すべての携帯電話事業者のチェコの貿易は、このような転売を禁止していることです。
特に、サービス提供の観点からは、比較的飽和状態にある。"	回転ドアの選択は、シンボリックな観点からも重要です。"
一騎打ちの心理学：なぜ私たちはもっとお金を使うのか？	一人勝ちの心理学：なぜお金を使うのか？
評議会議長職のすべての機関への設置は、パレ・シーギで完了しました。	2回目の記録更新を祝う会。
自分の車のスイカを打ち上げました。	車からスイカを発射した。
答えは簡単で、競争がないのです。	このような定型的な回答は、オペレーターの代表からすれば、驚くことではありません。
その可能性については、すでにチェコのすべての携帯電話会社と何度も交渉しています。	問題は、すべての携帯電話事業者のチェコの貿易は、このような転売を禁止していることです。
世界第4位の航空機メーカーであるエンブラエル社は、2008年の航空機納入数を215機とする見通しを維持し、同社のフレデリコ・フルーリー・クラド会長に再確認しました。	世界第4位の航空機メーカーであるエンブラエル社は、2008年の航空機納入数を215機とする見通しを維持し、フレデリコ・フルーリー・クラルド会長に再確認しました。
エネルギーが波動になると、大きな波動が発生する。	エネルギーが波動として生まれると、今度は大きな動きとなる。
野党に言わせれば、そんなことはないのだが...。	野党の議員が国会にいるとすれば、それは選挙で選ばれたのではなく、任命されたのである。
紙の生産の価格は、印刷版の活動と変更されていません。	使用方法と将来の所有者の要求の選択。
ナオミは温かい心の持ち主だと言われます。	ナオミが人の中心的な目的であることを人々.
しかし、なんという素晴らしい長距離選手なのでしょう。	しかし、なんという実質的な偉大なアスリートなのでしょうか。
どういう意味？	しかし、それは感情にとってどのような意味を持つのでしょうか？
のベヒーモスを攻撃する。	コロッサスから攻撃へ．
他の事業者もチェコ市場の特殊性に言及しています。	チェコの事業者のいずれも、このような市場で支配的な地位を占めてはいませんでした。
HSV ビート グラッドバッハ 1 : 0	グラッドバッハと戦うHSV 1 : 0
新しい法律はまた、プログラムに参加する企業の経営者のためのいわゆるゴールデンパラシュートを制限しようとして、それは委員会を設立します、これは、資金の監督を確保する。	新しい法律はまた、プログラムに参加する企業の経営者のためのいわゆるゴールデンパラシュートを制限するために提供し、それは委員会を確立し、これは、資金の監督を確保する。
ドライバーは、登録されたバウチャーの有効期限を管理します。	これは、ドライバーが登録されたバウチャーの有効性をテストする方法です。
したがって、ダルtorrioneに対する傍受を命じ、エントリを書く、ですémergée 'ビジネスマンの要件と結婚する意欲、知られているグループを表す、 piromalliに近い、一族の利益に行政の選択を統一する。	ダルトリオーネに対して命じられた傍受を皮切りに、首相は書いている、 "ビジネスマンの要求と結婚する可能性、代表よく知られているグループpiromalliに近い、一族の利益で行政の選択を統一する.
私は、そう信じていますが、最終的にそれは参加し、これらの活動は、多くの共通点を持っています。	しかし、この場合、我々は少なくとも、すべての人間の脳が同じ状況を持っていることを望むことができます。
政府は、ブラッドフォード＆ビングリーズの260万人の預金者を保護するために140億ポンドを提供しました。	ブラッドフォードとビングリーズの住宅ローンが解除されたときに£140億の融資が返済されます。
の実験では、3つのグループが異なる状況で、相手に対して入札を行った。	それらで , パートナーを持つ3つのグループsurenchérissaient , さまざまな状況で .
他の多くのポール・ニューマンが歴史に名を残しています。	ポール・ニューマンもその一人だった。"
2008年上半期の夜行便やホテルは、前年より安価になりました。	また、航空券の価格についても、第1四半期は上昇傾向にありました。
AIGの理事会は日曜の夕方に会合し、可能性のある譲歩を検討したと、ft.	AIGの取締役会は、可能な限り検討するために、日曜日の夕方に会合しました。
将来は期待できるかもしれません。	オバマは、自分が未来だと言っている。
読者は、しかし、簡単に順序を持っているという利点があります。	しかし、mp3プレーヤーは、簡単にコントロールできるという利点があります。
これは、今朝、カラカラ火山の後ろにある新しい本部で行われたローマの未来のための委員会の仕事のために、キャピトルによって設定されたスケジュールです。	それはローマの未来のための委員会の仕事のためにキャピタルの設定されたタイムテーブルである " 資本は、今朝、新しい本社、カラカラ浴場の後ろに行われました。
戦争の終わりに、彼はイギリス人によって捕獲され、地域のホルスタインのキャプチャに裁判所に配置されたときに、ドイツ人の数十は、彼らの学習チェコへの相談だった。	戦争が終わり、イギリス人の捕虜となり、ホルスタイン州の捕虜収容所に入れられたとき、何十人ものドイツ人がチェコ語を学ぶために彼に近づいたのです。
一度にジェット機をマークできるのは、これがベストだった。	ジェッツの1試合での最高得点だった。
答えは簡単で、競争がないのです。	しかし、危機のダイナミクスと予測不可能性の観点から、そこに確実ではありません。
特別検察官ノーラ・ダニー氏は、調査中に警官が尋問者に嘘をついたかどうか、つまり司法妨害をしたかどうかを照会する。	告発者のアドバイザー、ノラ・ダネヒは今、調査中に尋ねられた役員が、調査官に嘘をついたかどうか、妨害と正義を。
トルーロー高等法院は、継娘であるステファニー・ランドルが5歳から7歳の幼少期に、彼が定期的に拘束していたことを明らかにしました。	トゥルーロの高等裁判所は、彼が定期的にその美しい娘、ステファニーランドル、彼の幼年期の間にリンクされている参照してください、5〜7年。
人質解放前の銃撃の状況はまだ不明である：まあ、エジプト治安当局の言葉を借りれば、誘拐犯は誘拐を終わらせる寸前だったが、スーダン軍は誘拐犯のうち6人を駅に叫ぶことなく殺害したのだ。	エジプト治安当局によると、誘拐犯は誘拐を止めようとしていたが、スーダン軍が警告なしに誘拐犯の6人を殺害したという。
しかし、私はそう思っていません。	しかし、私はどのようにショーを知っていない。
最も重要なのは、消費者の意識と、この情報をパブリックドメインとして公開することです。	そして、その情報をパブリックドメイン化することです。
ハイポ・リアル・エステートは今、法律で定められた分数の利息を支払う必要があります。	ハイポ・リアル・エステートは今後、その権利の端数に対して利息を支払わなければならない。
それは、背中に仮説の貧しい人々のために北京のゲームに参加することができますが、彼はベルリンで勝つことを約束し、その第三マラソン、ほぼ5分の彼の個人記録を向上させます。	彼女は背中の痛みのために北京のゲームに参加することができませんでしたが、ベルリンで勝つことを約束し、彼女の3回目のマラソンで約5分自己記録を向上させました。
市場支配的地位の解釈は、多くの論点の1つである。	一日の間に歴史上最大の失点となった。
一日のうちにポイントを失ったのは、史上最大の出来事だった。	「日本でのコース初日。
ihned.czのサーバーで、4つの新バージョンを聴くことができます。	4つの新しいバージョンの国歌を聴く .
オバマは、自分が未来だと言っている。	オバマは、それが未来だと言っている。
このような思考の縞模様の理由は、ライアンの新作「The Women」（不倫者の物語）に対するマスコミの反応にあります。	思考のこのストリップの理由は、彼の新しい映画のためのプレス関係ライアンです" 女性 '-不倫の話をされます。
として、MSジョーンズ、勇気と赤の活気のために低いを持っている教師は、常に彼らの偏狭なコミュニティが理解されていることを恐れている。	イートンビルの多くの人は、真っ赤なものが大好きな勇気あるジョーンズ先生のように、自分たちの偏狭なコミュニティが理解されないことを常に恐れているのです。
輸出向け販売価格は2008年7月時点のものと比べ1.1％上昇し、前年同期のもの と比べ3.9％下落しました。	工業製品輸出販売価格は、2008年7月と比較して1.1％上昇しましたが、前年同期と比較すると3.9％の下落となりました。
その後、ダウ・ジョーンズは少し抜かれた。	その後、ダウ・ジョーンズは少し回復した。
このことは、úohsの代表者たちはよく知っているはずだが、彼らの関心はどうやら別のところにあるようだ。	しかし、義務のコースは、特にうまくいっています。
聯合議員、ジョージ・ブッシュ大統領のプロジェクトへの呼びかけを支持する。	ブッシュ大統領自身は、交渉の進展を喜んでいる。
しかし、私はそう思っていません。	「しかし、この仕事が危険なものであるという印象を持ったら、それを取り除くつもりです。
これらの飲み物は、特に夏に消費されるためdésaltérantesとビタミンが豊富で、いくつかの重要な薬に関連付けられている場合、人気の吸収を変更したり、ケースで削減するために、その有効性は、健康のために同じ重大な結果をもたらす。	これらの飲み物は、彼らはさわやかで、ビタミンが豊富なので、特に夏を消費し、いくつかの重要な薬で撮影した場合、その有効性を変えることができる、吸収や健康への深刻な影響を持つ、ケースに応じて減少させることができます。
火曜日、貿易の開始時に、プラハの証券取引所は、それがほぼ6％を失ったときに、前日の彼の没落でrenoua。	火曜日、貿易の開始と、プラハの証券取引所は、それがほぼ6％を失ったときに、前日のその没落を続けた。
我々は、多くのそのビネットがビネグレットポット、ソース、ビスケットや他の食品を優美にすることができ、貧しい味のプロセスを判断し、冒頭のジョークとはいえ、見てきました。	私たちは、ヴィネグレットポット、ソース、ビスケットや他の食品に彼の顔を見てきました、それはむしろひどい味、最初のジョークであったにもかかわらず。
結果はまだ発表されていませんが、多くの若者がアレクサンドル・ルカシェンコ大統領の権力に反対するデモに参加しました：「独裁者、辞任せよ」。	結果はまだ発表されていないが、多くの若者がアレクサンドル・ルカシェンコ大統領の権力に反対するデモに来た：「独裁者は、辞任」。
チェコの事業者のいずれも、このような市場で支配的な地位を占めてはいませんでした。	問題は、すべての携帯電話事業者のチェコの貿易は、このような転売を禁止していることです。
という疑問が、自然に湧いてきます。	「しかし、この仕事が危険なものであるという印象を持ったら、それを取り除くつもりです。
紙の生産の価格は、印刷版の活動と変更されていません。	2回目の記録更新を祝う会。
これは、2005年のbundestagの選挙で3年間の間に繰り返された 、すなわち、多くの議論のstoiberの時に 。	これは、2005年のbundestagの選挙で3年あると言っている 、すなわち、多くの議論のstoiberの時 。
その後、他の2つの家は、もはやrejoignèrentません。	その後、他の2つの家も同様に対立した。
逆に、携帯電話事業者は、チェコの市場は非常にconcurrenciezされていることを訴えるのが好きです。	しかし、携帯電話事業者の姿勢を考えると、チェコの規制当局の無関心さは気になるところです。
この仕事はまだ始まったばかりで、両国でやるべきことはたくさんあります。	ほとんどの場合、私は日本で何を食べているのか正確にはわかりません。
他の事業者もチェコ市場の特性を参考にしているはずです。	チェコの事業者はいずれも、このような市場において支配的な地位を占めていない。
「私たちは一歩下がる方法を知っている」とマーセル・ジャンセンは言った。	コールズへのパスについて、ファーブルは「自分のエリア外には出ていない」と語っている。
しかし、義務の経過は、特に良好である。	しかし、危機のダイナミクスと予測不可能性の観点から、そこに確実ではありません。
遅かれ早かれ、それは最終的に致命的な事故になる、 "彼は言った、年がある、ty ´ den.cz 。	遅かれ早かれ、それは最終的に致命的な事故になる、 "彼は言った、一年前に、ty ´ den.cz に。
これは、特に、長期債権者が、債権放棄をすべきかどうかという判断に不眠の夜をもたらすはずである。	これは、彼らが彼らのコミットメントから分離すべきかどうかの決定に長期的にはすべての債権者の前に睡眠の夜を予約する必要があります。
私はスペイン人ですが、2年間ここに住んでいます。	ほとんどの場合、私は日本で何を食べているのか正確にはわかりません。
上限賃金は具体的に言及されていません：制限は、財務局が会社にどのような支援を提供するかによります。	賃金の上限は具体的なケースで言及されていませんが、制限は、国庫事務局が会社に援助を提案する方法に依存します。
今日、イートンビルは、フロリダ州の異常である：オーランドの6マイルに、それはいつでもそれが1880年代に27黒人の家族によって設立されたときにあったように、夏の雨の日、小さな後の裏通りとして自分自身を参照してくださいすることができます。	オーランドから6マイル、1880年代に27組の黒人家族によって設立された当時と同じように、夏の雨の後の裏通りのような小さな町です。
しかし、ベルギーのブランドはタンクトップだけを作っているわけではないことに注意してください。	しかし、ベルギーのブランドは、そのタンクトップだけではありませんので、注意してください。
「私は変わった、リスクは冒したくない」。	「しかし、この仕事が危険なものであるという印象を持ったら、それを取り除くつもりです。
将来は期待できるかもしれません。	しかし、もちろんこれは未来の話です。
エゴのない究極の品質.	エゴの少ない、究極の品質表示。
男性または女性の独唱、合唱、楽器演奏の4つのバージョンがあります。	私たちは4つのバージョンを持っている - 歌のソロ男性または女性で、合唱とインストゥルメンタルバージョンとの解釈。
大手の論説委員は、紙の新聞の「殺人者」として多くの人に見られているインターネットへの道を歩んでいます。	大きな家éditricesは、インターネットへの道を動作させる , として多くの人が見て " 殺人者 " 紙の新聞 .
このことは、úohsの代表者たちはよく知っているはずだが、彼らの関心はどうやら別のところにあるようだ。	しかし、義務の経過は、特に良好である。
を参照するには、確かに、 " 我々は戦略的な参照のスケッチを必要とする、または会社やスタンドまだ、私たちの街を許可するために、それが絶対に必要である、改善するために、その将来について考えながら団結の精神は、 " 。	アレマンノによると、確かに、「私たちは、団結の精神でその将来を考えながら、絶対に必要な私たちの街を改善するために、戦略的な参照のスケッチが必要で、確固たるものでも不動でもない。
多くの人にとって、音楽を再生する携帯電話の主な利点は、その価格です。	モバイル格安の場合、彼らは数時間のために音楽を再生するのですか。
地域社会は、高速道路がもたらす破滅的な結果を実証するために、ハーストンを称える祭りを開催し始めた。	コミュニティは、高速道路がもたらす壊滅的な結果を実証するために、ハートン祭りを開催し始めました。
他の事業者もチェコ市場の特性を参考にしているはずです。	チェコの事業者のいずれも、このような市場で支配的な地位を占めてはいませんでした。
オバマ氏のキャンペーンでは、「アフリカ系アメリカ人やラテン系の学生は、白人の学生よりも卒業のチャンスが少ない」と強調されている。「これは本当です。	オバマ氏のキャンペーンでは、「アフリカ系アメリカ人やラテン系の学生は、白人の学生よりも卒業するチャンスが少ない」と強調されています。「これは事実です。
結局、マンガを読めばいいんです、それは私がもう何年も前から好んでいることです。	「しかし、この仕事が危険なものであるという印象を持てば、私は支持します。
土曜日の夜、議員の代表は、政府基金に最終的な形を与えるために、米国財務長官ヘンリー-ポールソンに会った。	土曜日の夕方、立法者の代表は、政府の底を与えるために、米国財務長官ヘンリーポールソン、最終的なフォームをrencontrèrent。
これは、企業が初年度の利益を解決するために£81万を見つける必要があることを意味します。	国庫は、ローンの利益は、£450millionsに2009になると推定している。
cˇtúに責任を負わせるというのは、そうすることによってúohsが手を洗っているということを伝える、かなり一般的な方法です。	仝岑らないでください々は、仝岑らないでください々は、仝岑らないでください々は、仝岑らないでください々は、仝岑らないでください々は、仝岑らないでください々を吭龍する、コミュニケーションにおけるかなりありふれたトリックです。
私にとって、いつかそこに行かなければならないことは明らかでした。	「しかし、この仕事が危険なものであるという印象を持ったら、それを取り除くつもりです。
新バージョンの国歌の4つの功績をご紹介します。	この国歌は、ジル・ベフロフラーヴェク指揮のもと、国立劇場のオーケストラによって再び録音された。
もちろん、通信は、経済競争の観点から、単一の市場であることをcˇtúによって作成された関連市場の分析があります。	もちろん、関連市場の分析は、電気通信は、経済的競争の観点から、単一の市場であることによると、cˇtúによって作成されたです。
オペレーターの選択肢は残念ながら悲惨で、ほとんどの場合、ラジオチューブに限定されています。	答えは簡単で、戦いに参加したい競争の欠如です。
チェコ市場は、他の非常に特殊な市場との比較において、.	他の事業者もチェコ市場の特殊性に言及しています。
それにもかかわらず、イラクはほとんどブッシュの弱点であった。	とにかく、これらの議論にもかかわらず、民主党の勝利のカードはジョージ・ブッシュです。
しかし、危機のダイナミクスと予測不可能性の観点から、そこに確実ではありません。	同時に、ヨーロッパでは、危機のグローバルな性質がさらに証明されました。
しかし、もしそれがポワレを作るために頼まれたのなら、私はいずれにせよやったでしょう。	しかし、もし彼女が梨の木を演じるように言ったなら、私はいずれにせよそれをしたでしょう。
野党に言わせれば、そんなことはないのだが...。	配当が減額されたのは事実です。
ルカに襲われるエレナ、そして抱擁。	エレナ、ルカたちが集まり、マルコが最後の演説をして、攻撃計画を説明する。
私たちは、西側諸国の中で唯一、グアンタナモ強制収容所に囚われた国民を連れ戻していない政府に直面しているのです。	西側諸国の中で唯一、グアンタナモ強制収容所に囚われた国民を連れ戻さなかった政府がここにある。
貿易面では、プラハの証券取引所が下落しました。	火曜日の朝の秋の後、プラハréctifiaの証券取引所は、その損失。
新バージョンの国歌の4つの成果を紹介します。	新チェコ国歌 4つの新バージョン.
月曜日にブルターニュとノルマンディーのいくつかのポートへのアクセスを大幅に中断している漁師の強さのショーと、共和国の大統領は、彼らの代表を満たすために、フィニステールのギルヴィネックの港で火曜日の朝に行くことにしました。	月曜日にブルターニュとノルマンディーのいくつかの港の出入りを激しく妨害した漁師たちの強さに、共和国大統領は火曜日の朝、フィニステールのギルヴィネック港に行き、彼らの代表者に会うことにした。
MDAXでは、アクションのarcandorは、資本の増加の発表後に下落した。	ローマでは、アレマンノが首都の将来のための委員会を立ち上げるよう命じた。
私は、せいぜい「...........................」という素晴らしい家族がいることを嬉しく思っています。	私の作品に出演してくれることになり、とても光栄に思っています」。
28歳の被拘束者であるA.A.J.は、様々な段階を経て拘束されており、今後数時間のうちに裁かれる予定です。	被拘束者、A・A・J（28歳）は、様々な犯罪を犯したとして拘留されており、今後数時間のうちに裁かれる予定です。
他の事業者もチェコ市場の特殊性に言及しています。	逆に、携帯電話事業者は、チェコの市場は非常にconcurrenciezされていることを訴えるのが好きです。
ワルシャワ証券取引所、プラハ証券取引所の買収を提案	貿易の終わりには、負のプラハbasculaの証券取引所
馬車の運転手は急ハンドルを切ってそれを避けようとしたが、それでもローリーの右側をかすめた。	最後のドライバーは、突然の動きでそれを回避しようとしたが、彼は彼の右側で不足した。
この仕事はまだ始まったばかりで、両国でやるべきことはたくさんあります。	そして、おそらく我々は、ヨーロッパの残りの部分よりも高価な呼び出しを継続する。
ルカに襲われるエレナ、そして抱擁。	エレナに、これは初めてです、ルカはすでに3番目か4番目の時間です。
in masi , " 回転ドアの選択は象徴的な観点で重要です。	特に、サービスの提供という観点からは、比較的飽和状態にある。"
彼の連れ子はプリマスに向かった。	その美しいプリマスの娘。
エジプトで誘拐された観光客が解放された	サハラ砂漠で誘拐されたヨーロッパ人観光客は、目に見えて自由になった。
このことは、úohsの代表者は非常によく知っている必要がありますが、彼らの利益は、明らかに他のものです。	もちろん、この計画を疑問視する声もありました。
警察は、車両が低手2マイルを停止するまで、彼らの継続を開始した、ここで2つの乗員が森林面積で逃げるために取った。	警察は追跡を開始し、車両は2マイル先の道路で停止し、そこで2人の乗員が降りて森林地帯に逃げ込みました。
ノーベル経済学賞は、貿易モデルとビジネスの地域化に関する研究で、アメリカのポール・クルーグマンに授与されました。	ノーベル経済学賞は、貿易と企業立地のモデルに関する研究により、アメリカのポール・クルーグマンに授与されました。
紙の生産の価格は、印刷版の活動と変更されていません。	同時に、ヨーロッパでは、危機のグローバルな性質がさらに証明されました。
ワルシャワ証券取引所、プラハ証券取引所の買収を提案	貿易面では、プラハの証券取引所が下落しました。
pca（会社とそこから取られたそのアップルiPodによって使用されるフォーマット）、一方、より少ないコースです。	aac（アップルとそのiPodで使用されているフォーマット）、一方、より少ない電流です。
この仕事はまだ始まったばかりで、両国でやるべきことはたくさんあります。	結局、マンガを読めばいいんです、それは私がもう何年も前から好んでいることです。
