グローバルなオンライン教育は、学習へのアクセスを民主化し、貧困などの社会的悪を克服する鍵である	論説委員：革命が大学を襲う
中国の検閲を受け入れたハリウッド（映画はもっと良くなるのか？）	中国向けハリウッド映画では、官僚が発言権を求めている。
# bloomberg : assault weapon ban tough sell pub. 敵の1人と2人は小市長 : big gulps and # guns .# ocra	ブルームバーグ : アサルト・ウェポン禁止令は厳しい
アフガニスタン情報局で自動車爆弾が爆発、死傷者数は不明 .	アフガニスタン情報機関の外で強力な自動車爆弾が爆発
フェインスタインの銃法案の中身 - # tgdn # pjnet	フェインスタインの法案の中身は？
リンダ・グリーンハウス：ロー対ウェイド裁判は、患者の最善の利益のために行動したために起訴に直面した医師についての裁判である。	オピニオネーター : ロー・ヴァン・ウェイドに関する誤解
北京の汚染に対する特別措置 :	スモッグ雲、北京を覆う
synthax _ terror 2 : :" アメリカン・タリバン " ジョン・ウォーカー・リンド、刑務所でのイスラム教 徒の祈りをめぐる裁判に勝訴	アメリカのタリバン」が集団礼拝の権利を獲得
オプラがランス・アムストロングに聞くべきだった質問	ランス・アームストロングへの難しい質問
cc " : ブラジルのナイトクラブで火災、少なくとも90人が死亡 "	ブラジルのナイトクラブで火災が発生し、数百人が死亡。
泣かない : レッドブリゲードのジャゴフが死ぬ 俺より1歳年上だ、くたばれ。	テロリストのガリナーリ氏が死去、62歳。
カリフォルニアが立ち直るように、知事は高い目標を呼びかけました。	カリフォルニア州知事が推進する大型プロジェクト。
NYTIMES# リーシュマニア症：致死的な寄生虫病の遠く離れた犠牲者に発見された遺伝子の関連性	グローバルアップデート：致死的なリーシュマニア症の犠牲者に遺伝的なつながりが発見される
ブラジルのナイトクラブで火災が発生し、少なくとも245人が死亡しました。	ブラジルのナイトクラブで火災が発生し、多数の死者が出ている。
ということは、ほとんどの会社がそうなのではないでしょうか？	米国人男性が中国に仕事をアウトソース、猫動画でサーフィンを楽しむ
狙いを定める # stopgunviolence # congress # nra	オバマ、銃政策とNRA.
# nra releases target shooting app , hmm wait a sec.	NRA、シューティングゲームに熱視線
手足が折れ、命が引き裂かれた北部の # マリ # アフリカ # 紛争 # 人権	マリで手足が折れ、命が奪われた
AR-15をめぐってゲストを非難	ピアーズ、ゲストがAR-15をめぐって衝突
ノルウェーの北極圏で、トラック1台分の茶色いチーズが6日間もトンネルを塞いでいた。	WORLD BRIEFING｜欧州：ノルウェー：チーズ火災、トンネルを閉鎖
性的虐待は一般的だが、人間にとって一般的な行動の道路範囲に直面する私たちの無能は、ありふれた風景の中で小児性愛者であるように。	オピニオン：ポリプロップでは、ロリコンが見え隠れしている。
ブラジルのナイトクラブで火災が発生し、死者が220人に上ったと当局が発表。	ブラジルのナイトクラブで火災が発生し、数百人が死亡。
( I love him ! ) 私たちがゴスリングに夢中になる10の理由	ゴスロリに飽き足らない理由 ( duh ! )
米国の撤退は、アフガニスタン人にとって「厳しい愛」である。	アフガン軍への米国の「厳しい愛」。
nytimes : 汚染浄化における中国の次のステップについてのアンドリュー・レブキン。	都市のポスト汚染への道筋を描く - 1952年のロンドンから2013年の北京まで
クラレンス・トマス判事、沈黙を破る 表敬訪問で市民の権利を守らないことを伝える。	トーマス司法長官、法廷で沈黙を破る
NATO : シリア国境にミサイル砲台が設置され、望ましくない連鎖が起こる可能性がある。	NATO : シリア国境でパトリオット・ミサイル・バッテリーが運用開始
ボーイング社のドリームライナーはどうしたんだ？「航空会社はさぞかし喜んでいることでしょう。	ドリームライナーはどうしたんだ？
願わくば一緒にいないで」：リチャード・プライヤーとディック・チェイニー、ショータイムのドキュメンタリーの焦点に "	リチャード・プライヤーとディック・チェイニー、ショータイムのドキュメンタリーに登場
今年、私たちは節目を迎えます：私たちが食べる魚の大半は天然ではなく養殖です	養殖魚の一里塚が近づいている
デザイン、デザイン、デザイン。我々は、技術が特別であることの最後尾にいる、？ ジョン前田は言う。	disruptions : ディスラプション : デザインが技術を進化させる
CNNのホームページで興味深い記事がありました。"ミクルソンの税金に関する指摘."	税金についてはミケルソンの言うとおり
vine video may change twitter # in	vineの6秒がTwitterを変えるかもしれない6つの方法
+ 1 mt ?" 私は書くことが嫌いだ・・・一種の恐怖症だ・・・ただ一種の倒錯したマゾヒズムが私をそれにおいておくのだ " スタイロン	♪ Selected letters of William styron ♪
sport : MTランス・アームストロング、ドーピングを告白 次のステップは？ 自転車競技の上層部に対する証言。	アームストロング、ドーピングを認め、サイクリング関係者に証言すると発表
ブルームバーグが10億円を寄付	ブルームバーグ、11億ドルを大学に寄付
米国政府が支援したソマリアでのフランス人人質救出作戦は失敗に終わった。	米国は、ソマリアでの人質救出に失敗したフランスを支援した。
NYTIMES : デリーとアメリカのスチューベンビルはそんなに違うのか？	コラムニスト：デリーとスチューベンビルはそんなに違うのか？
枢機卿マホニー、典礼の乱用者と児童虐待者の盾。 とても悲しいし、イライラする。	マホニー、虐待神父を庇護していたことが文書で明らかに
" テニス : ジョコビッチ、オーストラリアで優勝 zmerphchnews dot com "	ジョコビッチ : オージー3連勝
地下鉄に転落死した男	地下鉄125丁目駅構内で電車が男性を殺害
# us details help in failed # hostage rescue.# somalia # france	米国は、ソマリアでの人質救出に失敗したフランスを支援した。
マイクロソフトのウィンドウズ8の売上はまずまずだが、素晴らしいとは言えない cnnmoney	マイクロソフトのWindows 8の売上は大きい--ただ、十分ではない
rssの生みの親であるインターネット活動家#aaronswartzが26歳で死去-自殺。係争中の訴訟のプレッシャーに負けたのか？	Aaron Swartz、インターネット活動家、26歳で死去
パブリシティについての真実......悪いパブリシティは存在する。# pr # メディア	悪評もまた然り
# 革命が大学を襲う # 距離による # 教育 # 持続可能性	論説委員：革命が大学を襲う
ヴィッキー・ハドルストン : なぜ私たちは # マリ共和国を救わねばならないのか？	寄稿：なぜ私たちはマリを救わなければならないのか？
これは奇妙な記事です。" レイ・カーツワイルは、我々は永遠に生きるつもりだと言っている "	トーク : レイ・カーツワイルが語る「私たちは永遠に生きる」。
dannngg !: ランス・アームストロング、オプラに語る ドーピングなしでのツール・ド・フランス7勝はありえない？	アームストロング、五輪メダルを剥奪される
アップルは131億ドルの利益を上げ、28％以上のiPhoneと48％以上のiPadを販売。	アップルの利益は横ばい、株価は下落
生命はいつ始まるのか？ カトリック病院は、胚は人ではないと主張している。	カトリック病院の弁護士、胎児は人ではないと主張
エジプト革命から2年...アメリカはエジプトについて再び誤った認識を示す - Yahoo!	オピニオン : 米国はエジプトについて再び誤解している
アームストロングが2年遅れでオプラにドーピングを認めた後、今度はドーピング疑惑の関係者に証言すると言い出した。	アームストロング、ドーピングを認め、サイクリング関係者に証言すると発表
待って、子供に賄賂を贈るのは悪いことなの？# notmomoftheyearafterall	this life : 賄賂に頼らず子どもの行動を変えるには？
# ディズニーの新しいビデオゲーム、via nytimes : ディズニーの世界を組み合わせたビデオゲーム	media decoder blog : ディズニーとピクサーのマッシュアップを使った新しいビデオゲーム
ゴワナス運河で、イルカが	ドルフィンスイム・イン・ゴワナス・カナル
シューマー上院議員は、中東についてはチャック・ヘーゲルに満足していると言っています。 彼の支持はその問題を解決するはずです。	シューマー氏、中東問題でヘーゲル氏に満足と発言
銃に関する人気ビデオのプロデューサーが撮影した。 すべての銃の死は悲劇である。	銃乱射事件のプロデューサーが死亡しているのが発見された。
アクセスできない、文化的に無能な主流のケアの兆候？ ボデガ・クリニカの空白を埋めるように、保健当局が引き裂かれている。	ボデガ・クリニカス（BODEGA CLINICAS）」、保健当局の関心を呼ぶ
ローマのカラフルなコロッセオ	ローマのコロッセオが秘密を明かす
" : サムスン、過去最高の66億ドルの利益 "	サムスンの利益、66億ドルで過去最高を記録
スペイン警察、イラン向け商品を押収 ...どうする？	スペイン警察、イランの核開発プログラム向けの物品を押収と発表
これはかなりすごい読み物です。# howstuffworks nytimes : コイン、紙幣、国の借金	economix blog : ブルース・バートレット : 1兆ドルプラチナコインの会計処理について
ホテルの一室にあるフィットネスセンター	アーバンアスリート : ニコル・グローのホテルルームワークアウト
アイルランドでの暴動が報道されないことに驚いています。	北アイルランド暴動で警察が放水銃を配備
サウジアラビアはスリランカ人女性の処刑を擁護している。	サウジアラビア、メイドの斬首刑を擁護
最悪の飛行判断ミス ... 2人をかろうじて逃したスタント機、連邦航空局の調査を促す ...	スタント機が2人をかろうじて取り逃がす映像が、連邦航空局の調査を促す
ヒラリー・クリントンのFPアプローチについて	イラクのランデブー : クリントン外交政策
イタリアでインサイダーが政治に戻る # memofromrome # politics	ベルルスコーニ、イタリアの選挙をかき乱す
sign of # apocalypse : チャーリー・ブラウンの声優が逮捕、起訴されました。	チャーリーブラウンが起訴されました。
地下鉄の中で、魂を揺さぶる声。	地下鉄の中で、ゲーチー・ダンの声は魂を揺さぶる。
CESキーノート：現代の若者は「生まれながらの # モバイル」である # ハイテック	CES : 若者は「生まれながらのモバイル」である
在宅死を妨げているのは、医療的ニーズではなく、介護者のニーズである # hpm	新老人のブログ : 大切な人を自宅で死なせるために必要なこと
CNNの気候変動 : 次のステップ : 2月12日のオバマ大統領の一般教書演説 ....	気候変動活動家からオバマ大統領へ：議会から手を引け
RSSとRedditの共同開発者であるAaron Swartzが自殺。	ネット活動家アーロン・スワーツが自殺
チャーリーブラウン声優起用	チャーリーブラウンが起訴されました。
NJFは1月26日にラトガース大学でこの映画を上映します。	私たちの世代 : ?set for life ?団塊の世代の文書危機
ドリームライナーのロールアウトがうまくいっていない。	ドリームライナーの危機が深刻化
what we don't know is killing us the gun industry can't handle the truth.私たちが知らないことは、私たちを殺している銃産業は真実を扱うことができません。	editorial : What we don't know is killing us.
インドインク : パンジャブ州で女性が7人の男にレイプされたと警察が発表 : 日曜日、警察は29歳の女性が7人の男にレイプされたと発表しました。	INDIA INK : インド、パンジャブ州で女性が7人の男にレイプされたと警察発表
# photos :# Kimjongun and his army forces	写真：キム・ジョンウンとその軍隊
ということは、facebookで検索して、bingをバックアップに使うということでしょうか。	bits blog : フェイスブック、新しい検索ツールを公開
アイシーミー、フェイスブックが新しい検索ツールを発表： " グラフ検索 "。	bits blog : フェイスブック、新しい検索ツールを公開
社長が望むなら	ヒラリー・クリントン大統領が望むなら。
そのような不親切な言葉に値する。	ケニアのレンジャーが、象牙のために11頭の象を殺した密猟者を捕えました。
レビュー : フェイスブックのグラフ検索はあまり役に立たない - CNN 「526人の友人のうち猫が好きなのは2人だけ」...もういいや。	レビュー : フェイスブックのグラフ検索はあまり役に立たない
ウクライナはシェルとシェールガス掘削契約に調印 # ダボス会議で # エネルギー # 市場参入	ウクライナ、シェルとシェールガスの掘削契約に調印
by the numbers : 米軍に女性兵士を......いや、よくない考えだ	数字で見る米軍の女性たち
次の休みは、新しいことに挑戦してみよう。	せかいりょうりきょうしつ
" : ブリトニー・スピアーズ、婚約を解消 " LOOLO CNNがこれを報道？	ブリトニー・スピアーズ、ジェイソン・トラウィックの婚約を解消
うんこおやじ、地下鉄に転落して死亡	地下鉄125丁目駅構内で電車が男性を殺害
thank you goodness .♪ : フィラデルフィアの医師死亡の殺人で起訴された男 ...?	医師死亡の殺人容疑で起訴された男、情報筋によると
イスラエル軍の占領軍によって西岸で殺害されたティーンエイジャー、活動家が発表	イスラエル軍が西岸で10代の少年を射殺したと活動家らが発表
食べるために生きるか、生きるために食べるか？ 私は前者だと思います。	大都会 : 新世代が直面する、手の届かない贅沢な食卓
インフルエンザ予防接種の効果を高める # 運動をする	運動はインフルエンザ予防接種の効果を高める
スマートフォンはリモコンのようなもの	スマートフォンは、今や消費者の生活を動かしています。
er diab ..." : ブラジルのナイトクラブで火災、少なくとも245人死亡 "	ブラジルのナイトクラブで火災が発生し、数百人が死亡。
2013年アカデミー賞ノミネート作品：受賞者	2013年アカデミー賞ノミネート作品：選ばれなかったのは？
国王への侮辱を示唆した罪でタイで有罪判決を受けた。 スピーチの中で国王の名前に言及することはなかった。?	タイでは、王族を侮辱することの定義がより広くなっています。
" ラクロスからの脱出 " 隣の家のプリパーズ	ニューヨークの終末予言者たち
オプラはランス・アームストロングを救えるか？ 彼女は納得していない #ドプラ	オプラでもランス・アームストロングを救えるのか？
ノートルダムのラインバッカーがナマズ型デマの犠牲者に？	ノートルダムのラインバッカーがデマの犠牲者であると発言。
モーニングアスレチックインスピレーション（みんなを競技に！）：若い障害者アスリートたちのスタートラインへの道を切り開く # nyt	障害者アスリートのスーツ姿に、ロジスティックスと公平性に疑問の声も
マイケル・R・ブルームバーグ、ジョン・ショプキンス大学のおかげでリーダーになれたと語る。	ブルームバーグが11億ドルで米国トップの大学寄付者に。
保安官：オバマの銃刀法を執行しない。	保安官は「違憲の」銃刀法を施行しない
2010年に発覚したモルシのユダヤ人に対する中傷。	モルジーのユダヤ人に対する中傷は不安を煽る
北朝鮮がロケットの発射に成功したとき、アメリカはそれを許した。	アメリカの最高司令官が女性の戦闘参加を支持するようになった理由
君は # インスピレーションだ!# keepfighting	女性のための戦いの最前線
研究 : 大学教育を受けた者は不況を最もよく乗り切った :	経済不況下における大学の学位の価値を示す調査結果
の悲しさ。" : 汚染されたニューヨークの運河にはまり込んだイルカが死亡。"	ニューヨークの運河にはまったイルカが死ぬ
" エラーにより退役軍人がウイルスに感染した可能性があります " あーあ ...	インスリン注射の誤りで退役軍人がウイルスにさらされた可能性
今日、私は「現在、銃の密売を犯罪と定義する連邦法はない」と知りました。「私は言葉を失いました。	上院議員、半自動小銃の制限に関する法案を発表
オバマ大統領、証券取引委員会（SEC）のボスに元検事のメアリー・ジョー・ホワイトを起用する。	メアリー・ジョー・ホワイト、証券取引委員会の新ボスに就任へ
wow ... a pedophile in plain sightの短い、しかし目を見張るような記事です。	オピニオン：ポリプロップでは、ロリコンが見え隠れしている。
良い読み物だ...なぜネットはアーロン・スウォーツを悲しませるのか-。	なぜ世界はアーロン・スワルツを悲しませるのか
アームストロングがついにドーピングを認め、証言すると発表。	アームストロング、ドーピングを認め、サイクリング関係者に証言すると発表
ペプシコがこの健康問題の解決に協力し、消費者を第一に考えていることを示す、とても有益な記事です。	ゲータレード、ティーンエイジャーの声を聞き、処方を変更
私が生きている間に米国はどのように変化したのか:	レーガンからオバマへ、私たちは国家としてどう変わったか
THE NEW YORK TIMES : 中国企業、米国の太陽光発電スタートアップを買収	中国企業が米国の太陽電池技術ベンチャーを買収
フランスでは、同性婚を認めることに反対するデモが行われた。	フランス集会：同性婚に反対する
follow the dinero : クオモ、再選のために2250万ドルを調達	クオモ、再選キャンペーンのために約2,250万ドルを調達
中国は教育に投資している - #高等教育 # edpolicy	次のメイド・イン・チャイナ・ブーム：大卒者
ライブストロングは、ランス・アームストロングのドーピングを認めても大丈夫なのか？	リブストロングにはランスのあとの人生がある
健康を守るためのフェンスを作ろう！インフルエンザに関する質問にお答えします。	インフルエンザに関する質問トップ10
ジョンソン・エンド・ジョンソン、股関節インプラントに40%の不具合があることを認識 # hipimplant	股関節インプラントの40%の不具合についてメーカーが認識
'is there a worse way to live ?' ( cc : ) # jidf	'is there a worse way to live than this ?これより悪い生き方があるのだろうか？'
銃の暴力は絶対に # 公衆衛生問題 です。 良い仕事です。	社説：オバマ大統領の銃規制改革案
AZ州知事ジャン・ブリューワーは考えを変え、メディケイドを拡大する。# medicaid	ナショナルブリーフィング：南西部：アリゾナ州：メディケイドで知事が譲歩
コラムの抜粋はこちら : ポーリーン・フィリップス、親愛なるアビー、94歳で死去。	親愛なるアビーとして数百万人の相談役を務めたポーリーン・フィリップスさん、94歳で死去
# ミャンマーの武装反乱軍との戦いは中国に向かう # burma # kachin	ミャンマーの戦闘は中国に傾いている
ブラジルのナイトクラブで火災、少なくとも90人が死亡。	ブラジルのナイトクラブで火災が発生し、数百人が死亡。
米国、反政府勢力を不注意に養成：マリでのフランスの攻撃は、米国の注意に取って代わる。	フランス軍ジェット機がイスラム教徒の支配するマリ共和国の奥深くを攻撃
カロリー爆弾のようなメニューは、食べ終わった後に罪悪感を抱かせる。	外食のカロリーボム9選
2012年、米国で最も人気のあるモバイルアプリは「facebook」だった	フェイスブックのモバイルアプリが首位に
気候変動への警鐘 #異常気象 #地球温暖化 #エコ	気候変動への警鐘
シリア：ダマスカスで大規模な空爆を実施	シリア、ダマスカス近郊で致命的な空爆を開始
という2つのパートナーは、あなたの通勤にもっと音楽を届けるために手を組んだのです。	フォード、アマゾンのクラウドミュージックを利用した車載用音声コマンドを発表
暴力的なシューティングゲームをプレイしても誰も何も言わないのに、NRAが新しいターゲットシューティングゲームに熱狂するのは驚きだ。	NRA、シューティングゲームに熱視線
を見る価値がある。" set for life " documenting a generation ? s fall .# 仕事 # 失業 # 団塊の世代	私たちの世代 : ?set for life ?団塊の世代の文書危機
ドリームライナーの修理 : 'it 's not easy' - this big mess that is not easy .	787ドリームライナーの修理：「それは簡単なことではない
nyt editorial : what we don't know is killing us # research # guns # violence	editorial : What we don't know is killing us.
ポジション「eliminated」 ...ではなく、「exterminated」 ...と読みますが、タイムズのエグゼクティブが去ることになりました。	回コミュニケーションズ・エグゼクティブが退社する
mr.drummond, yep ... show my age : コンラッド・ベイン、父親が脳梗塞で倒れた？89歳で死去	コンラッド・ベイン、「Diff & Rent Strokes」の俳優、89歳で死去。
サウジアラビア、メイドの処刑を擁護	サウジアラビア、メイドの斬首刑を擁護
" facebookは多くのデータを持っていますが、それは非常にノイズの多いデータです。"	フェイスブックの運命は検索にかかってるかもしれない
CNN Recent Nightclub tragedies : 土曜日、ブラジル南部のナイトクラブ「kiss」で大規模な火災が発生し、死者が多数出ています。	デッドリー・ブレイズ : 最近のナイトクラブの悲劇
北朝鮮がまた脅迫している	北朝鮮が米国に露骨な新脅威を発した。
私たちは皆人間です、これ以上死なないでください！またチベット人が中国の支配に抗議するために焼身自殺をしました。	チベット人による中国支配への抗議としての焼身自殺
コカ・コーラ、肥満対策に参加	コカ・コーラ、肥満対策に取り組む
バート・レイノルズさんのご冥福をお祈りします。	バート・レイノルズ、「快方に向かっている」が「まだICUにいる」と報告。
タリバン」は複数形だが、CNNや他のジャーナリストには難解すぎるようだ : .	アメリカのタリバン」が集団礼拝の権利を獲得
サウジアラビアの活動家が「沈黙はしない」と発言～～平和的に権利を獲得する方法を見つけてほしいです	サウジアラビアの活動家は、王国が彼らを黙らせようとしていると言っている。
医者が言うことを聞かないとき、どうすればいいのか？	医者が言うことをきかないときの対処法
ジョディ・フォスターは、シリアがダマスカス郊外に致命的な空爆を開始したことをもっと気にかけるだろう。	シリア、ダマスカス近郊で致命的な空爆を開始
ステーキハウスのルールを曲げる #食べ物 #食べ歩き	レストランレビュー：アッパーイーストサイドのアーリントンクラブ
ニューヨークの議員たちが、新たな銃規制について合意に達する # 法律 # cdnpoli	ニューヨーク州議会議員、新銃法の早期採決に期待
匿名」が司法省を脅す ... 「匿名」が司法省を脅す	ハクティビストグループが司法省を脅す
ブラジルのナイトクラブで火災、少なくとも245人が死亡、残念。	ブラジルのナイトクラブで火災が発生し、数百人が死亡。
今日のインターネット中毒：「リンジー・ローハンを映画に起用するとどうなるか？	リンジー・ローハンを起用すると、こうなる。
中国にも、マッキンゼーが考えるようなグローバルな「教育から仕事へ」の問題があることを示す、Nytの素晴らしい記事。	中国の卒業生が工場での仕事にノーサンキューと言う
先延ばしの功罪 : 元旦のコラムの予定でした。	知見 : 前向きな先延ばし、矛盾ではない
フランス : 私たちは、あなたが考えているような平和主義者ではない - マリ	フランスはなぜ平和主義国家でないのか
オンライン恋愛の奇妙な世界：マンティ・テオの画像が謎に包まれ、様々な説が飛び交う	マンティ・テオのイメージは、様々な説が飛び交い、パズルと化した。
唇のひび割れが狂牛病の最初の兆候であることがようやく確認されました。	オピニオン：ヒポコンドリア：インサイド・ルック
スウォッチが10億ドルのハリー・ウィンストン買収で大盤振る舞い Get it, big hand ...# iexplainmyjokes	スウォッチ、ハリー・ウィンストン社の時計・宝飾品事業を7億5000万ドルで買収
Healthexchange timetable : : 各州は交換所設立のための時間的猶予を得る # aca # hcr	各州に健康保険取引所設立のための時間的猶予が与えられる。
" 剣に生きる ..." 悲しくも皮肉な、銃にまつわる人気ビデオのプロデューサーが撃たれる	銃乱射事件のプロデューサーが死亡しているのが発見された。
コービー・ブライアント、妻が離婚を取りやめへ!	コービー・ブライアント夫妻、離婚を撤回
excellent !? :# obama accelerating troops withdraw from # afghanistan, several months ahead of schedule : ?	オバマ大統領とカルザイ大統領は軍事的移行を加速させる
obit : ニクソンが州兵を送るまで全国の郵便局を閉鎖した1970年のストライキのリーダー、ヴィンセント・ソンブロット。	郵便ストライキを率いたヴィンセント・ソンブロート氏が89歳で死去
so heartbreaking " : ブラジルのナイトクラブで火災、少なくとも90人が死亡と当局発表。"	ブラジルのナイトクラブで火災が発生し、数百人が死亡。
国内税制の累進性を強化する理由 " アメリカの生産性は上昇し、賃金は低迷している "	ニュース分析：アメリカの生産性は上昇、しかし賃金は停滞
これは興味深いです： "我々は知らないことが私たちを殺している"。	editorial : What we don't know is killing us.
地下鉄でこの歌手を初めて見たとき、私は彼に記事が必要だと思った。 そしてNytはそれを実現したのだ!	地下鉄の中で、ゲーチー・ダンの声は魂を揺さぶる。
ドイツ、マンハッタンからフランクフルトへ674トンの金塊を移動 ...	ドイツが金準備の一部を本国送金へ
エイダ・ブライアントとロバート・ヘアーは、私の心を温かくしてくれました。	エイダ・ブライアント、ロバート・ヘアー、ウェディング
# New York City ties # doctors ?# income to # quality of # care	ニューヨークの病院、医師の報酬を品質指標と連動させることを決定
NY TIMES : dot earth blog : フラッキングの「ワイルド・ウエスト」時代は終わりつつあるのか？	ガス掘削の「ワイルド・ウエスト」時代は終わりつつある？
ドレスコードに違反した児童に手錠をかける!# ms fills # school2prison pipeline reports grantee .	ミシシッピ州での学校懲戒処分について批判する報告書
fruitvale」と「bloodbrother」、おめでとうございます！今年のサンダンスは、パワフルな作品が多かったようですね。	The carpetbagger : 「Fruitvale」、前評判の低いドラマがサンダンスで勝利。
sleep , perchance to dream and our memories not unseem mt : 脳の老化と睡眠に関連する記憶力低下 "	脳の老化は睡眠に関連した記憶力の低下につながる
私のpbkのメンバーシップは、最終的に説明した。 両親？ 財政的なサポートは、大学の成績を助けることはできません。	両親の経済的支援と大学の成績の関連性
tennis : シャラポワ、少年に挑む	シャラポワ、オーストラリアの少年たちに挑む
FDAは、ウンコが薬であることを発見するかもしれない。 NYTIMES : 薬が効かないとき、この、えー、選択肢は、治療法を提供する。	気持ち悪い、かもしれない、でも治療は有効、との研究結果。
チーズ屋さんで起こることは、乳製品、熟したプロスだけです。	独創的なチーズ職人による巧みな説明
peter likes : ディールブック : デルの株式が非公開化のニュースで上昇	dealbook : 買収の可能性報道を受け、デル株が急騰
キャパニック、プレーオフでハーボーのギャンブルをサポート	ハーボーのギャンブルに応え、見事なパフォーマンスを見せたキャパニック
共和党の知事たちは、大胆な解決策を提示し、税金の議論に新しい風を吹き込みました。	The caucus : 共和党の知事たちが税金の議論に新たな戦線を開く
ちなみに、私はKarlieの前に髪を "The Karlie "に切っています; )。	The Karlieが注目される
親しみを込めて。# 北韓国	国連と北朝鮮のために：ゲームオン
メラノーマで発見された新たな変異は、その発症メカニズムの解明に有用である。# 癌	メラノーマに新しい変異が発見された
NYTIMES : ドイツ経済、第4四半期に縮小。	第4四半期のドイツ経済はおそらく縮小した
国連機関：シリアの苦しみをもう一度止めよう。	国連：シリアの苦しみを止めよ
保守派作家ニコラス・クリストフ：銃は「保護する道具ではなく、エスカレートする道具」である。"	コラムニスト：銃とガチョウからの教訓
nytimes : ロボットメーカーは、自動化は仕事を消すだけでなく、新しくより良い仕事を作り出すと言う。	ロボットメーカーが世界に広める自動化の福音
五大湖の水位が新たに低下 #干ばつ	大湖の水量が過去最低を記録
英国、高速モバイル用に250Mhzをオークションにかける-。	英国が高速モバイル・パーティに参加
nytimes : アプリや他のデジタルツールは、手を貸す...	ツールキット : アプリなどのデジタルツールが新米ママに手を差し伸べる
インドとブラジルの内臓リーシュマニア症血液サンプル6,000のDNAを比較したところ、同様のバリエーションがあることがわかった。	グローバルアップデート：致死的なリーシュマニア症の犠牲者に遺伝的なつながりが発見される
ペンタゴンは女性の戦闘禁止を解除する予定です。	ペンタゴン、女性の戦闘参加禁止を解除
ドイツ、674トンの金を移動させる # germany # europe # usa	ドイツが金準備の一部を本国送金へ
" : シークレットサービス犬が転落死 " 😢 🐶 🐶 ←今ここ	シークレット・サービス・ドッグ、VPの任務中に転落死
* NYTIMES : セキュリティ会社がサイバースパイキャンペーンを発見。	bits blog : セキュリティ会社が世界的なスパイキャンペーンを発見
# オバマの計画：チェックを厳しくし、突撃兵器を出さない - - from # guncontrol	GOPは銃規制の提案に難色を示す
ケン・サラザール、ボロネーゼとの時間を増やすため退社。	インテリアのケン・サラザール氏が退任
ナイキがローリー・マシルロイをタイガーの後継者として発表。$ 200 mil deal ??は私にビジネスセンスがありません。	ナイキがローリー（タイガーの後継者）を発表
赤ちゃんは「泣き止む」ことを許されるべきか？# アタッチメント # 子育て	赤ちゃんは「泣き止む」べき？
ルック・オブ・ザ・モーメント :# taylorswift	T magazine : ルック・オブ・ザ・モーメント｜テイラースウィフト
アトランタファルコンズの窮状	NFL : ファルコンズは巻き返せるか？
ニューヨーク州、銃規制に関する協定を締結 精神的悪に焦点を当てる	ニューヨーク州議会議員、新銃法の早期採決に期待
トライバルレッスン - ' 昨日までの世界 '	昨日までの世界、ジャレド・ダイアモンド著
so . odd .♪ : in his own words : manti te 'o on his girlfriend, and her death - now revealed to be a hoax : ?彼のガールフレンドの死はデマであることが明らかになった。	マンティ・テオの言葉：ガールフレンドの死について
J&Jは、デピュー社の股関節インプラントの故障率が40％であることを認識していた。	股関節インプラントの40%の不具合についてメーカーが認識
コロラド州のマリファナの法的判断に従うと、カリフォルニア州の薬局は混乱する。	論説委員：コロラド州のマリファナの混乱
ny times - 落とし穴のあるスプリント	スラップショット : NHLのシーズン・スプリントには落とし穴がある
ダッチクッキングを楽しもう ? レッツゴーダッチ ??# gartine	ダッチクッキングにスパイスを効かせる
オバマはパレスチナで自分自身を証明しなければならない : NYTIMES : ネタニヤフ首相は、オバマからの批判に応えて、ベールに包まれた辛辣な言葉を発した。	ネタニヤフ首相、オバマ大統領の批判にベールに包まれた反論を発表
アメリカ、明日のサウジアラビア - 良いのか悪いのか？	アメリカ、明日のサウジアラビア
お腹が痛いです．	外食のカロリーボム9選
ストップ・デーが必要ですか？	ストップ・デー」の重要性
オーストラリアで起きたこと......私は銃を追った。 オバマもできる。	論説委員：オーストラリアは突撃兵器を禁止している。
オバマ大統領の銃に関する提案は有効か？ 痛みを想起させ、市長たちは法案成立を強く求める。	銃による犠牲の痛みを想起し、市長らが法案成立を要請
nyt books - books of the times : ?リバー・スイマー, ?ジム・ハリソンによるノベラのペア : ?リバー・スイマー, ?ジ...	Books of the times : ?リバー・スイマー、ジム・ハリソンによる2つの小説
技術に目覚めたベビーブーマーたち :	祖父母 : 新しい技術者たち？
ケリーCEOは、「イランは核開発プログラムについて自白しなければならない」と述べた。	ケリー確認審
フォックス・ニュースがサラ・ペイリンの契約を更新しなかった。	Fox NewsとSarah Palinが決別
畏敬の念 - 元祖「ブロガー」の一人が死去。 親愛なるアビーとして数百万人に顧問を務めたポーリーン・フィリップス、94歳で死去。	親愛なるアビーとして数百万人の相談役を務めたポーリーン・フィリップスさん、94歳で死去
Don't get any ideas ,. 米国のプログラマーは自分の仕事を中国にアウトソースし、猫のビデオをサーフする - 。	米国人男性が中国に仕事をアウトソース、猫動画でサーフィンを楽しむ
映画監督ジェイソン・ダ・シルヴァが語る、ニューヨークを旅する挑戦 # ms : the long wait ?# サンダンス	op-docs :♪ the long wait ♪
この記事は、まるで事前に書かれた「死」の記事のように読めます。 気味が悪い。	バート・レイノルズ、インフルエンザでフロリダの病院の集中治療室にいる、と代理人。
unfairrt : ドーピングを認めたランス・アームストロングに対し、読者が書籍の返金を求めて提訴 : どう思う?	読者が本の返金を求めてアームストロングを提訴
ナイトクラブ火災で200人死亡	ブラジルのナイトクラブで火災が発生し、数百人が死亡。
ニューヨーク - 米国防総省、女性の戦闘任務への従事禁止を解除	ペンタゴン、女性の戦闘参加禁止を解除
" このレビューの以前のバージョンでは、ブロードウェイでの「ピクニック」のオープニングで登場したトルソーを誤って認識していました ..."	シアターレビュー：「ピクニック」＠アメリカン航空劇場
あと2年間は、ラインス・ペニスのジョークで盛り上がりましょう。	共和党全国委員会のトップにプリーバス氏が再選されました。
ニューヨークが銃規制法案を可決 興味深いことに、彼らは実際に精神的健康に焦点を当てていることが好きです。	ニューヨークでニュータウン銃乱射事件後初の銃規制法案を可決へ
ミス・モンタナには、素晴らしい物語があります。# autism	ミス・モンタナ、自閉症について
CG - ネパールでバスが崖から転落し、30人が死亡-。	ネパールのバスが崖から転落、30人が死亡
ジョニー・ハワードの意見で、驚くほど新鮮だった。 私は銃を追った。	論説委員：オーストラリアは突撃兵器を禁止している。
" : today ?s gun challenge editorial, obama puts politics aside and takes action on gun reform."	社説：オバマ大統領の銃規制改革案
N.A.A.C.P.では、ソーダ禁止に反対する産業界が味方になっている 私はその中の一人ではない	ブルームバーグのソーダ禁止令に対し、NAACPは法廷で反論。
そして、彼らはその理由を決して理解しない!アメリカはまたエジプトについて間違ったことをした。	オピニオン : 米国はエジプトについて再び誤解している
砂で汚されたハリケーン浸水車は、無意識のうちに買い手をつけてしまう。	洪水で浸水した車が買い手を誘う
オズでは、私たちの政治、銃規制などを嘲笑するのが大好きです。私たちの人口が私たちの前に何年も議論していることを覚えておく価値がある。	オバマ大統領は市民権取得への道を一気に進めるだろう。
paging orval faubus : " oregon sheriff : ' unconstitutional ' gun control laws won't be enforce " # guncontrol # newtown	保安官は「違憲の」銃刀法を施行しない
ゴールデン・グローブ賞：ティナ・フェイとエイミー・ポエラーの司会はどうだった？	ゴールデングローブ賞でハリウッドの賞レースシーズンが開幕
トルコでは、弔問客がクルド人の殺害に抗議しています。	トルコでクルド人活動家の殺害に抗議する人々
チム : 戦後ヨーロッパを鮮やかに回顧する # 写真集	チム : ヨーロッパの鮮烈な回顧展
コネットの大虐殺のような出来事が、私たちがそれに気づくために起こらなければならないのは、悲しいことではありませんか # challenges	アリゾナ州保安官移民部隊の新たな任務：学校パトロール
ビデオ：ローマのカラフルなコロッセオ。	ローマのコロッセオが秘密を明かす
what the what ?♪ : チャーリー・ブラウンの声が逮捕され、起訴された。	チャーリーブラウンが起訴されました。
またか...ある男がホッファの埋葬場所を知っていると言った。	マフィア犯罪で有罪判決を受けた男が、ホッファの埋葬場所を「確かだ」と言っている。
フィラデルフィアの地下鉄で襲撃された男が逮捕されました。	フィラデルフィアの地下鉄で女性が線路に投げ出され、男性が拘束されました。
にもかかわらず、私は# google maps for # iphone をダウンロードしました、私はまだ# apple 's built in maps を使っています、彼らは使いやすいです。	グーグルは野党のアプリを作ることで利益を得ている
埋もれた記憶は、生存、記憶、回復のこれまで語られたことのない実話を語る。	ケイティ・ビールの「埋もれた記憶」。
湾岸の「グリーン」ビル # アンマン # CNN	湾岸で最もクールなグリーンビルディング
NYTIMES : N.R.A. attacks obama & daughters in video \ repugnant.	N.R.A.がビデオでオバマ大統領を攻撃
ひどい" : 800以上のニューヨークのレイプ事件が鑑識のミスで見直される "	800件以上のニューヨークのレイプ事件でミスがないか検証
ここで質問ですが、ランスは不正をしたことで罰せられるのでしょうか、それとも不正をしたことのほうが罰せられるのでしょうか？	大衆はアームストロングに怒りをぶつける
キンドルの存在理由 : オニオンがビデンの伝記を電子書籍で放り出す	artsbeat : ビデンがオニオンから自伝をもらう（彼が望むと望まざるとにかかわらず）。
インフォメーション マイアミのデザイン地区がアップグレード：3億1200万ドルの改装案が、デザイン地区を変貌させる見込み。	マイアミのデザイン地区、アップグレードの必要性
マリ北部で手足が折れ、命が引き裂かれる - # islamism # sharia	マリで手足が折れ、命が奪われた
ジャーナリストよ、アンドリュー・サリバンを見習え。	ジャーナリスト , ブロガー・サリバンから学ぶ
この甘いラブストーリーに、私は涙を流しました。 いや、本当に。	レースは最終ラップに近づくにつれ甘くなる。
北朝鮮が戦いの太鼓を鳴らす...	北朝鮮が米国に対して新たな脅迫を行った。
イスラエルで高まるロシアの影響力 # israel	露助の台頭
イスラム過激派の下での生活 - 北マリで手足を切断され、引き裂かれた命	マリで手足が折れ、命が奪われた
チャーリーブラウンが逮捕されるとは、なんともはや。	チャーリーブラウンが起訴されました。
" : " : ブラジルのナイトクラブ火災で死者220人に、当局が発表。" 信じられないほど悲しい " 恐ろしい	ブラジルのナイトクラブで火災が発生し、数百人が死亡。
悲しいけれど、インクで汚れた手で彼女のコラムを読んだ記憶がよみがえる。 なんという人生だろう。 Nytimes : 親愛なるアビー、94歳で死去。	親愛なるアビーとして数百万人の相談役を務めたポーリーン・フィリップスさん、94歳で死去
砂漠の前哨基地で、国境警備隊員が監視している # elpaso # elchuco # lafrontera # mexico	国境警備隊員は、遠隔地の前哨基地で手がかりを探す。
ハリウッドに最も近い場所 : # greenfashion on the red carpet	IHT RENDEZVOUS : レッドカーペットのグリーンファッション
再び : nytimes : 787型機が安全性試験中に燃料漏れ	日本航空、787型機の安全性試験中に燃料が漏れたと発表
北朝鮮のミサイルの動きは米国を心配させている トム・シャンカー、デビッド・サンガー	北朝鮮によるミサイルの動きは、米国を心配させている。
どうなるのか楽しみです。!サウスパーク、クリエーターが "重要なスタジオ "を立ち上げました。	サウス・パーク」のクリエーターが会社を設立
CNN : ヘリコプターの墜落でロンドンの道路に破片が降った。	ロンドン・ラッシュアワーにヘリコプターが墜落
ネットの神童アーロン・スワーツが自殺 神よ、なぜ？	ネット活動家アーロン・スワーツが自殺
スタジオ54は60年代のようなもので、もしあなたがそれを覚えているなら、あなたは本当にそこにいなかったのですか？ スタジオ54の古い輝きを売っています。	スタジオ54の記念品がオークションに出品される
気候は、遠い未来ではなく、今、変化しているのです。	気候変動への警鐘
異常気象 : 想定外の事態を想定する	異常気象が世界中で頻度と強度を増しています。
アダ・ブライアントとロバート・ヘアー You go girl !!	エイダ・ブライアント、ロバート・ヘアー、ウェディング
Nyt on Aaron Swartz : a data crusader, a defendant and now, a cause (アーロン・スウォーツについて)	アーロン・スワーツ、データ・クルセイダー、そして今、原因とは？
見出しを無視：220人以上...リンクをクリックすると、CNNで更新されます。	ブラジルのナイトクラブで火災が発生し、数百人が死亡。
私はそれがいくつかのためにこうなることを残念に思う。	チベット人による中国支配への抗議としての焼身自殺
こわいこわい・・・ギリシャの成長を問う	world : ギリシャの成長に関するグリーンな質問
悲劇的なニュース：データ保護活動家、被告人、そして今、原因	アーロン・スワーツ、データ・クルセイダー、そして今、原因とは？
気候変動を信じた方がいい。連邦政府の報告書は、地球温暖化が米国に大きな影響を及ぼすと見ている。	dot earth blog : 地球温暖化が米国に与える影響に関する連邦政府の報告書案
: 人気ガンマニアが自宅で射殺、NRAはもっと銃が必要だと考えている。	銃乱射事件のプロデューサーが死亡しているのが発見された。
this is so sad " : ブラジルのナイトクラブで火災、245人死亡 警察、国営通信に発表 ."	ブラジルのナイトクラブで火災が発生し、数百人が死亡。
前オーストラリア首相、「私は銃を追った。 オバマもできる。"	論説委員：オーストラリアは突撃兵器を禁止している。
チャーリーブラウンの声優が起訴されました。	チャーリーブラウンが起訴されました。
スモーキングナンバー	井戸：喫煙による平均寿命への長期的影響
ミス・アメリカは南部出身が多いのは偶然ですか？	寄稿： 人種政治とミス・アメリカ
英国、三大不況に傾く cnnmoney	イギリスは新たな不況に陥る危険性がある
百万人の行進：出血したパキスタンに変化をもたらすことを約束する- # TAHIRULQADRI # 14JAN	パキスタンの首都を麻痺させる「百万人の行進」を約束する
アメリカ、明日のサウジアラビア - グッドラック・サウジアラビア : )	アメリカ、明日のサウジアラビア
フランスのツイッターで人種差別的発言の背後にあるアイデンティティをめぐる裁判が行われ、インターネット上の言論をめぐる最新の小競り合いとなった	ツイッターに反ユダヤ主義的な投稿の情報源を明らかにするよう命じられる
" すべてのスムージーが同じように作られているわけではない！？"	外食のカロリーボム9選
病院、インフルエンザ症状の訪問者を追い返す - NYT	病院がインフルエンザ患者の面会制限を実施
nytimes : ブラジルのナイトクラブで火災が発生、232人が死亡（ロックされたセキュリティードアとバンドの花火）。	ブラジルのナイトクラブで火災が発生し、多数の死者が出ている。
携帯電話の電波塔に関するF.C.C.の権限について、最高裁判所が議論を行う。	最高裁判所、携帯電話タワーに関する議論を聞く
iht : シャオ・シュウ、サザン・ウィークエンドの元記者、検閲の鉄のグリップをインサイダーで表現する。	中国における報道の自由への期待
# wtf it happened again:7人の男がバスの乗客を集団レイプ。	バス連続強姦事件で6人を逮捕
# youth : the wants to know : " Does # facebook ever make you feel l-o-u-s-y ?" シェアする	Learning Network Blog : 学生の声｜facebookで嫌な思いをしたことはありますか？
DA CNN : 「ブラジルのナイトクラブで火災、少なくとも245人死亡」最新情報	ブラジルのナイトクラブで火災が発生し、数百人が死亡。
イギリスとアイルランドでハンバーガー用の肉から馬肉が発見される。	イギリスとアイルランドでハンバーガーから馬肉が発見される。
dear abby, dies at 94. dear abby : are birth control pills deductible ? bertie dear bertie : only if they don't work ...効き目がない場合だけ。	親愛なるアビーとして数百万人の相談役を務めたポーリーン・フィリップスさん、94歳で死去
ジャレド・ダイアモンドの本は読む価値があるのか？" 昨日までの世界 "	昨日までの世界、ジャレド・ダイアモンド著
# socialmedia makes folks more honest , says # Cornell prof # facebook # linkedin	ソーシャルメディアは私たちをより正直にさせる
世界一の急流ラフティング ?ギークケニア	ラフティングで世界一の場所？
ケーシー・アンソニー、4つの有罪判決のうち2つを破棄。	ケーシーアンソニーの有罪判決を取り消す
労働者が単なるコストとして見られる...我々は皆、この社会を構築し、我々が支払うものを得ることになる。	オピニオンリーダー｜The Great Divide : 常用型派遣の台頭
オンライン学習における人間性の必要性について .	オンラインコースは、教育するために人間の要素が必要です。
奇妙な、声だけ？" : チャーリー・ブラウンの声、逮捕・起訴 "	チャーリーブラウンが起訴されました。
フラム : 米国の銃問題は人種問題ではない ( 必読 )	アメリカの銃の問題は、人種の問題ではない
言論の自由は、フランスを除く民主主義の基本的権利である # twitter	ツイッターに反ユダヤ主義的な投稿の情報源を明らかにするよう命じられる
ニューヨーク市は、医師の収入と医療の質を結びつけている。	ニューヨークの病院、医師への報酬を品質指標と連動させることを決定
Art meets Technology before Tragedy : 写真家タリン・サイモンとコンピューターの天才アーロン・スウォーツがプロジェクトを立ち上げる , via NY times	6th floor blog : タリン・サイモンとアーロン・スワルツのイメージの実験
地下鉄の中で、魂を揺さぶる歌声。	地下鉄の中で、ゲーチー・ダンの声は魂を揺さぶる。
マイクロソフトのウィンドウズ・エイトの売上は、まずまずである。	マイクロソフトのWindows 8の売上は大きい--ただ、十分ではない
死は最悪です。	あなたのお金 : 衝撃的な死、金融の教訓と他の人への助け
"husbands of hollywood" ?リアリティ番組に対する男女逆転した風刺と、黒人俳優の限られた選択肢に対する微妙なコメント......。	critic? s notebook : 「ハリウッドの本当の夫たち」と「黒人男性主人公の不足」。
ヒラリー大統領！これ以上望むものはない。	ヒラリー・クリントン大統領が望むなら。
nyt , " マウス研究、[ 埋没 ]行動を制御するDNAを発見[ と脱出用トンネルが作られるかどうか ]" "	マウス実験で行動を制御するDNAを発見
" : ソーシャルメディアが私たちをより正直にさせる？	ソーシャルメディアは私たちをより正直にさせる
私たちの市民的な言説をどのように落ち着かせることができるかを考えています。	オピニオンリーダー｜the stone : ハクティビストとは何か？
アームストロングのドーピングをどう思うか？	大衆はアームストロングに怒りをぶつける
アメリカの脅威の後、北朝鮮は南に怒りの矛先を向けた # military # skorea # nkorea # us # politics	米国への脅迫の後、北朝鮮は南に怒りを向けている。
フェインスタイン上院議員、半自動小銃を制限する法案を発表 :	上院議員、半自動小銃の制限に関する法案を発表
NYTIMES : アンソニーとニックスの勝利	アンソニーとニックスに勝利
メキシコの銃とタブレットの交換...	ヘリコプターの残骸を撮影したビデオ
from : コンデナスト・ライター、論争を巻き起こす # コンデナスト	ナスト社との契約により、映画契約における著者のシェアが減少
朝からいい気分で読めるナプキンに「この食事は私たちのおごりです」と書いてある。	ナプキンのメモ：「この食事は私たちのおごりです。
運動はインフルエンザの予防接種の効果を高めることができる # flushot # exercise # health	運動はインフルエンザ予防接種の効果を高める
通信業界は、私たちの権利を奪った。	bits blog : 携帯電話のロック解除の権利は消えつつある。
すごい！# republicans can't win on their ideas so they will change the rules !?	共和党が主導するいくつかの州では、選挙人投票の変更を検討しています。
アメリカ人の77％が診断を得るために検索を利用している。医学的なアドバイスのためにウェブにアクセスする？	well : 医療診断のためにウェブを利用する。
ウォール街からハイテク企業への転職のコツ # dealbook	dealbook : ウォール街からハイテクセクターへの転職は難しい
赤ちゃんは "泣き止ませる "べきなのか？" ...	赤ちゃんは「泣き止む」べき？
ブロンコスのプレーコールについての興味深い見解です。	ジョン・フォックスの慎重な呼び方
ライバルは、シェルの＃北極掘削の希望がスナッグを打つように見ている。$ rds.a # アラスカ # keystonexl # 石油 # 政治	ライバルはシェル北極圏掘削の苦難を見守る
ロシア軍、靴下への切り替えを命じられる 今日、新しいことを学びました。!!	at war blog : ロシア軍、ポルチャンキを靴下と交換するよう命じられる。
クラレンス・トーマス判事、沈黙を破る NYTIMES か ONION の記事か？	トーマス司法長官、法廷で沈黙を破る
ヒップホップのアサップ・ロッキーのパートナー、アサップ・ヤムズの記事です。	asap yams、ヒップホップのパートナー、asap rocky。
彼らはとても若かった : ( # santamaria # tragedyinthenightclub )	ブラジルのナイトクラブで火災が発生し、数百人が死亡。
Thewritinggenie Supernatural tales : マニュエル・ゴンザレスが語る「ミニチュア・ワイフ」 : ゴンザレス氏の初コレクションは、...	artsbeat : Q&A : マニュエル・ゴンザレス、物語集『The Miniature Wife』について
Philly high schoolers, join the conversation .：学校に武装警備員がいたら安全だと思いますか？	Learning Network Blog : 学生の声｜学校に武装した警備員がいたら安全だと思いますか？
より多くの命が救われるという、変化のための良いニュース - 癌死亡率が20％低下 ...	より多くの命を救うために：がん死亡率が20％低下
これは感動的な展覧会です。 未来への道。都市に部屋を作る	weekend miser : メイキング・ルーム、ニューヨーク市立美術館にて。
悪名高いスパイ、アルドリッチ・エイムズの正体を暴くのに重要な役割を果たしたジャンヌ・ベルテフィーユが、最近亡くなりました。	ジャンヌ・ベルテフィーユさん死去、80歳、アルドリッチ・エイムズ捕獲に協力
待って、何？- ユニバーサル・バックグラウンド・チェックの定義	ユニバーサル・バックグラウンド・チェックとは？
経済的苦境：アメリカの生産性は上昇し、賃金は低迷している。	ニュース分析：アメリカの生産性は上昇、しかし賃金は停滞
家事労働者保護法の不備 : サウジの死刑 : 残忍、非人道的、そして違法？- CNN # P2 # P21 # TCOT # CCOT	斬首刑 : 非人道的で違法？
reading : アメリカン・オンライン・ビザの取得方法	寄稿：高速インターネットを全アメリカ人に普及させるには
ニューヨークタイムズの広報トップが退社へ	回コミュニケーションズ・エグゼクティブが退社する
研究することの何がそんなに悪い？	editorial : What we don't know is killing us.
ベンジャミン・ミルピエ、パリ・オペラ座バレエ団を買収、その全貌が明らかに。	ベンジャミン・ミルピエ、パリ・オペラ座バレエ団監督に就任
# morsi :" 私たちの子供や孫を憎しみで育てる : シオニストやユダヤ人のために "	モルシ、ユダヤ人への中傷は文脈から切り離されたものだと発言
NYTIMES : アームストロング、説明のない自白-史上最も洗練され、組織化され、専門化された？	アームストロングにとっては、説明のない自白である。
リーン・イン・シスターズ ... Nytimes : she ' s ( rarely ) the boss.	論説委員：彼女は（まれに）ボスである。
パキスタンの爆弾被害者遺族が抗議を終了	パキスタンの爆弾犠牲者は、抗議の終了後、埋葬される。
これは非常に面白い展開になるかもしれませんね．	共和党が主導するいくつかの州では、選挙人投票の変更を検討しています。
シューマー上院議員、国防長官にチャック・ヘーゲルを選ぶと発言 良いニュースです。	シューマー氏、中東問題でヘーゲル氏に満足と発言
この人はグラミー賞に出るような大物より歌がうまい ギース・ダン、地下鉄42丁目で演奏する	ニューヨーク／地方：ジーチー・ダン プレイズ・ザ・42ndストリート・サブウェイ
セキュリティ企業がサイバースパイのキャンペーンを発見 # itsecurity # cyberspy	bits blog : セキュリティ会社が世界的なスパイキャンペーンを発見
素晴らしいNYタイムズの記事。" : : 都市の聖者 : ニューオーリンズのアーチー・マニング "	街の聖者 : ニューオリンズのアーチー・マニング
企業経営者が直面する、銀行選びのポイントについて、素晴らしい記事とコメントをいただきました。	生き続けること : 私が新しい銀行を探す理由
核兵器を捨てろ！" 北朝鮮、新たな核実験を対米戦の一環と発表 " ジャッキー	北朝鮮が米国に対して新たな脅迫を行った。
メニューにカロリー爆弾の惨状	外食のカロリーボム9選
ICEMI : 「障害者アスリートが競技に参加するとき、ロジスティクスの問題を考える」。	障害者アスリートのスーツ姿に、ロジスティックスと公平性に疑問の声も
もしあなたが# crazy # love を見ていないなら、見るべきです。 NYTIMES : linda riss # pugach, whose life was ripped from headlines, dies at 75.	LINDA RISS PUGACH, 1937-2013 : リンダ・リス・プガック、75歳で死去 その人生はヘッドラインから引き裂かれた
問題は、これが内戦を意味するかどうか？ おそらくしないが、それでも良い状況とは言えない #イラク	スンニ派首長、アル・マリキに「銃撃の背後にいる兵士を引き渡すか、損失を被る」か
この事実にはとても同意できない。	オピニオネーター : インドは競争に負けている
大学生の子供を支援する親にとって興味深い記事 : 両親の経済的支援は大学の成績に役立たないかもしれない	両親の経済的支援と大学の成績の関連性
ニューヨークのクオモ、銃規制法案に署名 .1ダウン あと49	ニューヨークでニュータウン銃乱射事件後初の銃規制法案を可決へ
synthax _ terror 2 : : 800件以上のニューヨークのレイプ事件が鑑識のミスで見直されることになった。	800件以上のニューヨークのレイプ事件でミスがないか検証
wtf india ?!これはもうやめよう。	バス連続強姦事件で6人を逮捕
サッカー界の "賞金稼ぎ "がFIFAに挑む : ソーシャルメディアの利用でFIFAから罰金を科された大手サッカーエージェントは、FIFAに対抗するため、"賞金稼ぎ "を名乗った。	バウンティ・ハンター」がフェイスブックで「FIFA」とバトル
dey stay preppin ' ... the preppers next door.	ニューヨークの終末予言者たち
息子の自閉症を治すためにマリファナを使う一家・・・ww	マリファナで自閉症を治した少年
" ロングアイランド : 「Attack of the bloodsuckers !" ロングアイランド子供博物館 " もしレオを怖がらせたいなら	アート｜ロングアイランド：「Attack of the bloodsuckers !ロングアイランド・チルドレンズ・ミュージアム
私の素晴らしい友人、Cynthis Schneiderがまたやってくれました。	オピニオン : 米国はエジプトについて再び誤解している
ネットが悲しむ理由 アーロン・スウォーツ-ネットの醍醐味を体現した革新者.	なぜ世界はアーロン・スワルツを悲しませるのか
女性監督が台頭し、徐々にストーリーテラーの性別が重要視されるようになった。	女性映画監督も徐々に活躍の場が広がっている
wtf ??" " : ブラジルのナイトクラブで火災、少なくとも245人死亡 更新 : "	ブラジルのナイトクラブで火災が発生し、数百人が死亡。
# cosmos unveil plan for # soccer stadium near # belmontpark # nys # longisland # econdev	コスモス、ベルモントパーク近くにサッカースタジアムの計画を発表
theme ?自分のものでないものを売ろうとする人たち... cc : # joydivision # music	ライフ : 私たちは喜びを分かち合いました
nytimes : スマートフォンは人生のリモコンになる --- 驚くべし	スマートフォンは、今や消費者の生活を動かしています。
breaks my heart " : ブラジルのナイトクラブで245人死亡、警察が国営通信に伝える。"	ブラジルのナイトクラブで火災が発生し、数百人が死亡。
論説 - なぜ我々は # マリ # アフリカ を救う手助けをしなければならないのか # helpmali	寄稿：なぜ私たちはマリを救わなければならないのか？
ブラジルのナイトクラブで火災が発生、少なくとも245人が死亡。	ブラジルのナイトクラブで火災が発生し、数百人が死亡。
インドでまた集団強姦事件が発生！ : ( インドで7人の男がバスの乗客を集団強姦 - )	バス連続強姦事件で6人を逮捕
ソーシャルメディアは敵にも味方にもなるが、IQは上がらない - - 警察 : ユーチューブの動画がマリファナの摘発につながる	警察 : ユーチューブでマリファナ摘発
彼は死んだ!ベネズエラ、チャベス大統領の病状は回復していると発表 ?	ベネズエラ : チャベスは改善している
nytimes : チュニジア風焼きカリフラワーフリタータ	recipes for health : チュニジア風焼きカリフラワーフリッタータ ?
唾液が出る！？♪ : 異国情緒あふれる世界の料理ツアー ?	せかいりょうりきょうしつ
" まだライブストロングブレスレットをお持ちですか？ 教えてください。" ( CNN )	cycling : アームストロングがスタッフに謝罪
レイクチャック出身の弁護士に任せて、正義のトーマスは沈黙を破ったのです。	クラレンス・トマス、ベンチで沈黙を破る
# coder # outsources own job to # china for a profit, gets fired .	米国人男性が中国に仕事をアウトソース、猫動画でサーフィンを楽しむ
アフリカ : 今週のニュース トップ5は...-	アフリカの今週のトップ5ストーリー
ノートルダムのラインバッカーが、自分はデマの被害者だと言っている。	ノートルダムのラインバッカーがデマの犠牲者であると発言。
薬が効かないとき、このオプションでC-diffを治すことができます。	気持ち悪い、かもしれない、でも治療は有効、との研究結果。
親愛なるアビー、私たちはすでにあなたが恋しいです。 マーガレット・フォックスがあなたの追悼文を書いてくれて、あなたはどれほど幸運でしょうか？"親愛なるアビー、94歳で死去"	親愛なるアビーとして数百万人の相談役を務めたポーリーン・フィリップスさん、94歳で死去
データ十字軍、被告、そして今、大義名分 # aaronswartz # mitfail # badbranding	アーロン・スワーツ、データ・クルセイダー、そして今、原因とは？
アメリカン・ヒーローはいかにして地球に落ちてきたのか？	えいゆうごうけつ
チベット人男性、抗議のため再び焼身自殺。	チベット人による中国支配への抗議としての焼身自殺
より正確には（キャッチーではないものの）「インドは2位」であり、「負けている」わけではないのですが、それでも興味深いです。	オピニオネーター : インドは競争に負けている
CIAに秘書課に配属されたジャンヌ・ベルテュフィーユ、80歳で死去。	ジャンヌ・ベルテフィーユさん死去、80歳、アルドリッチ・エイムズ捕獲に協力
Nytimes : ゲイによる「プロパガンダ」がロシアで規制されつつある。	ロシアでゲイによるプロパガンダが規制される。
ニュータウンの犠牲者の家族は、 # 銃暴力についての答えを探す # NRA	ニュータウンの学校での大量殺戮の犠牲者の家族が銃暴力に反対して組織された。
ホッファが埋葬されている場所は確かだと言っている。	マフィア犯罪で有罪判決を受けた男が、ホッファの埋葬場所を「確かだ」と言っている。
nytimes : How to get america online - 巨大ISPの規制に関する優れた論説。	寄稿：高速インターネットを全アメリカ人に普及させる方法
ナイトクラブを禁止する時期	ブラジルのナイトクラブで火災が発生し、数百人が死亡。
リンジー＃ローハンを映画に起用するとこうなる」＆撮影現場に無制限でアクセス可能 : 極上ジャーナリズム.	リンジー・ローハンを起用すると、こうなる。
北朝鮮は南に怒りを向ける #北 #南 #韓国 #国連 #制裁 #戦争 #R2P	北韓は南韓に矛先を向ける
カソリック病院が胎児は人間ではないと主張したことに衝撃を受ける	カトリック病院の弁護士、胎児は人ではないと主張
アームストロングの告白は、彼のおとぎ話が真実だと考えていたすべてのがんサバイバーとサイクリング・ファンを破滅させた。	アームストロングにとっては、説明のない自白である。
これは、ブラジルで起こったことです。	ブラジルのナイトクラブで火災が発生し、数百人が死亡。
真実はより高い基準であるが ... : ドーピングを認めたランス・アームストロングに本の返金を求める読者の訴え	読者が本の返金を求めてアームストロングを提訴
ボーイング787型機の地上走行に関するNYの記事	米国連邦航空局、米国で運航するボーイング787型機の着陸を命令
aww ? : ブリトニー・スピアーズ、婚約解消 ?	ブリトニー・スピアーズ、ジェイソン・トラウィックの婚約を解消
2013年赤ちゃんの名前ランキング - ( おや、私の名前がない ; o ) )) )	parenting.com 'sのトップベビーネーム
これは問題であってはならないことだ。 準備完了。	障害者アスリートのスーツ姿に、ロジスティックスと公平性に疑問の声も
damn smh " : ブラジルのナイトクラブで火災、死者220人に。"	ブラジルのナイトクラブで火災が発生し、数百人が死亡。
ということで、「スター・ウォーズ」の実写版テレビシリーズをABCが検討することになりました。	ABC、「スター・ウォーズ」実写版シリーズを検討中
オンラインコースには、やはり人間の要素が必要です ...	オンラインコースは、教育するために人間の要素が必要です。
銃禁止論は続いているが、罪のない人々の武装を解除する以外に本当に解決になるのだろうか？# pols1101	もう十分だ」とフェインスタインが新たな銃禁止令を提案
派遣会社の歴史：60年代の性差別を利用して、強力な労働組合の目と鼻の先で「拡大」する。"	オピニオンリーダー｜The Great Divide : 常用型派遣の台頭
ロバート・ウルフと彼の新会社、オースタン・ゴールズビーが素晴らしい人物であることがわかった。	ロバート・ウルフがグルスビーを自分の会社の顧問として雇うと言われている。
アーメン" : 良いニュースです......私のシェロ・ロビン・ロバーツは2月に「グッドモーニング・アメリカ」に戻る予定です... "	media decoder blog : ロビン・ロバーツ、2月に「GMA」への復帰を計画
モンゴル教会から貴重な遺物を盗んだのは誰？	ミズーリ州の教会から貴重な聖遺物が盗まれたのは誰？
firefly : 2015 is happening ......as a nasa mining vessel .# fireflyreturnskinda	ホタルが宇宙の岩石を採掘する
アルジェリアがマリに報復攻撃、との報道	アルジェリア・ガス田の攻撃で英国人死亡
こんな男になりたい # paultheroux 私の # 旅行願望リスト via	ポール・セローの旅行リスト
通勤に40マイル、バイクで。-- 信じられない	サーマルとフリースで40マイルの自転車通勤。
預けられたムスリムブラザーフッド	エジプト、制御不能の衝突を鎮めるため、スエズ運河に軍を配備
私の人生には「停止日」が必要だ。# cnn	ストップ・デー」の重要性
シリアにおけるクラスター爆弾の悲惨な犠牲者」という素晴らしい記事があります。	クラスター爆弾の凄惨な犠牲
タルムード・ブログを通じて、イスラム帝国におけるユダヤ人の生活を紹介する。	古代イスラム帝国におけるユダヤ人の生活を明らかにする文書
ケイティ・コウリックとマンティ・テオのインタビューのハイライト	the lede blog : ケイティ・コウリックとマンティ・テオのインタビューに関する最新情報
スキーをサポートするアプリ : via ny times	app smart : アプリがゲレンデをもっと楽しくする - app smart
先週末、オープンアクセスの提唱者の死を悼みました ~ データ活動家、被告、そして今、原因	アーロン・スワーツ、データ・クルセイダー、そして今、原因とは？
nsfw ? : obit opening I've best obit in a long time. 親愛なるアビー、94歳で死去 ?	親愛なるアビーとして数百万人の相談役を務めたポーリン・フィリップスさん、94歳で死去
食文化は少し行き過ぎかもしれない...手の届かない贅沢な食の世界	大都会 : 新世代が直面する、手の届かない贅沢な食卓
私はこれを読んでみたい。 mt : 子供にダイエットをさせ、それについて書いたDL Weissのインタビュー。	motherlode blog : 7歳の子供にダイエットをさせ、それを本にしたダラ-リン・ワイスのインタビュー。
Nytは、シェルの北極圏でのトラブルに関する良い記事の中で、「つぶれたビール缶」騒動に関する記述を誤っている。	ライバルはシェル北極圏掘削の苦難を見守る
隣のプレッパーズグループに入りたい人は？	ニューヨークの終末予言者たち
アームストロングはドーピングを認め、証言すると言っている。	アームストロング、ドーピングを認め、サイクリング関係者に証言すると発表
保安官：オバマの銃刀法には従わないよ。	保安官は「違憲の」銃刀法を施行しない
ドリームライナーのバッテリーをntsbが研究 ( via instapaper )	NTSBがドリームライナーのバッテリーを研究していることは否定できない。
ハードルを上げる、いい動きだ"ウォルマートは仕事を求める退役軍人を雇う予定だ"	ウォールマート、退役軍人の雇用に関する大規模な計画を発表へ
NYTIMES : アップルは大きいかもしれないが、ベルウェザーではない（私のコラム）。	戦略 : apple stock isn't a bellwether, even if it's big ?
schrecklich !😢 " : ブラジルのナイトクラブで火災、少なくとも90人が死亡 "	ブラジルのナイトクラブで火災が発生し、数百人が死亡。
フェイスブックの運命は検索にかかっている-これが大きな手がかりか？	フェイスブックの運命は検索にかかってるかもしれない
タイで # 国王を侮辱したら # どんな代償を払うのか？活動家ソミオット・プルサカセムスックに懲役10年	活動家、王に対する侮辱で10年の刑を受ける
sheriff : I won't enforce obama 's gun laws he 's 1 black guy, they r us laws & calm down # overparanoia & racism	保安官は「違憲の」銃刀法を施行しない
電子記録から健康データを抽出することは、医学研究に大いに役立つが、必ずしも医療費の削減につながるとは限らない。	ヘルス・データ・マイニング
nytimes : 「マッドメン」、4月7日に再登場。	Artsbeat : 「マッドメン」、4月7日に再登場
ギリシャのFM：ギリシャがEUを脱退する可能性は低い	ギリシャのFM：ユーロ離脱の可能性は低い
「パパ、私が友達なのは本だけだよ# malala # womenonthefrontline	女性のための戦いの最前線
読者の質問に対する彼女の回答は貴重です。 ベーコンを炒めるを読んで、あなたは感動することができました。	親愛なるアビーとして数百万人の相談役を務めたポーリーン・フィリップスさん、94歳で死去
中国のアウトソーサーに「4時間労働」の教祖：悪いカルマ - CNNインターナショナル	アウトソーサーで「4時間労働」の達人
パート4：#fafsa # finaid # scchatについてのご質問にお答えします。	the choice blog : パート4 : ファフサについての質問にお答えします。
兵役中の女性にとって最大の安全上の懸念は、同志からの性的攻撃の危険性であるという冷ややかな事実。	コラムニスト：女性軍人と最前線
退役軍人に敬意を払え！ ウォルマート、希望する退役軍人の雇用を計画	ウォールマート、退役軍人の雇用に関する大規模な計画を発表へ
" : 速報 : ブラジルのナイトクラブで250人が死亡、200人以上が負傷。" クレイジー	ブラジルのナイトクラブで火災が発生し、数百人が死亡。
「パネッタ国防長官、ローマ法王に謁見「祈ってくれ	パネッタ国防長官、ローマ法王に面会
ジョン・ケイル・イン・パリ・アンド・ボーダーライン .# 音楽	Q＆A：ジョン・ケイルとパリで、そしてボーダーラインで
ロンドン演劇界の新星が語る「ビンラディン」。	op-ed contributor : I played osama bin laden in ? ゼロ・ダーク・サーティ ?
キャスティング : リンジー・ローハン、借金地獄、ポルノスター。	リンジー・ローハンを起用すると、こうなる。
スリランカのメイドの処刑を擁護しようとするサウジアラビアのモンスター # p2 # tcot	サウジアラビアがメイドの斬首刑を擁護
彼はビジョンを提供することはありませんし、彼は誰2bring itを使用しますか？ ウィンフリーの低格付けケーブルチャンネルは、突破口を開く態勢を整えています。	ウィンフリーの低視聴率ケーブルチャンネルがブレイクする。
必読！】トルコがクルド人と和平を結ぶには？	トルコがクルド人と和平を結ぶには？
40年にわたる結婚生活と、ゲイの息子の闘争がいかに結束を強めたかについてのNytの素敵な記事です。	保守とリベラルの出会い、そして40年の結婚生活。
マリで何が起きているのか？@	フランスがマリで空爆、反政府勢力の進出を阻止と発表
ギャビーとマーク：銃規制の新しいブラディたち # tgdn libs play dirty as norm	銃規制の新しい「ブラディ」たち？
NRAのビデオゲームは偽善のにおいがする # NRA # guncontrol	NRAのビデオゲーム偽善
frum : # us .# gun problem is not a race problem	アメリカの銃の問題は、人種の問題ではない
オンライン署名を始めた子供から。 NYTIMES : ペプシコはゲータレードの添加物の使用を停止する。	ゲータレード、ティーンエイジャーの声を聞き、処方を変更
アル・パチーノ、ブライアン・デ・パルマ監督の映画『ハッピー・バレー』（仮題）でジョー・パテルノ役に決定 # sportsbiz	パチーノ、映画でパテルノを演じる
source say at least 150 " : ブラジルのナイトクラブで火災、少なくとも90人が死亡と当局が発表。"	ブラジルのナイトクラブで火災が発生し、数百人が死亡。
NYTIMES : ダーウィンを論破する。 デートについて彼は間違っていたのか？# セックス # ジェンダー	オピニオン : ダーウィンはデートについて間違っていた
she owns it business groupから...ビジネスを成長させ、従業員を支援するためのさらなるアイデア。	you're the boss blog : ビジネスを成長させ、従業員を支援するための考え方
まあ、少なくともスライドが動くことはわかったわけですが。	ボーイング787型機、日本航空が地上待機に
nytimes : what we don't know is killing us -couldn 't agree more ! e.g., ipv homicides and guns is critical .	editorial : What we don't know is killing us.
bhoの銃の提案2は、エリートだけがprtctdするように、アメリカ人を完全に武装解除するための手順で、大量殺人を超えて見てください。	オバマ大統領、銃乱射事件の先を見据えた銃を提案
シリアにおけるクラスター爆弾の死者数	クラスター爆弾の凄惨な犠牲
ナプキンに「この食事は私たちのおごりです」と書いておくことです。	ナプキンのメモ：「この食事は私たちのおごりです。
ジャッキー・ウィーバーがNYタイムズに語ったところによると、「オーストラリアには友人がいて、彼らは私のことを "ハリウッド・ジャック "と呼んでいます。?	ジャッキー・ウィーバーとグリニッジ・ビレッジの領主
冬に咲く花？ 椿は私の好きな多年草の一つです。	in garden : 寒さに備えた椿の花。
go # obama . obama calls for broad action on guns.	オバマ大統領、銃規制の強化を議会に要請へ
パキスタンは「#南アジアの#ドリームライナー」になるのか？- アシュラフ首相の逮捕命令を拒否する政府関係者	パキスタン政府高官、首相逮捕の命令を拒否
グーグル、iphone向けアプリの開発で利益を得る # healthit # hcsm	グーグルは野党のアプリを作ることで利益を得ている
私は間違いなく、無名の楽譜とコンサートチケットに費やしていました。# misspentyouth	大都会 : 新世代が直面する、手の届かない贅沢な食卓
世代間ギャップ？ このサイトにはない（ハーバード・ビジネス・スクール）	40代以上の女性のための20代向けサイト
エディ・フアンがNYタイムズに登場。	eddie huangは説明不要です。
ランジェル：軍隊をもっと平等に？ 徴兵制を復活させよう # 配備 # usaf # 軍	より平等な軍隊、徴兵制の復活
フランス、マリのジハード主義者に立ち向かう	フランス、マリのジハード主義者を阻止することを誓う
大学にはたくさんの団体やクラブがあり、圧倒されます！時間を割く前に、慎重に選びましょう。	THE CHOICE BLOG : 大学生からのメッセージ : キャンパスで見つける自分らしさ
笑って......えーと......アメリカでの「実験」？# damn ! : 北朝鮮、新たな核実験を対米戦の一環と発表 : ?	北朝鮮が米国に対して新たな脅迫を行った。
# morsi ? s slurs against # jews stir concern オバマ政権の中に英語の読み方を知っている人はいるのか #?	モルジーのユダヤ人に対する中傷は不安を煽る
「vineはtwitterが動画のinstagramになろうとしたものです。	vineは、「ビデオのインスタグラム」を目指すツイッターの試みです。
マーク・サンフォード、元南カロライナ州知事で「アパラチアン・トレイルを歩く」、下院議員に立候補する。	元南カロライナ州知事のサンフォード氏、下院議員に立候補へ
2013年に行くべき場所 by !」は、これら「2013年に行くべき場所」のほとんどを、洞察に満ちた形で紹介しています。	2013年に行くべき46の場所
ピーターがトップ10に入ってないのに、モ、バーティ、ガスが入ってる？" 2013年 赤ちゃんの名前ランキング "	parenting.com 'sのトップベビーネーム
nytimes :# queens # school is locked down after # gun is found in 7-year-old ? s backpack is there no end ?	クイーンズ校の7歳児のリュックサックから銃が発見される。
what choo talkin ' bout mr......rip conrad bain, father on ? diff ? rent strokes ?, dies at 89	コンラッド・ベイン、「Diff & Rent Strokes」の俳優、89歳で死去。
フェイスブック、新しい検索ツールを公開 :	bits blog : フェイスブック、新しい検索ツールを公開
# ♪一世代のための銃規制改革	社説：オバマ大統領の銃規制改革案
コーラの主成分は砂糖？ 広告で、コーラはソーダと肥満の関連性に立ち向かう	コーラのテレビ広告は、肥満とソーダの役割に直面しています。
住宅市場の回復に関する優れた分析 - 住宅は経済の強さの希望となる	High & Low Finance : 景気回復を示唆する住宅市場の兆し
ウィリアムズのスタートは速かったが、ペースはロケッツに合っていた。	ウィリアムズが好調な滑り出し、しかしネッツはロケッツに敗れる。
Quebra tudo !!J.J.エイブラムス、「スター・ウォーズ」次回作の監督に決定	J.J.エイブラムス、「スター・ウォーズ」次回作の監督に決定
ワオ：アナウンスでは、仕事を希望する退役軍人をすべて雇用する計画で、いくつかの条件を付けている。 10万人以上の雇用を見込んでいる。	ウォールマート、退役軍人雇用のための大規模な計画を発表へ
イギリスでは、バスケットボールは、タフなsellwhyになることができます英国はプロのBBを打つ興奮するだろう、彼らは退屈しないように "サッカー "を得た。	イギリスでは、バスケットボールを売るのは難しい。
ブラジルのナイトクラブで火災が発生し、少なくとも90人が死亡した " Kroppは間一髪でその国を去った。	ブラジルのナイトクラブで火災が発生し、数百人が死亡。
ダッチオートマット ダッチクッキングに活力を与える	ダッチクッキングにスパイスを効かせる
フィラデルフィアで地下鉄が襲撃され、男が拘束された Omg !	フィラデルフィアの地下鉄で女性が線路に投げ出され、男性が拘束されました。
戦争法は誰が決めるのか、それは文民の法廷に属する。	ニュース分析：軍事法廷と国際戦争犯罪
元アラスカ州知事のサラ・ペイリン、FOXニュースのコメンテーターから外れる	Fox NewsとSarah Palinが決別
ニューヨーク州議員、銃規制の変更で合意 悪の元凶	ニューヨーク州議会議員、新銃法の早期採決に期待
ランス・アームストロング [ 最終 ]ドーピングを認め、証言すると発表	アームストロング、ドーピングを認め、サイクリング関係者に証言すると発表
香港は54.1mbpsで、インターネット速度のタイトルを獲得しました。	香港がインターネット・スピードのタイトルを獲得
正義はどこにある？「黒人だから轢かれた	被害者の息子 : ヘイトクライムだったんだ
休職していた医師が再び診療を開始したことを反省している。	医者と患者 : 医者が医者に戻るとき
シーンは「2.5 MEN」に戻ることを望んでいるが、彼の過去のイメージがそれを台無しにしている？# coepr205	シーンが「Two and a Half Men」に戻ることを望んでいる。
インドにおける女性の課題。	インドにおける女性としての挑戦
nytimes : リチャード・G・スターン、作家か、84歳で死去 大きな損失。	作家のリチャード・G・スターン氏が死去、84歳。
物語のインパクトから読み解くファンタスティックな物語： " ... アルゴリズムではなく、物語は、私たちの多忙な世界に秩序を与える。"	オピニオン：テレビは、考える人のためのエンターテインメントである。
" 2012 : the year of extreme # weather " :# climatechange # drought # nationalclimateassessment # globalchangeresearch	地球観測ランデブー : 2012年 : 異常気象の年
甘い、甘い物語。 NYTIMES : 人形の魔法、更新の自由。	a doll's magic , free to renew
新たな住宅ブーム？それは当てにならない - ロバート・J・シラー著	新たな住宅ブーム？
" ( イギリスのお気に入り ) " 相棒 なぜ人を殺さない？ 寒すぎる。" -ここ9日間のNYCの殺人者たち	寒波でニューヨークの殺人事件が大幅に減少
ホワイトハウスは独立の嘆願を拒否したが、テキサス州民は戦い続けている。	テキサス分離独立運動、ホワイトハウスに拒否されても屈せず
教員組合評価で合意せず、NYは4億5000万ドルの損失リスク	ニューヨーク市、教員評価について協議
Nytimes : 新たな住宅ブーム？	新たな住宅ブーム？
中国の「ファイアウォール」の背後にある戦い	中国の「グレート・ファイアウォール」の向こう側で働く。
nytimes : アームストロングとウィンフリーのインタビューの分析 それは恥だ（しかし我々はそれを知っている） # congrutalionlance	the lede blog : アームストロング氏のオプラ・インタビューをライブでお届けします。
インドには "too many s * tty men "がいる : Another gang rape	バス連続強姦事件で6人を逮捕
ウォッカは命を救っている！まあ、子犬の命だけど...。	酒が子犬の命を救う
JL # NYT : 米軍、アフガニスタンでの拘束を一部停止 # P2 # トップログ	米軍、人権への懸念からアフガン刑務所の一部で被拘束者の派遣を停止
パリで開催された # クチュール展 のストリートスタイルが好きだ # ファッション	T magazine : パリのクチュールから生まれたストリートスタイル
多くの人に（自分も含めて） #ランスアームストロング にもう一度チャンスを与えるに値するかどうか聞いてみた。 興味深い意見だ。	ランスにもう一度チャンスを？
撮っておけばよかったと思う旅の写真	今日の一枚：タイのお寺
# pentagon to lift combat ban for women ... how about banning combat for men ?ペンタゴンは女性の戦闘を禁止する。?	ペンタゴン、女性の戦闘参加禁止を解除
慈善活動（イメージアップも） # セレブリティ # チャリティ	The carpetbagger: doing good ( and burnishing images, too )
イランの通貨がさらに下落 銀行取引に対する米国の圧力で	イラン通貨、銀行への懸念でさらに下落
猫カムの調査では、4匹の猫が飼い主と二股をかけていたことが判明 , 'と、この猫の物語の中でより多くの。	ウェル・ペット : 猫のホリーの驚くべき旅路
組合員数は97年ぶりの低水準、11.3％に落ち込む。人々はまだ、すべてのためにそれらを非難する方法を見つけるでしょう。	雇用の増加にもかかわらず、組合員数は減少
食べ物にそんなにお金をかけるなんて、そんなのバカげてる : ) 食べ物という手の届かない贅沢品。	大都会 : 新世代が直面する、手の届かない贅沢な食卓
CNN app for android から送信されたブラジルのナイトクラブの火災で少なくとも245人が死亡。	ブラジルのナイトクラブで火災が発生し、数百人が死亡。
# グーグルは、iPhone用のアプリを作ることで利益を得ています。	グーグルは野党のアプリを作ることで利益を得ている
Sun ( # oracle ) と一緒になって！国土安全保障省は、ユーザーにJavaを無効にするよう警告しています。# サイバーセキュリティ	障害 : 米国機関がジャバ・ソフトウェアの問題を警告
unreal ? : もし、ボリショイ監督への酸の攻撃を知らないなら．?	ロシアバレエ団監督へのアシッドアタック
悲劇的な、私の思考と祈りは、すべての人に送られます..." ブラジルのナイトクラブで火災、少なくとも220人死亡 "	ブラジルのナイトクラブで火災が発生し、数百人が死亡。
爆発的な可能性を秘めた法廷闘争：カソリック病院、胎児は人ではないと主張	カトリック病院の弁護士、胎児は人ではないと主張
カイル・スタンレー、トーリーパインズでリードを奪われた痛手から脱出 : カイル・スタンレーは今週、トーリーパインズに戻ってきた。	カイル・スタンレー、トーレパインズでリードを奪われた痛手から脱出
希少性と財務上の意思決定 .	借金で首が回らなくなった。
なんてこった！ : ( " 2 killed as helicopter crash into crane in central london " )	ロンドン・ラッシュアワーにヘリコプターが墜落
アレルギーいじめは、現実の問題である。	アレルギーいじめ：食べ物が武器になるとき
世界はオプラのアームストロングのインタビューを待っている。	世界はオプラのランス・アームストロングとのインタビューを待っている - しかし、それは何かを変えるだろうか？
米国における15-24歳の死因の第2位は殺人、このうち5人中4人が銃によるものである。	アメリカは健康診断で落第する
子どもたちに貸し出す「図書館人形」。	a doll's magic , free to renew
上院がワシントンを立て直すカギを握っている - その洞察に感謝する # p2 # tcot	上院は、ワシントンを修正するための鍵です。
#キューバは熟練者の渡航を制限している	キューバ、スポーツ選手や労働者の渡航を制限
政府支出の増加をもたらしているもの # facts	政府支出の伸びの原動力は何か？
この子に拍手を送りたい。!ペプシコはゲータレードへの添加物の使用を停止します。	ゲータレード、ティーンエイジャーの声を聞き、処方を変更
オバマの支持する銃法案は望み薄だ " これは私と大統領が偶然にも同意する一つの問題だ。"	改革は現在の議会では難しい
マスコミの感情報道を超えて、# Clinton put out good info : ベンガジ公聴会から学んだ5つのこと	ベンガジ公聴会から学んだ5つのこと
2 # フランス : 私たちはあなたが思うような平和主義者ではない	フランスはなぜ平和主義国家でないのか
ルールを変える＝ロムニー大統領：「：選挙人団の変更は民主党に危険をもたらすだろう	fivethirtyeight : 選挙制度の変更は民主党にとって危険である。
テレビで見たとおり~ 黒くて有名だけど放牧されてる	critic? s notebook : 「ハリウッドの本当の夫たち」と「黒人男性主人公の不足」。
レポート：アルジェリア軍、人質650人を解放	アルジェリア人質事件での恐怖と混乱
コービー・ブライアント、妻が離婚を撤回 - 正しい理由のために一緒にいることを祈る	コービー・ブライアント夫妻、離婚を撤回
マリ北部で手足を切断され、命を奪われた人々の悲惨な物語。	マリで手足が折れ、命が奪われた
# NHLの選手たちは労働協約について投票を開始し、土曜までに承認される見込みです # abasal # antitrust	スラップショット : NHLの選手たちが労働協約について投票を開始、土曜日までに承認の見込み
50歳以上、そして50歳以上の幻想を抱くことなく、毎日自分自身を発明すること	5人の高齢者がキャリアを再構築するチャンスをつかんだ理由
ユーザーレビューの力-善にも悪にも使えるか？ nytimes : ネットで本の群れを作る	amazonの戦場での犠牲者 ?パルチザンの書評
クールなもの：CES 2013で見た6つのトレンド-。	セシウム2013の6つのトレンド
ブラジルのナイトクラブで火災、少なくとも233人死亡 ... : (	ブラジルのナイトクラブで火災が発生し、数百人が死亡。
悲しいニュース：ブラジルのナイトクラブで245人が死亡。	ブラジルのナイトクラブで火災が発生し、数百人が死亡。
痛い、もしかして？" : NYTIMES : 日本のビジネス文化がボーイング社のバッテリー選択に漂う "	常識：ボーイング787のバッテリーメーカー選定に疑問の声
偉大で感動的な精神の喪失！インターネット活動家、RSSの作成者、26歳で死去、自殺のようです。	Aaron Swartz、インターネット活動家、26歳で死去
刑務所の時間だ、チャーリー・ブラウン	チャーリーブラウンが起訴されました。
ついに真実が明らかに...アームストロングがドーピングを認め、証言すると発言。	アームストロング、ドーピングを認め、サイクリング関係者に証言すると発表
私は、バカにしてるんだ！!Nytimes : モルシ、ユダヤ人への中傷は文脈を無視したものであると語る。	モルシ、ユダヤ人への中傷は文脈から切り離されたものだと発言
スキーヤーやスノーボーダーであれば、これらを掘るでしょう：雪の斜面で、指はタッチスクリーンを滑る。	app smart : アプリがゲレンデをもっと楽しくする - app smart
デビッド・ガーゲンは、オバマの第2回就任式は分裂を深めるだろうと言っている。# didn't see itcoming	オバマ大統領の歴史的な演説は分裂を招くものだったのか？
シリアにおけるクラスター爆弾の恐ろしい犠牲者についての記事を読んでください。	クラスター爆弾の凄惨な犠牲
米国がモールプへの関与を強化 # pppj # # pl # # # p # # p	米国、マリへの関与を強化
私は銃を追いかけたが、オバマも同じだ。	論説委員：オーストラリアは突撃兵器を禁止している。
王立軍は監視網を構築していたのか？- 中国の党と企業幹部がセックススキャンダルで解雇された。	中国当局がセックススキャンダルで解雇
nytimes : いつものように、彼女は（めったに）ボスがスマートだ。	論説委員：彼女は（まれに）ボスである。
wow " : ブラジルのナイトクラブで火災、少なくとも245人が死亡 最新情報 : "	ブラジルのナイトクラブで火災が発生し、数百人が死亡。
hot # luxury news : 日本航空、緊急着陸でドリームライナーの運航を停止 ?もっと見る	日本航空、ドリームライナーの緊急着陸を受け、運航を停止
今日のCNNのコラムを読んでみてください。	アメリカの銃の問題は、人種の問題ではない
# breaking :# police clash with # protesters calling for dissolution of # pakistan's government - (パキスタン政府の解散を求めるデモ隊と警察が衝突)	パキスタンで警察とデモ隊が衝突
ムバラクが牢屋に入る	エジプトのホスニ・ムバラク氏、再審に臨む
オバマの銃規制案で、人々の権利が損なわれているのはどこなのか？	オバマの銃規制案の中身は？
これは変だ！ チッ- カソリック病院、胎児は人ではないと主張	カトリック病院の弁護士、胎児は人ではないと主張
銃規制を推進する大統領に関する彼の作品について、プレスプールで話し合うことができるのは素晴らしいことです。	ビデン氏、銃乱射事件に関する提案で下院民主党員と会談
アメリカの古典的な名声と責任のなすり合い。	論説委員：ランス・アームストロングのポイント
# ジョコビッチ、パリ・パーティに照準を合わせる	ジョコビッチ : オージー3連勝
# パキスタン首相、火災調査に介入	パキスタン、アシュラフ首相が火災事故の調査に介入
キンシップ・ケアと兄弟姉妹 : #養育年数を経て、ある女性が姉妹のロールモデルとなる	最も困難なケース：里親の後、姉妹の模範となるために
まにあわせることができそうだ	GOPは銃規制の提案に難色を示す
ベールをはぐように、慎重に。	テレビウォッチ：ジョディ・フォスター、ゴールデン・グローブ賞でベールを脱ぐ
面白い作品だ！ ビン・ラディンという存在 # 映画 # ゼロダークサーティ	op-ed contributor : I played osama bin laden in ? ゼロ・ダーク・サーティ ?
u ds boi ehn " : Piers、AR-15についてゲストを非難する "	ピアーズ、ゲストがAR-15をめぐって衝突
本日の駄文(ニュース) " : インドのレイプ被害者、警察がしばしば問題視される "	インドではレイプ被害者のために、警察も問題の一部であることが多い。
マスコミの大キャンペーンに支えられ、人気投票で当選した気骨のないポピュリスト # ゼマン # チェコ共和国	チェコ共和国大統領に元首相が選出される
アートリー : 1000万人のフォロワー獲得	ツイッターで1000万人のフォロワーを獲得する方法
彼女は破産を申請しています。	ケイシー・アンソニー、破産を申請
# ♪マリはフランスのアフガニスタンである必要はない	イラク戦争：マリはフランスのアフガニスタンである必要はない
悪との戦い？ 社会病質者との戦い？ 銃を禁止することは、ドラッグとの戦いよりもずっと効果がありそうですね。	オバマ大統領、銃乱射事件の先を見据えた銃を提案
中国の大気汚染はひどいとニュースで言っていました。	中国、大気汚染の危機を報じるメディアを許可
英雄的な医師がコンゴに戻る	医師がコンゴに戻り、英雄と称えられる
NYTIMES : 宇宙開発競争のリーダー、D.ブレイナード・ホームズ氏、91歳で死去。	D. ブレイナード・ホームズ、NASA最高幹部、91歳で死去
179人の共和党員が反対票を投じ、下院は507億ドルのサンディ被災者向け緊急支援を承認した。	下院、暴風雨被災者への緊急支援507億ドルを承認
ノーベル賞受賞の経済学者が語る # 気候変動に関心を持つべき理由 .	温室効果ガスと権利支出の非等価性について
NY MOST EMAILED : ペンタゴン、戦闘任務に就く女性の禁止を解除へ : 画期的な決定で、199の禁止事項を覆す。	ペンタゴン、女性の戦闘参加禁止を解除
二人が会ったことがないなんて、そんなの信じられるわけがない。 イメージがパズルのように膨らみ、テ○○○○説が渦巻く。	マンティ・テオのイメージは、様々な説が飛び交い、パズルと化した。
アメリカの英雄がカナダ人になるとは？ Nyt : テヘランでアメリカ人を保護した男性、88歳で死去。	テヘランで米国人を保護したカナダ人、ジョン・シアダウン氏、88歳で死去
ヴァンパイア・ダイアリーズ」のスピンオフ作品がCWに登場、本拠地はノラ！？	ヴァンパイア・ダイアリーズ」スピンオフパイロット、CWに登場
2D-guessingの中で、貧しい生き物の山は、海洋救助隊は、ゴワナス運河から被災イルカを削除しないことを決定した。	イルカを助けないという苦渋の決断
CNN : エジプトの衝突 : サッカーの暴動に関連したエジプト裁判所の厳しい判決は、少なくとも30人が死亡した衝突に拍車をかけました。	エジプト、制御不能の衝突を鎮めるため、スエズ運河に軍を配備
ランス・アームストロングの名言集、ピュアゴールド	ランスの名言
ガス代が少し上がる	ガス代はわずかに上昇
インドのスター、サニア・ミルツァが語る「メディアと結婚」。	ストレート・セット : インドのスターが語る、メディアと結婚すること
親は原点と定義される。 私はまだ、ベンにとって最高の親になりきれていない。	ニュータウン学校虐殺事件の犠牲者の家族が銃暴力に反対して組織された。
ジョディ・フォスターの発言を分析する 正直に言うと、彼女が何を言っているのか分からなかった。# ゴールデングローブ	カーペットバガー：ジョディ・フォスターの発言とその分析
インターネット活動家でRSSの生みの親であるアーロン・スワーツが26歳で死去、自殺とみられる。	Aaron Swartz、インターネット活動家、26歳で死去
MT : NY州保健局長、病院を避難させなかった決定を擁護 ㊧災害時のオムツ交換の重要性	ニューヨーク州保健局長、病院を避難させないという決定を擁護
糞の役にも立たないような場合．	気持ち悪い、かもしれない、でも治療は有効、との研究結果。
プロサイクリングを活性化させる経済と文化に関する良い記事。 nytimes : looking upstream in doping cases.	批評家たちは、ドーピング・スキャンダルの川上に目を向ける。
# wal-mart plans to hire any # veteran who wants a # job.	ウォールマート、退役軍人の雇用に関する大規模な計画を発表へ
ひどい別れ方だ．" : ブラジルのナイトクラブで火災、少なくとも220人死亡 "	ブラジルのナイトクラブで火災が発生し、数百人が死亡。
高齢者のケア：食の機会は車いすより多い。	調査：食事よりも宅配に注目
nytimes : 話す、歩く物体（これはギークな私のファンタジー世界です。）	opinion : 私たちの話すこと、歩くこと
uciの社員はパンツを履き替える必要があるようだ Nytimes : アームストロングがドーピングを認め、証言すると発表。	アームストロング、ドーピングを認め、サイクリング関係者に証言すると発表
なんて馬鹿なんだ・・・Nytimes : アームストロング、ドーピングを認め、証言すると語る。	アームストロング、ドーピングを認め、サイクリング関係者に証言すると発表
パキスタンの首都を脅かす「100万人の行進」 - CNN ,	パキスタンの首都を麻痺させる「百万人の行進」を約束する
これは、エンターテイメントとして素晴らしいものになると思います。	サウス・パーク」のクリエーターが会社を設立
" : チャーリー・ブラウンの声 逮捕され起訴されました ... " 彼が "やれやれ "と言ったと言ってください ...	チャーリーブラウンが起訴されました。
は、この反自由な言論の新しいフランスの法律は、Twitterは人種差別的な、反ユダヤ主義のポスターを識別する必要があります、経由です。	仏裁判所：ツイッターは人種差別主義者のユーザーを特定しなければならない
インフルエンザの季節がやってきました。「インフルエンザにかかったら予防接種は必要？"	ask well : インフルエンザにかかったら予防接種は必要ですか？
コービー・ブライアント、妻が離婚を取りやめると発表。	コービー・ブライアント夫妻、離婚を撤回
チェルシー・クリントンによる、今週土曜日のボランティア活動についての感動的な記事（National Day of Service	クリントン：We can make a difference
オピニオン誌の「親と教師の関係」を読みましたか？ ライザ・リーはインタビューに答えています。# edchat	オピニオンリーダー｜学校教育：危険な親と教師の二重奏
マットデザインはテクノロジーに匹敵する重要性を持つようになりました。	disruptions : ディスラプション : デザインが技術を進化させる
ゴスロリの美味しさを堪能できる10の理由	ゴスロリに飽き足らない理由 ( duh ! )
不完全なパッチによるJavaの脆弱性 ( から )	以前のパッチが不完全であったため、Java に重大な脆弱性が存在する。
nytimes : 親愛なるアビーの素晴らしい追悼文。	親愛なるアビーとして数百万人の相談役を務めたポーリーン・フィリップスさん、94歳で死去
ロボットが製造業の競争力を高める	ロボットメーカーが世界に広める自動化の福音
フロリダ州のビルマニシキヘビ問題で、ヘビ退治コンテストが開催される.- ...	フロリダ州、ニシキヘビの狩猟コンテストに挑む
殺人事件の追跡サイトが # シカゴ に進出。	media decoder blog : 殺人事件追跡サイトがシカゴに進出
180 !" : ブラジルのナイトクラブで火災、少なくとも90人死亡 "	ブラジルのナイトクラブで火災が発生し、数百人が死亡。
投資で「引き分けを狙う」方がいいのか。	戦略 : 投資では、少なくとも引き分けを狙うのが合理的です。
運動でインフルエンザ予防接種の効果を高める	運動はインフルエンザ予防接種の効果を高める
オバマのために？新学期、ここからスタート - nick kristof for news	論説委員：オバマ大統領の2期目はここから始まる。
最悪の悪夢" : ブラジルのナイトクラブで火災、少なくとも245人死亡 更新 : "	ブラジルのナイトクラブで火災が発生し、数百人が死亡。
誰かこれを試しましたか？AmazonがあなたのCDを無料でmp3に変換してくれます。	amazonがあなたのCDのmp3を無料で配布しています。
くそー、ロンドンの霧についてそんなに悲観的になるべきじゃないかもしれない。	ロンドン・ラッシュアワーにヘリコプターが墜落
# ♪ニューヨークのスクールバスの運転手がストライキをする ♪ニューヨークのスクールバスの汚職と場合によっては組織犯罪	ニューヨークのスクールバス運転手がストライキに突入
すでに国境を越えて捕まった人たちに市民権を与えるというのはどうでしょう？# citizenship path in one fast push	オバマ大統領は市民権取得への道を一気に進めるだろう。
良い読み物だと思います。	両親の経済的支援と大学の成績の関連性
J.J.エイブラムス、「スター・ウォーズ エピソード7」の監督に決定？	J.J.エイブラムス、「スター・ウォーズ」次回作の監督に決定
すでに生徒を撃った人物に立ち向かうために... " : I'm no hero, says teacher who talked down armed student."	教師が武装した生徒に降参するよう説得、警察発表
( ) ブラジルで世界最大のホモパレードが開催される。# fagsdoomnations 245 people killed in brazil club fire .	ブラジルのナイトクラブで火災が発生し、数百人が死亡。
ティーパーティーは不満だ。 フォックス・ニュースがサラ # ペイリンを解雇した。	Fox NewsとSarah Palinが決別
on point ...恐れてはいけない5つのワインワード	THE POUR : ワインについて語るとき、恐れてはならない5つの言葉。
参照：NYTIMES : ケベック州、スキーで祝賀会	ケベック州では、スキーで冬の祝典を行う。
生命は受胎時に始まり、カゼがない限りは。	カトリック病院の弁護士、胎児は人ではないと主張
北朝鮮が南朝鮮を脅して国連の制裁を受けさせる。	北韓は南韓に矛先を向ける
米国では、炭酸飲料の禁止に反対する産業界が味方になっている ふむふむ．	ブルームバーグのソーダ禁止令に対し、NAACPは法廷で反論。
いい加減にしろ!ニューヨーク州知事、ニュータウン以後初の銃規制法案に署名 -	ニューヨークでニュータウン銃乱射事件後初の銃規制法案を可決へ
スペインで失業率が再び上昇、緩和の兆しなし...	スペインの失業率、再び上昇 救済のめど立たず
アップル社のティモシー・クックCEOは、製品のパイプラインはぎっしり詰まっていると述べた。私たちは、私たちが持っているものについて素晴らしいと感じています。	アップルの利益は横ばい、株価は下落
facebookがソーシャルグラフデータの巨大なデータベースを検索するための新しいツール（ ）を立ち上げたという記事を読みました。	bits blog : フェイスブック、新しい検索ツールを公開
なぜ彼について読むのをやめられないのかわからない - データの十字軍、被告、そして今、原因。	アーロン・スワーツ、データ・クルセイダー、そして今、原因とは？
これ、見たいなぁ、カッコイイなぁ！セカンドステージは「Nobody loves you」を追加。	artsbeat : セカンドステージ・シアター、「Nobody loves you」を追加。
nytimes :# lindarisspugach, whose life was ripped from headlines, dies at 75 # crazylove	LINDA RISS PUGACH, 1937-2013 : リンダ・リス・プガック、75歳で死去 その人生はヘッドラインから引き裂かれた
3D版「トップガン」が中国の検閲で却下された。 「ライフ・オブ・パイ」の「宗教は闇だ」というセリフも×。	中国向けハリウッド映画では、官僚が発言権を求めている。
コビーは約1億ドルを節約した。	コービー・ブライアント夫妻、離婚を撤回
NYタイムズの広報担当重役ボブ・クリスティが退社する。 業界では数少ない優れた広報担当者だ。	回コミュニケーションズ・エグゼクティブが退社する
リップ言葉もない : ( ブラジルのナイトクラブで火災、少なくとも245人死亡 - )	ブラジルのナイトクラブで火災が発生し、数百人が死亡。
資産価値：あなたが得るもの... $ 1.6 million	資産価値 : 160万ドルの不動産
インドは女性にとって衝撃的なほど悪い場所です。?	レイプに焦点を当てたインドでは、女性の危険は表面的なものに過ぎない。
食事に気をつけましょう。!!	外食のカロリーボム9選
# 英国首相、欧州連合に関する投票を求める決定を擁護 # 欧州連合	英国首相、EUの投票を求める決定を擁護
アフリカはどこにあるのか？	常識：ボーイング787のバッテリーメーカー選定に疑問の声
女性たちは、「この国がほとんど気づかないほど、隙のない冷静さで持ち場についた。'	コラムニスト：女性軍人と最前線
トーマス判事はこの7年間、最高裁で一言も発言していなかったが、沈黙を破り、「彼はそうではなかった」と述べた。	トーマス司法長官、法廷で沈黙を破る
子供たちは誰も信用できない!" : フロリダの児童性犯罪捜査で50人逮捕-教師数人を含む : "	児童性愛事件で逮捕された50人のうちの1人が教師
ペンタゴン、戦闘禁止を解除へ	ペンタゴン、女性の戦闘参加禁止を廃止
私は通常、前首相ジョン・ハワードに同意しないが、米国における銃規制については的確である。	論説委員：オーストラリアは突撃兵器を禁止している。
毛沢東やゴダイバの馬印が欲しい？# nabejoint	neighborhood joint｜ウェストビレッジ：10,000個のゴム印を作るインクパッドの会
ジェームス・ブラウンの伝記映画、ついに始動！ : Blogで本を紹介しちゃいます。	アートビート : ジェームス・ブラウンの伝記映画、ついに始動
これは面白い - NYTIMES : 両親の経済的支援は大学の成績には役立たないかもしれない。	両親の経済的支援と大学の成績の関連性
石川とウィラチャントがオーガスタに招待される	石川遼とThaworn Wiratchantが修士課程に招聘される。
偉大なアイデア " : キャピタルゲインは、資本が投資された期間に基づいて、時間の経過とともに逆進的にすべきである # startupact " 。	私たちは資本家のジレンマを生きているのだろうか？
ペンタゴン速報、これは大きな議論になりそうです。	ペンタゴン、戦闘任務の女性への開放を決定
omo dey go tey : オピニオン : アフリカの春を待ち続けるナイジェリア人 ソウォレ - Sowore	ナイジェリアは「アフリカの春」を待っている
イギリスとアイルランドでハンバーガーから馬肉が検出されました。	イギリスとアイルランドでハンバーガーから馬肉が発見される。
オンライン・インターネットのアーロン・スワーツが自殺、親族が語る	ネット活動家アーロン・スワーツが自殺
インフルエンザの予防接種を受けましたが、運動することでより効果が期待できます。	運動はインフルエンザ予防接種の効果を高める
for # armstrong it's about rebuilding a revenue stream the same as always .# ドプラ	アームストロングにとっては、説明のない自白である。
disruptions : デザインはテクノロジーに匹敵する重要性を持っている : nice quotes !	disruptions : ディスラプション : デザインが技術を進化させる
親愛なる砂糖の前に、親愛なるアビーがいた：何百万もの人々の輝かしいアドバイザー、ポーリーン・フィリップスが94歳で死去。	親愛なるアビーとして数百万人の相談役を務めたポーリーン・フィリップスさん、94歳で死去
" フランスはニジェール及び国内の警備を強化している" # uranium # mali	フランスはニジェールのウラン鉱山の警備を強化している。
ユニコーンのパーツの違法使用で裁判中。# dailywhale	イッカク牙の密輸に関与した2人が無罪を主張
国連制裁に反抗する北朝鮮	国連安全保障理事会、北朝鮮を非難し、制裁を拡大
スター選手から学ぶトレーニングのコツ #モチベーション #フィットネス	パーソナルベスト：スターアスリートからのトレーニングインサイト
面白い記事です！彼女は（めったに）ボスではありません。	論説委員：彼女は（まれに）ボスである。
クリステンセン：私たちは資本主義のジレンマを生きている	私たちは資本家のジレンマを生きているのだろうか？
私の中のジンジャーは、世界一の独身男が # ジンジャーファミリー の一員であることが大好きです。	プリンス・ハリー 最も魅力的な独身男性
: - ┛hmvが倒産したのと同じ...	dealbook : 英国の小売業者HMVが破産に相当する状態に。
really people ???♪ : 読者がランス・アームストロングを訴える ドーピング容認後の本の払い戻しを求めて ?	読者が本の返金を求めてアームストロングを提訴
バリ島麻薬事件で英国人女性に死刑判決	バリ島にコカインを密輸したイギリス人の祖母に死刑判決
daily review : セレクテッド・レターズ・オブ・ウィリアム・スタイロン # review	♪ Selected letters of William styron ♪
