健康専門家の証言はいかがでしょうか？	また、そこに「本物の」健康専門家の証言がないとは言い切れないでしょう？
「と言って、船長はいなくなった．	すると、船長が戻ってきた。
問題はもっと単純です。	問題は簡単です。
負の偵察の必要性 .	太平洋の要件 .
だから、私は今のところ、あなたに質問するのをやめようと思います：「マルクスはどこですか？	私はあなたに、「牛肉はどこにあるのか？
否定を証明しろというのか？	否定を証明しろということですか？
医療用でもOK!	医療用でもOK!!
インフレで必要なものはすべて値上がりしている。	あなたが持っているすべてのもの、つまり資産の価格が下がっているのです。
中東戦争 .	中近東での戦争...
original posted by vienna どのように権威主義的だったのでしょうか？	originally posted by zaf I give up .
白人と黒人がいる場所を想像してください。	男女比の違う場所を想像してください。
公正な裁判のチャンスはない。	公正な裁判を受けるチャンスはないのです。
涅槃は忘却とは全く異なるものです。	涅槃は忘却ではありません。
もし、あなたが「はい」「いいえ」と答えたら、おそらくノンケでしょう。	もし、あなたが「いいえ」と答え、「はい」と答えたら、あなたはおそらくノンケです。
地球全体を合わせると、10億人分の食料を生産していることになります。	今、10億人分しか生産していないのは誰ですか？
彼は、当時としては適切な猶予を与えられていた。	その時の状況に応じて、適切な延期をすることです。
しかし、私が見たニュース放送では、彼を白人と呼んでいました。	しかし、彼を白人と呼ばない方が「インパクト」は少ないようだ。
ガールフレンドとジマーマンによると、彼はそうでした。	ジマーマンによると、彼はそうでした。
親から「体に悪いよ」と言われました。	先生からは、体に悪いと言われています。
.ナチスとはNswpの俗称です。	original posted by odins eye .naziはnswpの俗称です。
私は死刑制度に反対です。	だから私は死刑を支持するのです。
まあ、何はともあれ、あなたは今、そうです。	まあ、何はともあれ、あなたは今それを認識しています。
彼らは私が食べたり、着たり、住んだりできるものを何も生産していない。	食べられないもの、着られないもの、住めないもの、いろいろ考えてみてください。
ディスコット・マット・ホリデイが所有する.	マット・ホリデイが所有しています。
人々は法律を悪用した。	人々は法律を曲げました。
面白いですね、私もある数学について同じことを考えました。	と、ここで、私は数学を知っていると思った。
私はレタスも使うので、何年も「ニーナ・ニーナ」権を持っています。	私は何年も前から "ニーナ ニーナ "の権利を持っているんだ。
私は、すべてのものに「あなたはユダヤ人が嫌いだ」という接頭辞や接尾辞をつけない。"	あなたは、すべてのものにユダヤ人嫌いの接頭辞や接尾辞をつけるのをやめたほうがいい。
木が好きかどうか聞いてみたよ。	せめて、3Pが問題外かどうか聞いてみたかったんですが......。
というのは、やはり意味がない。	意味不明なのはあなたです。
より高価な住宅を .	より高価な車 .
マーティンは言った、「なぜ私の後をついてくるのですか？"	zimmermanは答えた、「ここで何をしているんだ？"
TAFBとSABによる衛星強度の推定値はわずかですが。	TAFBとSABによる主観的なDVORAK強度の推定値はktに増加した。
「妖精は存在しない」 - いいわ。	「サテュロスは存在しない" - よろしい。
私が何を不思議に思っているか知りたいですか？	それが不思議なんです。
いつ私がホモセクシュアリティを発達障害と比較しましたか？	ホモフォビアを発達障害と比較しました。
と聞いたら、保守派は、数字が右に偏るでしょう。	と聞けば、進歩的な人たちは、数字が左に偏ってしまうのです。
その1つの投稿の前に、あなたはPFAについて言及しませんでした。	接近禁止令のことも言っていない。
ramblin' rose by nat king cole we are all vessels filled with many wonders.	虎の目......我々は、多くの不思議に満ちた器である。
前年度比 .	前年同期比.cの増加。
まだこの番組が大好きです。	この番組は、とても素晴らしいものです。
彼らの膨大な財産は政府によって保護されています。	彼らの巨万の富は、政府によって守られている。
ファンダメンタルズの違い、教えてください。	根本的な違い？
第二次世界大戦の愚かさに対して、ドイツは一体どのような「罰」を受けているのでしょうか？	具体的にどのような罰を受けているのでしょうか？
Zは彼を追い詰め、そして撃った。	あなたはジマーマンが「彼を追い詰め、そして撃った」と主張しました。
私は激怒しているのではなく、失望しているのです。	神の祝福を 私は憤慨していない、失望している。
そもそも、そこから抜け出せなかったんだ!	そもそも、そのお金はどこから出ているのでしょうか？
言論の自由は結果をもたらす	もし言論の自由が結果をもたらすなら、それは自由ではありません。
親から「体に悪いよ」と言われました。	先生から体に悪いと言われました。
4人を救うために1人を殺すことができるとしたら、あなたはそうしますか？	人を救うために人を殺すかどうかについては、私にはわかりません。
モラルを押し付けるものではありません。	それは法律を課すことです。
極端をどう定義するかによりますが。	は、「極端」をどう定義するかによるのですが。
少なくともメキシコはカリフォルニアに進出していた。	メキシコはカリフォルニアの領有権を主張しない。
そう、私たちはキリスト教を学ぶために聖書を読んでいるのです。	個人的には、キリスト教を学ぶために聖書を読みます。
だから私を怒鳴りつけ、私の質問に答えようとしないのですか？	まだ私の質問に答えないの？
規制が多すぎるのではなく、少なすぎるのです。	自由市場への介入が多すぎるのではなく、少なすぎるのです。
人間的な要素......ランス・バークマンと年末に契約できるかもしれませんね？	年末にランス・バークマンと契約できるんだろう？
なぜトマス書は正典から外れたのか？	なぜ、イエスの言葉の追加が正典から外れるのでしょうか？
つまり、主要メディアの言葉を信じているのですか？	春風亭昇太の言葉を信じると言うのか？
私たちは探検するためにあるのです。	私たちは、動くことを意味します。
イスラエルは、それを受け入れて、それを与えることはありません。	イスラエルは、他の誰がどう思おうが、知ったことではないのです。
私たちは皆、多くの不思議に満ちた器なのです。	I want to rock and roll by kiss we are all vessels filled with many wonders.
スルットスタンプ！オハイオの親愛なる友人がこれを送ってくれた。	オハイオの親愛なる友人がこれを送ってくれた。
しかし、タイタニックの物語は、証拠の精査に耐えるものです。	新しい研究は、タイタニックの物語が精査に耐えないことを示している、と私は思う。
Googleのアドセンスで本当に儲かるのだろうか。	Googleアドセンスで儲けているのは誰？
彼らは、ビデオがガス室を示していないことを知っている。	要するに、このビデオクリップにはガス室が映っていないのです。
暖かい、多分記録。	暖かい、ほぼ間違いなく記録的な。
「聡明だが散漫な性格」が「薬で治す」になっている。	「意見が多く頑固で、薬で治療するようになる」。
あなたの考える「人生」とは何ですか？	あなたの考える自然とは何ですか？
いろいろあるんだろうけど．	は単純なミスである可能性があります。
強要も、賄賂も、お金も関係なく、彼は自分の票のためにお金を要求している。	強要や賄賂、金銭の授受はなく、E級重罪のみです。
自分の気持ちを伝えるべきでしょうか？	このまま様子を見た方がいいのでしょうか？
I. アトランティック要件 .	太平洋の要件 .
ペンタゴンにミサイルが落ちた跡はないのか？	ペンタゴンへのミサイルの 目撃者はいないのか？
" jane " は、親切なパーティーのゲストに支払いを依頼するよう求めています。	パーティでお世話になった人にお金を貸してもらうなんて。
避妊を望む女性は、誰でもそれを受けることができます。	中絶を望む女性は、誰でも中絶することができます。
このシリーズについて、私はどう思いますか？	その間のホタルの感想は？
私たちは皆、多くの不思議に満ちた器なのです。	チャック・クローズ 私たちは皆、多くの不思議に満ちた器なのです。
しかし、まあ、究極の主権は？	したがって、究極の主権。
というのは答えになっていない。	いいえ、それは答えではありません。
ナチスは拳銃所持許可証の有効期限を数年に延長した。	ナチスは銃の最低購入年齢を.NETに引き下げた。
しかし、我々は助けなしにそれを行うことはできません。	私たちはあなたなしでそれを行うことはできません。"
健康な人にギャンブルは必要ない。	健康な人はセックスを必要としない。
私は、それは法的な意味での人ではないと言いました。	人でないとしたら、それは何なのか？
オバマ大統領が規制改革を呼びかけているのを見たことがありますか？	オバマ大統領が削減、上限、均衡を要求しているのを見たことがありますか？
「妖精は存在しない」 - いいわ。	「エルフは存在しない」 - よろしい。
ハイネとクアーズライトを買ってきて、昨日の夜から始めたんだザニス。	昨日の夜から始めました。
イランは、NTPとiaeaにも加盟しています。	イランはNPTとIAEAに加盟している」というEKの事実が気に入った。
「ゴルゴは存在しない」 - よろしい。	「サテュロスは存在しない" - よろしい。
お金を引き出す最良の方法は、ロビー、そのすべてを取り除くことです。	それを覆す最善の方法は、お金を引き出すことです。
私は何年も前から「ニーナ・ニーナ」の権利を持っていて、通常はかなりまともなケアを受けることができます。	私は何年も「ニーナーニーナー」の権利を持っている彼らは、クラックアップです。
ダッチーから連絡があった人はいますか？	nickfunさん、ダッチーから連絡はありましたか？
コモディティ拡張値形式 , .	一次商品資本価値形態 .
あなたはクリスチャンです。	だから、あなたはクリスチャンではないのです。
そして、今日のシンプルな事実 ?	繰り返す：そして、今日の単純な事実は？
モラルは全く関係ない!	そして、モラルと誠実さは、すべてそれに関係しています。
fernさん......このような話は馬鹿らしいと思います。	- 狼......このような話は馬鹿らしいと思うのですが......。
今後数時間、サイクロンの形成は期待できません。	熱帯低気圧の形成は期待できない。
この言葉の羅列の意味がわからないのでしょうか？	この「導かれた」という言葉が何を意味するのか、お分かりにならないのでしょうか？
宗教の自由はない。	言論の自由はない。
抹消後、子供はどのくらいで学校に戻るべきですか？	抹消後、どのくらいで子供が気にならなくなるのか？
男と女は違うのです。	男と女は違う？
二重の危険は、実際には陪審員の無効を強制するものです。	合法性に関しては、私は陪審員の無効化を使うことができます。
ファシリテーター：show me the smart child .	ファシリテーター：そして、なぜ彼女は馬鹿な子供なのでしょう？
宗教小説は、冗長で反復的ではないのですか？	それは冗長で、繰り返しではないのですか？
元はアナベルが投稿したものですが、何が問題なのでしょうか？	viennaが投稿した''say''は何？
cracklin ' rosie by neil diamond we are all vessels filled with many wonders.	ジングルベルロック by ボビー・ヘルム we are all vessels filled with many wonders.
これらの機関を運営する人々を完全に信頼している人もいます。	他の人々は、これらの機関を運営している人々を全く信頼していません。
ルースチェンジは、フィクションとして始まりました。	フィクションとして完成させました。
もし生命でないなら、生まれることはできないでしょう。	もし、それが生きていなかったら、それだけで流産してしまうでしょう。
gl , terral それは本当に素晴らしいです。	hi ollie : それは本当に素晴らしいことです。
白人の割合と黒人の割合があるとします。	白人と黒人がいる場所を想像してください。
言論の自由は結果をもたらす	もし言論の自由が結果をもたらすなら、それは自由ではありません。
「妖精は存在しない" - よろしい。	「妖精は存在しない」 - いいわ。
もしそうなら、それは彼らが真実ではない理由であることを述べてください。	このような場合、どのようにすればよいのでしょうか？
-何も言わない」「何もしない」。	は、それについて話して何もしないよりもさらに悪いです。
「核兵器に反対する」ということは、「核兵器を使いたくない」ということではありません。	「核兵器の使用に反対する」ということは、「核兵器を使いたくない」ということです。
私の姪は黒人と結婚しています。	私の偉大な姪は、半分が黒人です。
英国の人口は100万人強です。	日本人の人口は約100万人です。
私は保安官を撃った我々は多くの不思議に満ちた容器である。	私たちは皆、多くの不思議に満ちた器なのです。
ベロキラプトルの養子縁組に使った金だ	ベロキラプトルを採用するのに使ったお金の中で、一番かもしれません。
では、テラルの書いたことを全部信じるのですか？	gl, terral hi corn : では、あなたはterralが書いたことのすべての言葉を本当に信じているのですか？
何がどう売れたのでしょうか？	それはどのように販売されたかではない、GB。
私は彼のようになりたくないと知っています。	私も彼のようになりたくないです。
武器はなかった。	もちろん、武器はない。
バカバカしいから、事実でなければならない。	そうかもしれないと思うと面白い。
個人の責任？	また、個人的な責任。
自分の言っていることが意味不明なことに気づいていますか？	そして、自分が言っていることがナンセンスであることに気づいていますか？
私は、国勢調査の後方からトップハットでそれを引き出したのだと思います。	国勢調査は、トップハットの中に後姿があるのでしょうか？
どうしてこれがブッシュに不利になるんだ？?	ブッシュに対する傾斜はどこにあるのか？
もしそれが馬鹿げたことでなければ、それはホメオパシーではない。	それは単純な論理で、もしそれが馬鹿げたことでなければ、ホメオパシーではないのです。
私は、彼の過剰なミリグラムを非難したことはありません、何も。	私は、彼が野球に細工をしたと非難したことはありません。
救済はタープより大きい bloomberg ニュース 。	ベイルアウトはタープより大きかった このタイトルは誤解を招きます。
を負うのは個人のリスクであるというのが彼の立場です。	彼の立場は、現在のところ、このようなものです。
I. アトランティック要件 .	太平洋の要件 .
read more : 中絶賛成派に会ったことがないのですか？	中絶賛成派に会ったことがないのですか？
お金を持っている人は問題ありません。	私はこの人たちと多くの問題を抱えていて、ここに書ききれないほどです。
ニクソン、フォード、カーターは油田を閉鎖したのか？	油田を閉鎖したことはない。
私は、「気にする」大統領を望んでいない。	カリスマ性のある大統領なんていらない。
それは脳天気である必要はありません。	私は提案されたモデルを持っていない。
ミサイルの証拠なし．	ミサイルの目撃者なし．
私は妊娠のティッカーを持っています。	私は妊娠ティッカーを持っています。
ということは、彼は全能ではないのです。	ということは、彼は悪意があるのです。
犬顔用ブリキ帽子、サイズは？	SARGのティンフォイルハット、あなたは何インチを着用していますか？
大麻がらみの犯罪で射殺されたこの年頃のように。	あるいは、マリファナの売人によって自動小銃で射殺された1歳の少年......。
跳び上がってヒットすると、ペナルティを受けることになります。	もし、あなたのスティックが相手の顔に当たったら、ペナルティを受けることになります。
電気エネルギーはすべてバッテリーから供給されます。	すべての電気エネルギーは、最終的にオルタネーターから供給されます。
何人の乗客が証言したか、何を言ったか知っていますか？	氷山を見たという乗客は何人いたのでしょうか？
男女比の違う場所を想像してください。	白人と黒人がいる場所を想像してください。
シナリオaでは、Co成長率が.%/yr加速すると仮定しています。	メタンガスが.% /yr加速すると仮定している。
その結果、最近の減少傾向から冷え込んできている。	最近の減少傾向から、冷え込みが感じられるようになりました。
私たちは皆、多くの不思議に満ちた器なのです。	猫からのランドンメモリー 私たちは、たくさんの不思議で満たされた器です。
繰り返しになりますが、彼らは以前のような主権者ではありません。	以前ほどの主権はない。
それはほとんどオランダ人だけのものです。	実際には、それはちょうどダッチです。
また、天使とコモンピンの話ですか？	lustig andreiさん、また天使とコモンピンの話ですか？
トレイボンの性格について、私がいつそんなことをしたと言うのですか？	のブログで、いつそんなことをしたのか？
ppは中絶サービスのためにどれだけのお金を取っているのでしょうか？	中絶手術にはいくら使われているのですか？
受精後の卵細胞はもうないのです。	精子細胞はもうないのです。
lacey - おかえりなさい。	ともかく、おかえりなさい。
more factchecking : I don't know why anyone is making a fuss over $ , bet .	私は誰もが$、賭けに大騒ぎしている理由がわからない。
もし、何の主張もしていないのであれば、そう言ってください。	私は何の主張もしていない。
サッチャー派はリバタリアンを名乗ることができない。	だから、サッチャー派がリバータリアンを名乗るのは不愉快だ。
問題は、誰がお金を持っているかということではありません。	問題は、お金を持っていない人です。
しかし、あの海域に氷山があったと本当に信じているのでしょうか？	タイタニックの近くに氷山があったとは思えないのですが......。
アストロズでもオリオールズでもない、オリオールズの悪いゲームデー ゲームは私のために凍結されています。	オリオールズ戦のgamedayは私のために凍結されています。
もしそうなら、多くの警官は処方薬を飲むべきですね。	もしそうなら、多くの発明家、作家は処方箋薬を飲むべきですね。
罪状を教えてください。	はい、彼の罪状は何ですか？
それらは部分的なサイコパスである。	テッド・バンディは部分的なサイコパスだったのか？
歴史を無視するものは、それを繰り返す運命にある。	歴史を無視する者は、それを繰り返す運命にある......。
これは戦争配備ではありません。	公式な展開ではありません。
nutrax anecdoteの複数形はデータではない 紳士は付き添いが必要でしたか？	エヌトラックスアナログはデータではない
Hと私は二人とも本を読みましたが、映画はとても早く進むと思いました。	私は本を読んでいないが、私は今日映画を見た。
それはモロクのシーンではないのですが．	これはモロクのシーンです。
リンドン・ジョンソンとジョン・ケネディは相思相愛だったのでしょうか？	リンドン・ジョンソンとジョン・ケネディは相思相愛だったのか？
あなたは、あなたの心を決定する必要があります。	論理的思考力を磨く必要があります。
帰ってから歩いて寝た人。	3つ持っている人は、家に帰ると妻を殴っている。
- admin drpizza and i 'd forgot what a whiny little bed wetter you are .	そして、私はあなたがどんなに泣き虫でおねしょをするか忘れていました。
アルバート・アインシュタインは大学に行かなかった」という議論です。	オーム、「アインシュタインは大学に行かなかった。"
キャピタルゲイン、最高税率：% .	所得税、最高税率：% .
彼はここ数年、面白いことがない。	ラリー・バッド・メルマンが出演していたときから、彼は面白くなかったんだ。
もし、宇宙にその存在の説明があるとすれば、その説明は神である。	したがって、宇宙はその存在を説明することができる。
彼らのために戦うことの見返りは何ですか？	------彼らのために戦うことの見返りは何だ？
冗談のような結婚を止めることはできないだろう。	そして、私は結婚のために戦うことはありません。
もし彼らがユダヤ人なら、私は彼らをユダヤ人と呼ぶでしょう。	もし彼らがカソリックなら、私は彼らをカソリックと呼ぶでしょう。
彼女は素晴らしい女性でした。	素敵な女性でした。
成功したから裕福なのではないのです。	なぜ、成功した人を嫌うのか？
お前ほどイラついてはいない。	ヘンリーと同じようにイライラしているようですね。
それは常識的なことであり、演繹的な推論です。	あなたの常識/演繹的推論のことを隠した。
私は、彼女はこれまで労働力の一部になる必要がなかったと言いました。	アン・ロムニー氏は、外に出て労働力の一部になる必要がなかったのです。
ドリームテックは、私の知る限りでは射精されたことがありません。	私の知る限り、一度も射精されたことはありません。
私は、ランド以来、私たちが軟弱になったとは言っていない。	私は、あなたが軟弱になったと言いました。
私たちは皆、自分が期待するものを得ていると信じています。	ほとんどの場合、ほとんどの場合、私たちは期待通りのものを得ています。
卑劣なベン、この男の言い訳を探すのはやめてくれ。	ベン、男の言い訳を探すのはやめてくれ。
国によって違うのでしょうか？	だから、簡単に言えば、そうですね、国によって違うのでしょう。
新しい研究は、あなたの主張をサポートしていません。	物理的な証拠は、あなたの主張をサポートしていません。
彼はすべてのレベルで言った.	が、彼はすべてのレベルを言った。
道徳は存在しないので、技術的には何も道徳的に間違っていることはありません。	もし神が存在しないのなら、道徳的に間違っていることがあるのでしょうか？
それはほとんどオランダ人だけのものだと思っていました。	それはほとんどオランダ人だけのものです。
toyland by johnny mathis we are all vessels filled with many wonders ...私たちは皆、たくさんの不思議に満ちた器です。	虎の目......我々は、多くの不思議に満ちた器である。
この件は裁判で解決しましょう。	このままでは裁判になるのは目に見えている。
ギャングであることは犯罪ではありません。	暴力団で犯罪を犯すことは犯罪である．
イランに取引を持ちかける	チャック 私はイランに取引を持ちかけるだろう。
そう、どちらも違うものなのです。	意見が分かれるところです。
モラルを押し付けるものではありません。	それは法律を課すことです。
アニーにそんな性癖があったのか？	ゾンビは、アニーにそのような性癖を持たせたことがあるのでしょうか？
純粋な共産主義：あなたは2つの牛を持っています。	リバタリアン / アナルコ資本主義 : あなたは2頭の牛を持っている .
科学者を台座に乗せるべきですね。	どうしてあなたのような人は、科学者を台座に乗せるのでしょうか？
彼らは何を隠そうとしているのか？	そして、「彼らは何を隠そうとしているのですか？
それは、彼らの死に対して、あなたに部分的な責任を負わせることになるのです。	ということは、あなたはアクセサリーのようなものだと思うのですが......。
" 他人の医療費を払いたいですか？"	" シートベルトをしますか？"
以前ほどの主権はない。	繰り返しになりますが、彼らは以前のような主権者ではありません。
私は、オバマが2つの悪のうち、より少ない方だとは思わない。	私は彼を悪人とは見ていない。
あるいはジム・クロースのこの曲は、私たちは皆、多くの不思議に満たされた器なのです。	私たちは皆、多くの不思議に満ちた器なのです。
ポイントは、丸腰の子供が殺されたことです。	重要なのは、丸腰の子供が黒人に殺されたことだ。
zimmermanは答えた、「ここで何をしているんだ？"	マーティンは言った、「なぜ私の後をついてくるのですか？"
そのような無宗教は問題です。	それをしない宗教は、私は問題を持っていない。
もし私が怒っているなら、それはこれらのスキャンのうちの1つに現れるだろう。	もし私がハイパーアクティブなら、これらのスキャンのいずれかに表示されるでしょう。
もし、あなたがXYZ社の普通株を10億ドル買いたいのなら、誰がそんなことを気にしますか？	家や車を買いたいのであれば、また、誰が気にするのでしょうか？
メキシコの現在の繁栄レベルでは、世界のすべての人が10億ドルです。	現在の北西アフリカの「繁栄」レベルでは、世界中の誰もが、そのような状況にあります。
もし、あなたが「はい」「いいえ」と答えたら、おそらくノンケでしょう。	もし、あなたが「いいえ」と答え、「はい」と答えたら、あなたはおそらくノンケです。
時々、権力を持つことを空想するんだ。	私も時々、自分の頭の悪い意思で人を曲げることを妄想してしまいます。
親から「体に悪いよ」と言われました。	私の保安官は、それはあなたに悪いと言いました。
アトラス・シュラッグド......それはまた、ばかげたことを吹き込むという点で、恒星のようなパフォーマーだ。	また、バカバカしさの点でも優れています。
マーティンはどうしてそのことを知らないのでしょうか？	マーティンや他の人は、彼の行動からどうやって彼の意図を知ることができるのでしょうか？
規制は、あらゆるものに政府を介入させる。	" 政府は全てに介入するのか？"
それは常識的なことであり、演繹的な推論です。	あなたの常識/演繹的推論のことを隠した。
そうです、私の議論では、すべてのパッケージがリサイクル可能であると仮定しました。	私もこのことを想定して議論してきました。
陪審員の無効化は、法律が違憲であることを意味しない。	陪審員無効化とは、法律が憲法違反であるということですか？
ただの細胞の集まりです。	私は、「細胞の束。"
マンの仕事は、数学がすべてだった。	マン氏の仕事とHSは、すべて木の年輪に関するものだった。
このことを聞いてとても残念に思うケリー。	残念だ、ケリー。
私は風味のあるビールは好きではありません。	私は多くのフレーバードリンクが好きではありません。
避妊を望む女性は、誰でもそれを受けることができます。	中絶を望む女性は、誰でも中絶することができます。
ヒットラーがユダヤ人を殺すのを見たことがありますか？	ヒトラーがユダヤ人を殺すのを見たか？
そして、私はあなたの友人のミットです。	あなたの良き友人ミット.
というのは、選択肢の一つということです。	は、その悪い選択肢を意味するものではありません。
私が書いたものを読み直す必要があると思います。	私が書いたものを読み直す必要があります。
白人の割合と黒人の割合があるとします。	白人と黒人がいる場所を想像してください。
お母さんは、「何の音？"	子供たちが「パパ、何してるの？'
私の最高の、私の元婚約者は、バージニア州や海軍の医師を使用しないでしょうkutte。	ジェイ 私の元婚約者は、バージニア州や海軍の医者を使おうとしなかった。
ホルダーは、3ページの手紙を提出しました。	裁判官は、3ページの書簡を提出するよう命じます。
lustig andrei , lustig , 同意 .	lustig andreiさん、ありがとうございます。
zimmermanは答えた、「ここで何をしているんだ？"	マーティンは言った、「なぜ私の後をついてくるのですか？"
これがどれほどのものかはわからないが、彼は自殺願望が強いと聞いた。	だから、これがどれだけ正当なものかはわからないが、そうだ。
市税はほとんどの人が凍結されたのでは？	市税はほとんどの人が凍結されているのでは？
あなたの芸は陳腐化しています。	あなたのミソジニーは、厄介なことになっている.
息を吸って、息を吐いて、前に進む。	ブハハハ 息を吸って、息を吐いて、前に進む。
より一貫して、より近くになるのを待ちます。	陣痛が強くなり、間隔が狭くなるのを待ちます。
オバマは極端な左翼だ。	オバマは極端な左翼の一員である。
フランク・アピサ、どう呼ぶかはあなた次第です。	cyracuz 、どう呼ぶかはあなた次第です。
陪審員無効化は、法律の合憲性とは何の関係もない。	陪審員無効化とは、法律が憲法違反であるということですか？
以前はどのような信念を持って話していたのですか？	それはどのような信念なのでしょうか？
ということで、実際にオペを読んでみて、何が分かったと思いますか？	さらに、私はこれを見つけた：だから私は実際にオペを読んで、私は何を見つけたと思います。
政府は、結婚しているかどうかを決定することはありません。	結婚する前に、政府が結婚を宣言する必要はないのです。
民主主義は自由への脅威である．	民主主義は自由とは関係ない。
hiro pro and corn : 何本の糸を作る予定ですか？	何本の糸を作る予定ですか？
今、どのシステムが機能していないのか、正確に教えてください。	では、どのシステムが私たちのために機能していないのでしょうか？
そしてまた、結婚が基本的人権であると主張している。	特に、結婚は基本的人権であるとした上で．
なぜロシア人がダマスカスにいるのか？	ロシアがダマスカスに!
はい、それは希釈についてです。	それは希釈の仕方ではありません。
ええ、この件もそれほど議論の的とは思えません。	彼女の言っていることはそんなに物議をかもすようなことではないと思うのですが......。
操作の混乱は、単に人々が投票することです。	カオスは、単に人々が投票しているに過ぎない。
古典的なガス私たちは、多くの不思議で満たされた器です。	歓声のテーマソング：私たちは皆、たくさんの不思議で満たされた器です。
繰り返しになりますが、彼らは以前のような主権者ではありません。	以前ほどの主権はない。
モラルは全く関係ない!	そして、モラルと誠実さは、すべてそれに関係しています。
私はコーネル・ウエストと会話をしている。	私はコーネル・ウエストと会話している これは一体何なんだ？
中東に戦争はない。	中東に「戦争」はない。
彼は彼を逮捕するつもりはなかったのです．	- 逮捕するとは言っていない。
私たちは皆、多くの不思議に満ちた器なのです。	あなたの心に少しの愛情を入れてください。私たちは皆、多くの不思議で満たされた器なのです。
あなたは「細胞の束」です。"	私は、「細胞の束。"
ガールズダウトって何？	お前は女の腐ったような奴だ。
陪審員無効化とは、法律が憲法違反であるということですか？	いいえ、陪審員の無効化は、法律が違憲であることを意味するものではありません。
それは間違いなく、以前のものではありません。	は、それは間違いなくそれが使用されているものではありませんに投票した。
製品の製造元には、消費者に安全であると納得させる責任があります。	メーカーは政府に安全であると説得しなければならない。
起業家について、あなたは的外れなことを言っていると思います。	また、Twainの引用について、ポイントがずれているように思うのですが。
「サイクロプスは存在しない」 - いいわ。	「ゴブリンは存在しない」 - よろしい。
" それは心の病であった、今、彼らはあなたに何を教えていますか？"	彼は、それが精神的な病気であると述べていますが、それはどのような偏見ですか？
私たちは不思議なもので満たされた器なのです。	火で遊ぶ......私たちは皆、多くの不思議に満ちた器なのです。
ブッシュは、彼の下で予算に関する信用をゼロにした。	そして、オバマは彼の下で予算に関して全く信用されていない。
.罪深い人は天国に行けない．	または罪が天国に入るときに取り除かれる．
抹消後、子供はどのくらいで学校に戻るべきですか？	抹消後、どのくらいで子供が気にならなくなるのか？
holly holy we are all vessels filled with many wonders.	私たちは皆、多くの不思議に満ちた器なのです。
シカゴでの「答え」は何だったのか？	カリフォルニアの反応はどうだろう？
殺人ガス室を運営したとされる人物とは？	refresh your memory : 殺人ガス室を運営していたとされるのは誰ですか？
したがって、宇宙の存在を説明するのは神である。	もし、宇宙にその存在の説明があるとすれば、その説明は神である。
がん抵抗性の遺伝的素因は、優れた遺伝学 .	アルツハイマーの遺伝的素因は劣悪な遺伝学である.
自分の言っていることが意味不明なことに気づいていますか？	そして、自分が言っていることがナンセンスであることに気づいていますか？
自衛のための武力行使	侵略者による武力の行使.
というのが、入手可能なデータからわかることです。	というのが歴史的な記録です。
私たちは多くの不思議に満ちた器なのです。	歓声のテーマソング：私たちは皆、たくさんの不思議で満たされた器です。
それはほとんどオランダ人だけのものだと思っていました。	実際には、それはちょうどダッチです。
david @ omsigdavid , I think santorum 's more likely than gingrich .	礒部さん、ギングリッチよりサントラムの方が可能性があると思います。
見つめ合っている	なんであんなに見つめ合うんだ？?!
運転してるんですか？	お前はクソボルトに乗ってるのか？
彼は、アメリカのビジネスにとって、全体的に良い存在になると思います。	彼はアメリカ社会のためになるのだろうか？
憲法上の問題ではない	また、これは憲法の問題ではありません。
お前たちは馬鹿だ．．．隠蔽工作を買って出た．．．罠だ．．．	hi eots : お前らは馬鹿だ......隠蔽工作を買って出た......フック......。
" 1番を押すとどうなるのですか？"	" 1を押すと英語になる ."
それはどのような信念なのでしょうか？	以前はどのような信念を持って話していたのですか？
originally posted by spikdboy 希望的観測ではなく、むしろ現実的。	客観主義が投稿したもので、希望的観測ではなく、むしろ現実的なものです。
何度も言いますが、私はリハビリテーションがうまくいかないとは言っていません。	引用している箇所は、「私はリハビリテーションが絶対にうまくいかないとは言っていない」と言うべきでしょう。"
チャーリーランジェルが問責された この映像を見た人はいますか？	この映像をご覧になった方はいらっしゃいますか？
レッドオクトーバー スタンディングバイ	赤いきつねのスタンバイ。
というのは、法務報告書の書き方ではありません。	それは、法的根拠がどのように働くかではないのです。
いいえ、これらの要因はいずれも最近の温暖化を説明するものではありません。	これらの要因が温暖化の原因であるかどうかはわかりません。
ストーン・ノーティファイド・キャプテン・ロード.	彼もまた、キャプテン・ロードに通知した。
体系弁証法の主な焦点は、dia chronic ではなく syn chronic です。	このように、メタ・システム・アティック弁証法は、通時的・共時的弁証法である。
運転してるんですか？	お前はクソボルトに乗ってるのか？
そしてそれは、共和党が支配する州で起こっている。	ミシガン州はゴップが支配する州である。
は凍結していました。	フォクシーはほとんど凍っていました。
フランク・アピサ、フランク、私は観察し、認識する。	cicerone imposter , frank , I observe and perceive .
政府は、どのような妊娠が成人に達するまで運ばれる必要があるかを決定する、それは良いことだ。	政府は自国民を監視している、それは結構なことだ。
あなたの心に少しの愛情を入れてください。私たちは皆、多くの不思議で満たされた器なのです。	私たちは不思議なもので満たされた器なのです。
パーセントより高いが、あまり高くない。	パーセントより低いが、非常に低くはない。
何がどう売れたのでしょうか？	それはどのように販売されたかではない、GB。
神は間違いなく存在しない。	神はおそらく存在しない。
息を吸って、息を吐いて、前に進む。	ブハハハ 息を吸って、息を吐いて、前に進む。
気候変動の優れた指標となる。	私たちは、この変化の本質に同意していると思います。
ここに住んでいる素晴らしいことは、スペースがあることです。	悪いことは、スペースがあることです。
言論の自由がどのように禁止されるのか理解できない。	言論の自由は今以上に禁止されることはないだろう。
という質問をする必要があります。	それは、答えが必要な質問です。
はびこる投稿を.	蚊の投稿.
私は、「気にする」大統領を望んでいない。	思いやりのある大統領を望んでいない。
というような、説得力のないものはないのでしょうか？	もっと説得力のあるものはないのか？
何度も言いますが、私はリハビリテーションがうまくいかないとは言っていません。	引用している箇所は、「リハビリテーションが絶対にうまくいかないとは言っていない」と言うべきでしょう。"
古典的なガス私たちは、多くの不思議で満たされた器です。	ゾンビの季節になると、私たちは多くの不思議に満ちた器となります。
ピーブ......つまり、実質的に自由落下で落ちてきたということで合意しているのですね？	彼らは基本的に自由落下で降りてきたということに同意しますか？
プロライフの人々は、女性が自分で中絶を選択できるようになることを望んでいない。	プロチョイスの人々は、誰かに中絶を強要しようとはしません。
だから、質問に答えてください。	質問を避けるのはやめましょう。
ハイチはクソみたいなところだ。	ハイチはクソみたいな場所だった。
私は、あの海域に氷山があったと絶対に信じています。	タイタニックの近くに氷山があったとは思えないのですが......。
フランチャイズの顔 : 最悪なのは、彼がリーフスのファンですらないことだ!	最悪なのは、彼がリーフスのファンですらないことです。
私は、彼が2期目の大統領になることを望んでいる。	私は、彼が2期目の大統領になることを望んでいます。
ジェイクがアシスト	ゴールを決めたボラーチェク
自宅が被災し、学校は被災していないのでしょうか？	確かに、彼の家が被害を受けた可能性はありますが、学校が被害を受けたわけではありません。
民衆が目覚めたのだ。	民衆が目覚めたからだ．
カリフォルニア号は貨物船であり、その記事がどうであろうと関係ない。	カリフォルニア号は貨物船だった。
うーん、これはかなり明確に、「法令は合憲と推定される」と述べています。"	と判断するまでは、「その法律は合憲と推定される。"
フロリダ......無知はお前のものだ!	無知なのはあなたです
私はトレイボンのために正義を叫ぶつもりです。	トレイボンのために正義を叫んでいる人たちは、みんな偽善者です。
何が正しくて何が間違っているのか、どうやって知ることができるのですか？	どの話が正しいのか、どうやって判断しているのですか？
そして、ニュージェントが言ったことは、完全に馬鹿だった。	ナタリーは、彼らのファンベースを侮辱した完全な愚か者でした。
全てはブッシュのせいだ。	オバマはブッシュのせいだ。
あなたは、すべてのものにユダヤ人嫌いの接頭辞や接尾辞をつけるのをやめたほうがいい。	私は、すべてのものに「あなたはユダヤ人が嫌いだ」という接頭辞や接尾辞をつけない。"
私は、彼が黒人が暴動を起こすと言った点を見逃しました。	決して、黒人が暴動を起こすとは言っていない。
にもかかわらず、あなたはそれを宣言する必要はありませんでした。	そして、あなたはその必要がありませんでした。
箴言 洗礼者ヨハネは生まれながらにしてナザール人であった。	洗礼者ヨハネは生まれながらにしてナザール人であった。
ヤコブ：行いのない信仰は死んでいると言っている。	パウロは、行いのない信仰を説いていない．
メキシコの現在の繁栄レベルでは、世界のすべての人が10億ドルです。	現在の北西アフリカの「繁栄」レベルでは、世界中の誰もが、そのような状況にあります。
また、地震データは、崩壊の持続時間と一致しません。	地震データは崩壊の期間と一致しない。
originally posted by lone fox you've said that multiple times now .	元々はローンフォックスが投稿したもので、イランに関連するものばかりではありません。
あなたはオバマの見解が好きではないかもしれないが、彼には彼の見解がある。	あなたは彼が持つポジションが好きではないかもしれませんが、少なくとも彼はそれを持っています。
しかし、あの海域に氷山があったと本当に信じているのでしょうか？	私は、あの海域に氷山があったと絶対に信じています。
保守派の間では、オバマに勝ち目はない。	これは、保守的な人が言うことです。
サタンは禁欲の代わりに耽溺を表しているのだ!	サタンは、他の頬を差し出す代わりに、復讐を象徴しています。
その販売にかかる税金が支払われている限りは．	税金を払っている限りはね。
fix ?イスラム教は政治的なものではありません。	イスラム教は常に政治的である。
なぜ、私たち住民に限定して質問することが不合理なのか、おわかりになりますか？	なぜ、米国以外の居住者も統計に関係するのか、おわかりになりますか？
私は、過去にワルシャワの上のufoを見たことがあります。	謹んで提出された、スティーブ、私は、過去にワルシャワの上のufoを見ました。
そのときどきの自分たちのおかしな議題を推進するために、どのような行動をとるかによって。	その行動が彼らのロニー・チューンズのアジェンダを促進するかどうかによって。
さらに、私が何の主張もしていないことに同意しますか？	そうすれば、私が何も主張していないことを認め、検証してくれるでしょう。
ジマーマンは車で殴られたと言っています。	彼の「友人」によると、彼は自分の車と対峙していたそうです。
中東に「戦争」はない。	中東に戦争はない。
プロライフの一部は、合法化された中絶に反対することです。	pro-lifeは、単に「中絶反対」の意味もあります。
キャピタルゲイン、最高税率：% .	- 所得、最高税率：% .
ゾンビの季節になると、私たちは多くの不思議に満ちた器となります。	歓声のテーマソング：私たちは皆、たくさんの不思議で満たされた器です。
いいえ、私はあなたが故意に無知であることを示した。	笑）、あなたはとても無知なのです。
私たちは皆、多くの不思議に満ちた器なのです。	ジングルベルロック by ボビー・ヘルム we are all vessels filled with many wonders.
問題は、誰がお金を持っているかということではありません。	問題は、お金を持っていない人です。
フォードは、悲しいかな、税金を受け取っていたのです。	フォードは、会社を救うために納税者の金を受け入れなかった。
イスラム教徒はクルアーンについて同じことを言うだろう。	ヒンズー教徒はバガヴァッド・ギーターについて同じことを言うだろう。
あなたが混乱したからといって、私が嘘つきになるわけではありません。	では、あなたが混乱したからといって、私が嘘つきになるわけではないのですね。
クリスチャンが極端な場合は、単に宗教というだけです。	イスラム教徒が過激になれば、それはテロリズムです。
正しいことが最も重要であるという考え方もあります。	胎児を殺さないことが最も重要だと考える人もいます。
進化は意見ではなく、信念でもない。	原子論は意見ではなく、信念でもない。
私は、他の女性の体を決める権利を主張するものではありません。	女性の身体について他人が決めることを望んでいるのですね。
ロン・ポールはどこだ？	マスコミは一体どこにいるんだ？?
ペンタゴンにミサイルが落ちた跡はないのか？	ペンタゴンにA-が残っていませんね。
引用している箇所は、「リハビリテーションが絶対にうまくいかないとは言っていない」と言うべきでしょう。"	何度も言いますが、私はリハビリテーションがうまくいかないとは言っていません。
メキシコの現在の繁栄レベルでは、世界のすべての人が10億ドルです。	現在の北西アフリカの「繁栄」レベルでは、世界中の誰もが、そのような状況にあります。
私の髪はきれいなものです : / quote : ditto .	私の髪はきれいなものです。
冗談のような結婚を止めることはできないだろう。	そして、私は結婚のために戦うことはありません。
あなたは、貧しい人々は自分の行動に責任がないと思っているようですね。	人は自分の行動に責任がある。
荷物がついていることです。	それは同じものではありません。
私たちは皆、多くの不思議に満ちた器なのです。	あなたの心に少しの愛情を入れてください。私たちは皆、多くの不思議で満たされた器です。
問題は、誰がお金を持っているかということではありません。	問題は、お金を持っていない人です。
どうしてフクロウが参加しなかったと思うのですか？	参加しなかったとは書いていない。
元々は、jacko !	original posted by izzy !
スレッドを立ち上げてくれたキャンディに感謝します。	candy - 今日はありがとうございました。
ただし、それは「なかった」ことです。	ただし、彼らはできなかった。
もし私があなたにドルを借りているならば、私は問題があります。	もし私が1兆ドルの借金をしたら、あなたは問題を抱えます。
もし、ある立場を支持する証拠が提供されないなら、それは拒否されるべきである。	もし、検証不可能なものであれば、それは拒否されるべきです。
今のメキシコの繁栄ぶりを見ていると、他のみんなは。	現在の北西アフリカの「繁栄」レベルでは、世界中の誰もが、そのような状況にあります。
ブッシュは、彼の下で予算に関する信用をゼロにした。	そして、オバマは彼の下で予算に関して全く信用されていない。
笑）アメリカでは車を運転するのに試験を受ける必要があるのでは？	米国で銃器を所有するにはテストが必要ですか？
私たち二人は、この映画が良いものであると考え、どのような点においても混乱は感じませんでした。	私はそれが良いと思った、そして私はそれが混乱を見つけることはありませんでした。
もし神が存在しないなら、道徳的に間違っていることがあるのでしょうか？	もし神が存在しないのなら、道徳的に間違っていることがあるのでしょうか？
法律は、憲法に抵触しなければ、合憲である。	違憲であるということは、憲法に違反しているということです。
original posted by muslim girl ooops sorry !	originally posted by muslim girl that is not a complete impossibility .
ここはあなたの国ではないのです。	これが私たちの国です。
コーンが投げたゲーム.	アディ・ジョス・コーンがゲームを投げました。
edited by lashl : 冒涜的な言葉を適切に隠すために編集されました。	edited by lashl : quoted postの冒涜的な言葉を適切に隠すために編集しました。
陪審員は、陪審員の無効化について知らされていない。	あなたの引用は、陪審員の無効化とは何の関係もありません。
検索ボタンをあまり使わないのですか？	検索ボタンを全く使わないのですか？
ポールに勝ち目があるとは思えないが．	ポールに勝機はない。
ゾンビの季節になると、私たちは多くの不思議に満ちた器となります。	私たちは多くの不思議に満ちた器なのです。
自分の言っていることが意味不明なことに気づいていますか？	そして、自分が言っていることがナンセンスであることに気づいていますか？
もし、研究を失敗させたら？	個人的なバイアスがかかっていたとしたら？
バプティスト	特にグノーシス的な.
と東海岸の大部分.	と西海岸の一部.
なぜ、ヘブライ民族の女性の話をするのですか？	私たちは、戦利品としての女性について話していたのではありませんか？
昨夜、日本軍は香港を攻撃した。	昨夜、日本軍はフィリピン諸島を攻撃した。
あなたの考える「生命力」とは何ですか？	あなたの考える「魂」とは何ですか？
というのも、それは、国民に対する直接的な責任ではありません。	しかし、彼らは有権者に対して責任がある。
イデオロギーは暴力的な拡張を中心に構築されたので、そう、暴力的な拡張。	そのイデオロギーは、暴力的な拡張と人種的な優越を中心に構築されていた。
これは浣腸なのだろうか？	もしかして、浣腸？
最後に、無視は正常化する効果があります。	そのため、「己を活かす」ことが「己を磨く」ことにつながるのです。
