木の枝の上に立つ猫。	白と黒の猫が木の枝に登っている。
緑と白の2台の列車が線路に座っている。	緑と白の2台の列車が線路を走る。
椅子の下に立っている白くて小さな猫。	白い猫が床に立っている。
マリーナの海に浮かぶ大きな船。	海上の大きな船。
子羊はカメラを見ている。	水辺の丸太の上に立つ小鳥。
駅に停車中の旅客列車	駅に停車中の客車。
食卓でノートに書き込む女性。	テーブルの上の女性が何かに夢中になっている
床に置かれたアップルコンピューター。	床に置かれたマッキントッシュのコンピュータ。
茶色の馬の頭のアップ。	馬の頭部を横から見た図。
好奇心旺盛な少年たちは、小屋を覗き込む。	木立の中で小屋を見ている2人の少年。
馬に乗る騎手。	ペンの中で馬に乗る騎手。
野に立つ雄牛。	緑豊かな野原に、茶色の馬が立っている。
男はバイクで道路を走っている。	赤いバイクに乗った男が、道路を走っている。
茶色の馬に乗った女性。	茶色の馬に乗った少女。
黒牛と白牛が門の前でポーズをとっている。	黒い牛と茶色の牛が、根こそぎ倒れた木の前の平原に立っている。
子供が自転車で棚から飛び降りる。	毛布で遊ぶ白黒の猫。
遺跡の階段の前で原付バイク。	廃墟の前で原付バイクを走らせたら......。
男は赤ん坊を膝の上に乗せて寝る。	赤ん坊を抱いて椅子に座って眠っている男。
4人で、ケーキを食べながら食事をしているところ。	四人でテーブルを囲んでデザートを食べる
黄色い花の前に立っている黒い犬。	野原にたたずむ黒い犬。
水のボトルのクローズアップ。	水のボトルをクローズアップした図。
茶色い顔の猫のクローズアップ。	ダチョウの顔のクローズアップ。
羊が立っている。	野原で草を食む羊......。
目を閉じた長髪の猫。	目を閉じた猫のクローズアップ。
グレーのシャツを着た女性がカメラに向かって微笑み、後ろの女性が顔を作っている......。	驚いた顔をした女性が、笑顔の女性を後ろから抱きしめている......。
小さな駅の近くの線路を走る銀と青のアムトラック列車。	ガソリンスタンドに停まっていた小さな白い車。
青いシャツを着た人がコーヒーテーブルとテレビの近くにリクライニングしています。	バイクのシートの上に立って、ウィリーする人。
二匹の猫が窓を眺めている。	窓の外を眺める白猫。
馬を見せる女性の白黒写真。	牛舎にいる牛の白黒写真。
野原に佇むダークブラウンの馬。	緑豊かな野原に、茶色の馬が立っている。
馬を背景にテントを張っているところ。	黒と白の子羊と他の子羊を背景に。
山々を背景にベレー帽をかぶった年配の男性。	朝霧の中の羊と背景の木々。
牛の餌は桶の中にある。	褐色と白色の牛は、トラフで食事をしています。
赤と灰色の小さな鳥が、裸の木の枝の間に止まっている。	赤と茶色の鳥が枝にとまっている。
ヘルメットをかぶった人が白い建造物の近くを自転車で走っている。	黒いショートパンツとブーツを履いた少女が、青いバイクの横に立っている。
食卓を囲む人々	テーブルを囲んでの食事とビール。
小さなアパートに黒と木を基調としたダイニングルームセット。	リビングルームのセッティングに黒と茶のテーブル .
緑豊かな野原に、茶色の馬が立っている。	緑の草原に褐色の馬......。
干し草の中にいる白黒の牛。	干し草のあるペンの中の白黒の牛。
老女が台所に立ち、足元に2匹の猫を置いている......。	老婦人が台所に立っていて、足元に2匹の猫がいる。
田舎の坂道をスクールバスが走っている。	未舗装路を走るレースカー。
ソファの前に綿の袋を置くと......。	ドアの前の段差に座っている三毛猫.
草原に座る迷彩飛行機。	緑の芝生に座っている迷彩飛行機。
赤い2階建てバスが通りを走っている。	トラフィックで駆動するダブルデッカー旅客バス 。
丘の上にいる白い羊がカメラを見ている。	やせっぽちの牛が草の上に立っている。
野原にいる羊の群れ	野原で草を食む馬たち。
空のガラス瓶のクローズアップ、歪んだ写真。	パソコンと書類が置かれた机のクローズアップ写真。
オフィスデスクは混雑しており、コンピュータのモニターが置かれている。	2台のモニターを備えたmessy computer desk 。
雑然とした部屋に座っている男。	雑然とした部屋のベッドに横たわる男......。
喫茶店の自転車の男．	コーヒーショップのパティオに自転車を運ぶ男性。
牧草地の木々の下を歩く黒毛和牛。	牧場の木の下を歩く牛．
木々を背景に野原に立つ2頭の馬。	草原を背景に水面に浮かぶ白と黒の鳥。
赤い2階建てバスが通りを走っている。	赤い2階建てのバスが通りを走っている。
外でビールを飲みながら微笑む女性と、もう一人の微笑む女性......。	外で笑っている二人の女性。
金属製のゲートにつかまっている鳥。	金網にしがみつく色とりどりの鳥。
やせっぽちの牛が草の上に立っている。	白いアヒルが地面に立っている。
ソファに座った二人の男性の間に女性が横たわっている。	青いソファに座り、カメラに向かって微笑む男性と女性2人。
大きなネックレスをした女性.	黒いトップスとネックレスをした若い女性。
野原に立つ角のある茶色の牛。	草原の真ん中に立つ茶色の馬。
海岸線に停泊中のクルーズライナー。	岸に停泊しているクルーズ船。
茂みの下に横たわる白黒猫。	黄色い目の白黒の猫は、土の中でくつろいでいる。
道端の草むらに佇む茶色と白の牛。	草原に立つ茶色と白の牛と背後の木々。
草の上に立ち、カメラを見上げている小型犬。	キッチンに立ち、カメラに向かって微笑む男女。
左耳に黄色いタグの付いた日焼けした子牛がカメラを見ている。	手前にメガネとペットボトル2本を持った男性。
片方の端に財布があるソファの白黒写真。	木の下にいる牛の白黒写真。
子羊はカメラを見ている。	カメラ目線の猫。
混雑した道路を走る赤い2階建てバス。	街角を走る二階建てバス。
ペンの中で馬に乗る騎手。	とっかんしゅ
水面に浮かぶボートの上の二人の男。	水面に浮かぶ大きな緑色の船。
シボレーのスポーツカーのリアビューです。	赤いシボレーのコンセプトカーの後姿。
ヘルメットをかぶった人が白い建造物の近くを自転車で走っている。	ヘルメットをかぶった人が自転車で木道を走っている。
古い駅の白黒写真。	地面に置かれたバイクの白黒写真。
グレーと白のタビーの猫が紫の布の上で寝ています。	茶色いシートの上で眠る白黒の猫.
白と黒の猫が木の枝に登っている。	黒と白の子羊、右耳にタグ付き.
小さな赤ちゃんを抱いた女性。	小さな赤ちゃんを抱いた笑顔の女性。
草原で草を食む馬の群れ。	野に放たれた馬の群れ。
飲み物が置かれたテーブルに座る3人の男たち。	テーブルでビールと食事をする3人の男たち。
草原に立つ白い服の二人。	高速道路の高架下に人が立っている。
ヘルメットをかぶった金髪の少女が、赤い自転車と一緒に座っている。	自転車を背景に、ヘルメットをかぶった少女。
ソファーで寝ているオレンジ色のタビーの猫。	ベッドの足元でテレビを見ている男。
枝にとまる二羽の鷲。	枝にとまった2羽の白頭ワシ。
猫砂の袋の上に寝そべる縞模様の猫。	猫砂の上に仰向けに寝そべる家猫.
リビングルームには青いソファとツインベッド。	太陽の光が差し込む部屋に置かれた青いソファ。
リビングでカメラに向かってポーズをとる男性と小さな子供。	男女がカメラに向かってポーズをとっています。
机の上に3台のパソコンとその他の機器を置いたホームオフィス。	コンピュータのモニターが数台ある部屋
5羽の鳥が雪の上に立っている。	数羽のカージナルが雪の中に立っている。
大きな建物の近くの牧草地に立っている乳牛の乳房．	黒と茶の牛が緑の芝生の上に立っている。
低山をバックに黒い車が止まっている。	田舎の土の中に停まっている黒い車......。
雪の中の旅客列車。	駅に停車中の旅客列車
黒い鳥は地面に座っている。	黒鳥が地面に座っている。
白黒の牛がカメラを見ている。	カメラを見ている白黒の犬。
u2のサインを掲げた柱のそばでポーズをとる女性。	u2 "と書かれた柱のそばに、一人の女性が立っている。
白とグレーの馬に乗った少女。	乗馬服を着た金髪の少女が、灰色と白の馬の上に座っている。
白と黒の羊が白い羊の隣を歩いています。	黒と白の子牛の耳にタグが付けられています。
ダイニングテーブルを背にしたリビングルーム。	ビーチを背景に、板に乗ってウィリーする少年。
ダイニングテーブルには、午後の日差しが入る。	ダイニングルーム 木製のダイニングテーブルセットとプレイメイト .
落書きの前の歩道に止まっていた赤い原付バイク。	赤いスクーターがビルの前の道路に止まっている。
カモメは水面に浮かんでいる。	水に浮かぶ小鳥。
羊の群れは野原に広がっている．	白い猫が床に立っている。
犬2匹と猫1匹がソファに座っています。	犬2匹と猫1匹がソファで休んでいる。
建設現場で資材の横に立つ黒い犬。	大理石の柱に置かれた花の鉢の横に座るアジアの幼児の女の子。
雪の中、マンションの前でポーズをとる女性......。	雪の中、建物の前に立つ女性。
アジア人と眼鏡をかけた女性が親指を立てて微笑んでいる。	二人の女性がカメラに向かってポーズをとり、親指を立てている。
黒い列車が線路を走っていく。	線路の上を走る、ほとんど黒塗りの列車。
5頭の牛が道路脇で草を食んでいる。	野原で草を食む数匹の羊たち。
アルプスの湖の前で草を食む2匹のシロイワヤギ。	山のそばで草を食む2匹の動物、そして水辺。
フェンスの向こうの黒と白の牛。	一部曇りの青空を背景に、金属製のゲートの後ろにいる2頭の白黒の牛。
駅に停車中の旅客列車	駅に停車中の客車。
雪に覆われた森を駆け抜ける白い動物。	白い犬が雪に覆われた森を駆け抜ける。
お店の前に自転車が止まっている。	本屋の前に自転車が止まっている。
草の上に座って空を見ている男。	雪の中、線路の上を走る列車。
床に置かれた黒いフラットスクリーンテレビ。	床にはフラットスクリーンテレビが設置されています。
リビングルームに置かれた銀色の自転車。	ダイニングルームに置かれた自転車。
オレンジと白の猫が、黒い革張りの椅子でブランケットに横たわっている。	革張りの椅子の上で丸くなって眠っている白と黒の猫。
茶色の犬が白い枕に頭を乗せて休んでいる。	ソファに寝そべった日焼けした犬が白い枕に頭を乗せています。
線路を走る黒い列車．	線路の上の列車。
線路を走る黒い列車．	線路の上の列車。
黒いソファに座る若いカップル。	ソファーに座る若いカップル。
ビルの前に原付バイクを持った黒人の集団がいた。	老朽化した建物の外にいる一群の人々。
ソファーで寝ているオレンジ色のタビーの猫。	緑のソファに座るビブスを着た男性。
赤い柄のソファに座った老女が、若い女性に腕を回している。	ソファに座ってカメラに向かってポーズをとる2人の女性。
白頭鷲はロープにとまっている。	枝にとまった2羽の白頭ワシ。
ソファの上で写真を撮るカップル。	ソファーに座る若いカップル。
男たちはギターを弾きながら、酒を飲んでいる。	赤と青のジャケットを着た少年が羊に餌をやっている。
ソファーに座って窓の外を眺める2匹の猫。	二匹の猫が窓を眺めている。
赤い二階建てバス .	赤のダブルデッカーバスのボンネットを開けたところ。
木に近い草の上に立っている顔の長い動物のクローズアップです。	青いオートバイの横にいる黒いブーツを履いた女性のクローズアップ。
花柄の椅子に座る茶色と白の犬。	首輪と鈴をつけたオレンジと白の小さな犬が、花柄の枕の上でくつろいでいます。
黒と茶の牛がカメラを見ている。	白黒の牛がカメラを見ている。
オレンジ色のSUVの後ろに乗っている男性。	満員の黄色いバンの荷台にぶら下がるアフリカ人男性。
崖の上にいる2匹の羊がカメラを見ている。	2匹の羊が立っていて、カメラを見て、反対側を向いています。
誰もいない駅の白黒写真。	寝そべっている猫の白黒写真。
圃場内のサイディングに並んだ機関車たち。	野原に佇むダークブラウンの馬。
ベッドルームのベージュのカーペットの上に置かれた白いアップルコンピューター。	床に置かれたアップルコンピューター。
小さなテーブルの下で昼寝をする犬。	テーブルの下で寝ている犬
道路を走る赤と白のバス .	バスが交通量の多い道路を走っている。
4枚の帆を張った船が水の上を走っている。	セイルボート 水上を走る .
赤いスポーツカーがサーキットを疾走する。	サーキットを疾走する赤いスポーツカー。
小さな赤ちゃんを抱いた笑顔の女性。	赤ちゃんを抱いて微笑む二人の女性.
コンクリートスラブの上に座る黒い鳥.	白い壁の隣に座る小さな犬。
ビクトリーライナーのバスは、白地に赤と金のストライプ。	赤、オレンジ、黄色のストライプが入った白のツアーバス。
道路脇の赤い2階建てバス。	街角を走る赤い2階建てバス。
木々を背景にした河川荷役の一群。	自転車を背景に、ヘルメットをかぶった少女。
カモメは水面に浮かんでいる。	水面に浮かぶ大型客船 .
車の横に止まっているバイク	2台の車に挟まれたBMWのバイク。
赤いクッションに寝転んでカメラ目線の猫。	モギーのベッドに横たわり、カメラを見上げている日焼けした犬。
窓の外を眺める灰色の猫.	窓から外を眺める猫......。
木の下にいる牛の白黒写真。	野原で木陰を歩く牛の白黒写真。
窓から差し込む日差しに照らされた鉢植え。	芽の出ていない鉢植え。
緑と白の2台の列車が線路に座っている。	緑と白の2台の電車が線路の上に座っています。
4人が岸辺でボートを漕いでいる。	緑色の水面に浮かぶボートに4人が乗っている。
赤いシャツを着た少女が茶色の馬に乗っている。	黄色いカバーレットとベッドに横たわる日焼けした白い犬。
石炭列車が線路を走っている。	古い列車が線路の上で眠っている。
ランドリールームの前に小さな机と椅子があります。	日焼けした壁と洗濯機と乾燥機のある部屋。
駅で待機するアムトラックの旅客列車。	駅に停車中の旅客列車
空港に停車中の大型ジェット機。	旅客機が空を飛ぶ。
カメラ目線の猫。	カメラを見ているグレー、黒、白の猫。
大型スクリーンに映し出される世界のニュースヘッドライン。	レースのために着飾った男がリラックスしている。
赤ちゃんと一緒にポーズをとる二人の女性.	赤ちゃんを抱いて微笑む二人の女性.
ヘルメットをかぶった少女がポニーに乗っている。	赤いブラウスを着た少女が茶色の馬に乗っている。
木のテーブルの上に横たわる灰色の猫。	ダイニングテーブルの上に寝そべる灰色の猫。
ポーチに座っている人たち	を、座っている人たち。
2頭の馬がペンの中に立っている。	野に放たれた馬の群れ。
裏庭に座ってギターを弾く男。	オレンジ色のSUVの後ろに乗っている男性。
赤い電車と黄色い電車が線路の上を走っている。	2台の列車が線路の上を走っている．
子羊が2匹の小さな動物の近くに立っている。	子供たちの近くに立つ羊。
椅子に座り、膝の上に赤ん坊を乗せて昼寝をする父親。	ピンクのシャツを着た男性が幼児と一緒に椅子の上で寝ている。
ダチョウの頭のクローズアップ。	ダチョウの顔のクローズアップ。
アウトドアでダートバイクに乗る人。	バイクを空中でジャンプさせる人。
草原で耳札をつけた日焼けした牛。	緑の丘の上に立つたくさんの羊たち。
木の枝にとまる緑と白の鳥。	緑色の頭と白い胸の鳥が木の枝に止まっている。
セイルボート 水上を走る .	青い海に浮かぶ帆船。
晴れた日に飛ぶ、赤と白の飛行機。	赤と白の飛行機が空中を飛ぶ .
帽子をかぶった男が白い馬に乗っている。	白馬に乗ったトップハットの男。
古い駅の白黒写真。	ソファに座っている猫の白黒写真。
遺跡の前で自転車。	ピンクの自転車がビルの前に。
バイキング帽をかぶった女性.	バイキングハットをかぶって座っている笑顔の女性。
白いダブルデッカーバスの駐車場。	赤と白のダブルデッカーバスが停まっています。
道路脇の赤い2階建てバス。	混雑した道路を走る赤い2階建てバス。
茶色の馬に乗った女性。	自分の写真を上から撮影する女性。
黒い顔の羊の群れ	黒い顔の羊。
2羽の鳥がメタルバンドにとまっています。	金属の棒にとまる2羽の小鳥。
バスが交通量の多い道路を走っている。	緑色のバスが道路を走っている。
キッチンの青いテーブルクロスでテーブルを .	キッチンの木製キャビネット .
アジア系の老夫婦が、あくびをする赤ちゃんと一緒に食卓でポーズをとっています。	年配のアジア人カップルが生まれたばかりの赤ちゃんと一緒に食卓でポーズをとっています。
緑の芝生を歩く茶色と白の鴨 .	晴れた日に飛ぶ、赤と白の飛行機。
ブレスレットをつけた若い女性が、ビキニトップとジーンズを着用しています。	ビキニトップとジーンズを着た女性。
緑の草原で草を食む茶色の馬。	草原の真ん中に立つ茶色の馬。
アルミホイルで覆われた皿の中央に、液体が入った鍋がある。	赤いテーブルクロスの中央に鍋が置かれている。
草原にたたずむ黒白の牛。	草原にたたずむアオカケス。
空には黄色と青の飛行機が飛んでいる。	青い空に白い飛行機が飛んでいる。
草むらに立って車を見つめる二人の男。	ピンクのトップスを着た女性がビールを持ってポーズをとっています。
クリスマスに椅子に座り、化粧をする女性。	電車が線路に止まっている。
書斎やリビングルームに座る4人のアジアの若者たち。	リビングチェアに座る少女。
線路を下る列車．	線路の上を滑走する列車 .
黒い服を着た若い女性。	着飾った2人の子供が椅子に腰掛けている。
水辺にいる2人のインディアンの女性と2人のインディアンの女の子。	二人のインド人女性が二人のインド人少女とビーチで立っている。
テーブルの上に座って飲み物を飲む人々	四人鼎立
テーブルには、2人分のワインと食器が用意されています。	木製のテーブルに、キャンドル、ワイン、そして紫色のプラスチックのボウルが置かれています。
遠くを飛んでいる飛行機．	白い馬に乗った女...
木々を背景にした河川荷役の一群。	黄色い札を耳につけた牛の群れが野原にいた。
ダイニングテーブルを背にしたリビングルーム。	大きなソファとダイニングテーブルのあるリビングルーム。
青いソファの上で休む黄色い縞模様の猫 .	ソファーで寝ているオレンジ色のタビーの猫。
駅に入る旅客列車。	大きな鳥が空を飛んでいる。
木々を背景に赤いカヌーで漕ぐ二人。	木々を背景に、黄色いカヌーで川を下る二人。
廃墟の前で原付バイクを走らせたら......。	建物前の芝生に停車している白いバス。
都市部では原付に乗る人が多い。	フェンスで囲まれた場所で馬に乗る人たち。
黒い列車が線路を走っていく。	黒い列車が線路を走っている。
店の前に停まっていた白いジープ。	路上に停車した白いジープ。
ツアーバスの前に立つ2人の女性。	飛行機の前で話す二人の男．
自転車が牽引するカートを運転する人。	防塵マスクをつけて三輪自転車に乗る男。
物置にある大きな銀色の機関車。	銀色の列車が駅に停車している。
黒い大きなバイクに乗った男。	黒い革張りの大きな椅子に座る子供。
本屋の前に自転車が止まっている。	スタンドアローンの人々
夕暮れ時の飛行中の飛行機。	夕陽の近くを飛ぶ飛行機。
大型バイクに座る二人。	長い枝に座る二羽の鷲。
赤いバスが2台、庭の前に停まっている。	赤いバスは、正式な庭の横にある大きな白い建物のそばに停まっています。
黄色いオウムがケージの横にしがみついている。	黄色とオレンジの鳥がケージの横につかまっている。
ドアの下を嗅いでいる犬。	閉じたドアを嗅ぐ白と黒の犬。
小さなヨットで航海するカップル .	小さな帆船で航海する二人の男．
車の横に座っている銀と青のオートバイ。	車の横に止まっているバイク
赤い二階建てバス .	赤い2階建てバス。
大きな建物を背景に、天気の良い日に立っている足。	バスを背景にバンの後ろに立つ2人の警察官。
ウッドデッキに寝転んで小枝をかじる白い小犬。	白い犬はテーブルの下の木の床に横たわっています。
銀色の電車の前に立っている男。	銀色の鉄道車両の前に立つ男。
舌を出した羊のクローズアップ。	舌を出している羊のクローズアップ画像。
野原に佇む黒と白の角のある牛。	野原にたたずむ黒白の牛。
冬に枝に座っている小鳥。	氷の枝にとまった小鳥。
金網の上で黄色い鳥が果物を食べている。	餌台で果物を食べる黄色い鳥。
白馬に乗った男が闘技場にいる。	白馬に乗った男...
茶色のアヒルと白いアヒルが草の上に立っている。	緑の芝生を歩く茶色と白の鴨 .
縞模様のソファに白黒の猫と犬。	窓の前に立っている白黒の猫。
畑の近くの線路に座っている電車。	線路を走る列車。
食卓に座る女性と小さな子供がカメラに向かって微笑んでいる。	木の梁の上に寝そべり、カメラを見上げている小さな猫。
テーブルの上に置かれた仏像と木製のテーブルランナー。	木製のフェンスポストの上に立つ鳥。
黒い正装と黒い帽子をかぶった男が、白い馬に乗っている。	白馬に乗ったトップハットの男。
庭の前を走る2台の赤いバス。	駅に停車中の列車
雪原で草を食む牛たち。	雪原で草を食む5頭の牛。
白馬に乗った男...	茶色の馬に乗った女性。
木に吊るされた餌台で、茶色の小鳥が食事をしている。	木に吊るされた餌台に小鳥が止まっています。
この写真は、大都市を背景にした田舎町の写真です。	大きな木を背景にした草原に、黒い牛が何頭かいる。
噴水の前に立っている青いシャツの男性。	青いシャツに日焼けしたズボンを履いた男が、石畳の広場にある男の像の前に立っている。
茶色の馬の上に乗馬服を着た少女が座っている。	赤いシャツを着た少女が茶色の馬に乗っている。
車の横に、薄着の女性が立っている。	黄色とオレンジの鳥がケージの横につかまっている。
テレビが何台も床に置かれ、積み重ねられている。	3台のテレビ、1台は床の上に、残りの2台は箱の上に置いてあります。
羊が木立の近くの草原で草を食んでいる。	並木の前の野原で羊が草を食んでいる。
本棚の前にある透明なプラスチックの椅子。	本棚の前にある透明なプラスチックの椅子。
犬がグレーのジャケットを着ている。	ペットジャケットに寝そべる犬。
羊が丘の上に立っている。	丘の上に立つ大きな羊。
草原にたたずむ黒白の牛。	野原にたたずむ黒白の牛。
青と赤の飛行機が空中を飛行中 .	飛行中の青と赤の飛行機。
黒いビキニトップとジーンズの女性。	黒い帽子をかぶった女性が地下鉄のそばに立っている。
茶色の馬に乗った少女。	騎手は紫色の服を着て、茶色の馬に乗っています。
黄色のコルベットの前に立つ男。	黄色いスポーツカーの横に立っている男性。
テントの中でポーズをとる3人の男たち．	キッチンで食事をする3人の男たち。
草の上に座って空を見ている男。	男は馬の前の歩道に立っている。
像のある大きな噴水の前でポーズをとる男性。	噴水の前に立っている青いシャツの男性。
小犬は飼い主を守る	標識の裏側にはステッカーが貼られています。
羊を見る子供たち。	外で乳を搾る子供
カーペットの上に立つ白い猫。	森にたたずむ羊。
床にはフラットスクリーンテレビが設置されています。	フラットスクリーンテレビが置かれています。
グレーの猫にグリーンの瞳のクローズアップ。	クリーム色のソファに座る猫のクローズアップ。
草原に佇む2頭の茶色い馬。	小さな帆船で航海する二人の男．
二匹の羊が戸口に立っている．	雪の上に立つ2頭の雄羊。
列車は駅に停車中です。	列車は駅に停車します。
コンピュータのモニターが数台ある部屋	コンピュータのモニターが4台並んだ部屋......。
列車は線路を下り、生け垣に沿って進んでいく。	中庭の床にいる犬が、塀の上の猫を見ている......。
旅客機が滑走路に駐機している。	地上近くを飛行する大型旅客機。
小さな女の子がカメラに向かって笑っています。	大きな耳を持った白い牛がカメラに向かっている。
テーブルの上に置かれた古い緑色のボトル。	テーブルの上に座る3人のスーツ姿の男たち。
ラブシートの白黒写真。	古い駅の白黒写真。
ステッカーがたくさん貼られた標識の裏側。	看板の裏にシールを貼ったもの。
フェンスの向こうで見つめる2頭の白馬。	2頭の馬がペンの中に立っている。
大画面テレビを備えたリビングルームまたは書斎。	リビングルームには、日焼けした家具とフラットスクリーンテレビを設置。
黒牛と白牛が門の前でポーズをとっている。	白い飛行機が空を飛んでいる。
草原にたたずむ黒白の牛。	野原に佇む黒と白の角のある牛。
芝生に座っている2人の女性。	二人の女性がカフェに座っている。
赤い2階建てのバスが走っている。	赤い2階建てバスが通りを走っている。
寝そべっている猫の白黒写真。	絨毯の上で寝そべる猫の白黒画像。
男女が立って、カメラに向かって微笑んでいる。	男女がカメラに向かってポーズをとっています。
革張りの椅子の上で眠っているオレンジと白の猫。	オフィスチェアに座るジンジャーキャット。
カーペットの上に立つ白い猫。	白い縞模様の可愛い猫が、テーブルから頭を垂れている。
机の上に横たわる白と灰色の子猫。	緑の芝生に寝そべる男と自転車。
湖畔にたたずむオレンジ色の長い脚を持つ白い鳥。	オレンジ色の長いくちばしを持つ大きな白い鳥が海岸線に立っている。
雪の中、マンションの前でポーズをとる女性......。	建物前の芝生に停車している白いバス。
ブレスレットをつけた若い女性が、ビキニトップとジーンズを着用しています。	ジーンズと濃い色のビキニトップ、そしてブレスレットを身につけた女性。
雪に覆われた街を走る赤い電車。	雪の中、線路の上を走る列車。
壁に絵が描かれ、シーリングファンがある部屋に、テーブルと椅子がある。	緑の木々や草を背景に道路を走るスクールバス。
黒い鳥は地面に座っている。	木の下で豚の背中と牛の背中。
ベッドにあぐらをかいて座り、小さなテレビを見ている男性。	小さなテレビのすぐそばのベッドに座っている男性。
滑走路に置かれたダスエアーの貨物機。	滑走路に駐機している旅客機。
青い車のヘッドライト	青い車のヘッドライトのクローズアップ.
紫色のシートの上で眠る猫。	紫色の毛布の上で眠る白黒の猫。
駅に入る旅客列車。	駅に停車中の客車。
クリーム色のソファに座る猫のクローズアップ。	馬のクローズアップ。
都会の橋を渡る3人の自転車。	雨の中、自転車が橋を渡っている。
イギリスの街角を走る、赤と白のバス。	赤と白の英国製バスが通りを走っている。
カメラに向いた飛行機	寒い庭に一頭の牛が座っている。
茶色の馬に乗った女性。	茶色の馬に白衣を着た人が乗っている。
馬に乗る騎手。	ペンの中で馬に乗る騎手。
2匹の犬は、動物たちの中に溶け込んでいます。	たくさんのぬいぐるみが置かれたソファに、2匹の犬が座っている。
ウッドキャビネットとダイニングテーブルのあるキッチン。	木製のキャビネットと家具を備えたキッチン。
線路の上を列車が走っている。	田舎町の線路を電車が走っている。
街並みのグラフィティが描かれた壁の近くに、バイクが止まっている。	夕暮れの街の壁画のそばに停車するバイク。
雪山の上に立って飛行機を見ている人。	山の上に立って飛行機を見る男。
鳥は水の中を泳いでいます。	鳥は水の上を低空飛行する。
水中で鳥が羽ばたいている。	大きな黒い鳥が水の中に座っています。
カメラを見ている黒い犬。	白黒の牛がカメラを見ている。
港に停泊しているクルーズライナー。	海岸に停泊しているクルーズ船。
混雑した道路を走る赤い2階建てバス。	公道で雪に埋もれた白いバス。
フェンスで囲まれた場所で犬を撫でている女性。	ゲートのある庭で犬を撫でている女性。
毛布で遊ぶ白黒の猫。	白黒の猫が毛糸の入ったバスケットに入り込む。
マウンテンバイクで傾斜を下る男。	これは、晴れた日に岩の上をマウンテンバイクで走る男性です。
オフィスチェアの上でくつろぐ猫。	オフィスチェアに座るジンジャーキャット。
野に放たれた馬の群れ。	緑の草原で草を食む茶色の馬。
フェンスに囲まれた犬小屋にいる2匹の犬は、前を向いている。	ダイニングルームで赤ちゃんと一緒にポーズをとる二人の女性。
乗用車から見た未舗装路の3匹の羊。	砂利道の真ん中に羊が3匹。
空には黄色と青の飛行機が飛んでいる。	9機の赤と白の飛行機が煙を吐きながら編隊を組んで飛んでいる。
列車は駅に停車します。	ブルートレインは駅に到着しました。
畑の近くの線路に座っている電車。	赤ん坊が草むらに座っている。
乗客を乗せる赤い2階建てバス .	赤い2階建てバスが、街で多くの乗客を乗せている。
二人の男がビールを飲みながらソファに座り、女の子が膝の上に横たわっている。	自転車と一緒に通りを監視している二人の女性、いつ渡ることができるのか。
台所で物を見ている二人の女性。	キッチンにいる2人の女性と、写真を撮る1人。
カメラに向かってくる蒸気機関車と汽車。	カメラに向かって飛んでくる大きな猛禽類。
野に放たれた馬の群れ。	草原で草を食む馬の群れ。
コカ・コーラのガラス瓶の白黒写真。	これは、背の低いコカ・コーラのボトルの白黒写真です。
氷の枝にとまった小鳥。	枝にとまった黄色い鳥。
マーケット広場でバイクに乗った数人の人々。	街角でバイクに乗る人々。
乗用車から見た未舗装路の3匹の羊。	未舗装路の3匹の羊を車から撮影。
コンピュータに入力する眼鏡の少年.	コンピュータの画面を見ている少年。
エルヴィスの格好をした2人の男性とポーズをとる人々。	エルヴィスの格好をした2人と一緒に立っている人たち。
赤いトラックはタイヤを回転させ、黒いトラックはフレームから離れる。	赤いトラックがタイヤをスピンさせ、後ろから煙を上げている。
テーブル、椅子、ソファのあるリビングルームと大きなヤシの木。	青いソファ、キャンプベッド、木製ベンチ、ドレッサーを備えたリビングルーム。
小さな赤ちゃんを抱いた笑顔の女性。	ソファに座って赤ちゃんを抱く女性。
エッソのガソリンスタンドと背景の木々。	バスを背景にバンの後ろに立つ2人の警察官。
4隻のボートの上を4機の青と黄色の飛行機が飛んでいる。	青と黄の4機の飛行機が飛行中。
門の近くに立っている馬と、その後ろにいる別の馬。	木々を背景にした河川荷役の一群。
テーブルの上に置かれた3本のボトル。	テーブルの上に置かれた古い緑色のボトル。
二人の少年がテーブルに向かい合い、一人がもう一人を指差す。	二人がテーブルに向かい合い、一方がもう一方を指差す。
蒸気機関車が木のそばを走っている。	列車は駅に停車中です。
列車は駅に停車中です。	駅に停車中の電車。
白い犬が2匹、水の中を泳いでいます。	鳥は水の中を泳いでいます。
小さなショッピングカートを押すオウム。	白い鳥がショッピングカートを操っています。
ソファに座って赤ちゃんを抱く女性。	湖に浮かぶ丸太の上に座る鳥。
黄色いカヌーで水面を漕ぐ男。	岸に向かって黄色いカヌーを漕ぐ男。
水飲み場に向かって飛んでくる2羽の鳥。	鳥の餌箱の近くを飛ぶ2羽の鳥．
広い野原に立つ2頭の牛．	野に立つ馬
ビール瓶（ -lrb- ハープラガー ） -rrb- 床に並べられた.	床に並べられたビール瓶の数々。
外で笑っている二人の女性。	バスの外に立っている2人の女性。
丘の上で草を食む羊たち。	羊の一団が丘の上にいる。
電車の前に立っている人。	ある男が、高く掲げられた像の前に立っている。
カメラに向かってくる蒸気機関車と汽車。	丘の上にいる白い羊がカメラを見ている。
二人の女性がカメラに向かってポーズをとり、親指を立てている。	笑顔でサムズアップサインをする若い女性2人。
ソファに座った女性が小さな赤ん坊を抱いている。	ソファに座って赤ちゃんを抱く女性。
街角を走る赤い2階建ての統一バス。	赤い2階建てのバスが走っている。
茶色のソファに座る二人の女性。	バスの外に立っている2人の女性。
グレーの猫にグリーンの瞳でカメラを見つめています。	カメラを見ているグレー、黒、白の猫。
鳥は枝の上に座っています。	羊は木の下に立っている。
一部曇りの青空を背景に、草の上に立つ白黒の牛。	一部曇りの青空を背景に、金属製のゲートの後ろにいる2頭の白黒の牛。
野原でカメラを覗き込む茶色と白の牛......。	白黒の猫がカメラを見上げている。
白馬に乗った男。	白馬に乗った男が闘技場にいる。
乳牛が2頭、池で水を飲んでいる。	2頭の牛が池で水を飲んでいます。
ペンの中に毛を刈られた羊が何匹かいる。	囲いの中にいる3匹の白い羊．
雪の山の近くに立つ黒と白の牛。	野原にたたずむ黒白の牛。
黒い犬が草むらに横たわっている。	黒い犬が草の上に横たわっている。
明るいグリーンの壁とアートワークのあるホームオフィススペース .	複数のデスクと緑の壁で構成されたオフィス。
水面に浮かぶ大きな白い客船 .	水面に浮かぶ大型客船 .
二人の若者がガラス戸の横のテーブルに座り、一人がもう一人を指差している。	二人がテーブルに向かい合い、一方がもう一方を指差す。
車を運転している人とバイクを運転している人の白黒写真。	クラシックカーに乗った男性とクラシックバイクに乗った男性の白黒写真。
手をつないで浜辺を歩く男と女。	ヒゲとスカルキャップの男と少年が海辺を歩いている。
カメラ目線の羊が10匹.	仰向けでカメラを見ている猫。
カメラを見ている白黒の犬。	ペンの中でカメラを見上げている小さな白黒のヤギ。
黒いテーブルと白いモコモコチェア。	子連れの女性...
乗客を乗せる赤い2階建てバス .	赤い2階建てバスが通りを走っている。
セイルボート 水上を走る .	曇りの日に出航するヨット .
青い鳥が手袋をはめた人の手にとまる。	手袋をはめた手に鳥がとまっている。
黄色いカヌーを持った3人が水辺にいる。	カヌーの準備をする3人
茶色と白の馬に乗った少女。	茶色の馬に乗った少女。
線路の上を走る、ほとんど黒塗りの列車。	線路の前に停車している車。
赤と青のクレヨンで塗り絵をする少年。	乗馬服を着た金髪の少女が、灰色と白の馬の上に座っている。
枝にとまった2羽の白頭ワシ。	二羽のワシが枝に止まっている。
リビングルームにいる人たち。	巨大なキノコの前を歩く4人組。
水辺の草むらで、マガモと白ガモを飼う。	ピンクのドレスを着た小さな子供が、テーブルの上に座っている。
ドアの前にある2台の自転車の間に猫が座っています。	柵の前の野原に立つ馬よりも．
赤いバッグを持った少女が路上に立っている。	黒い犬が羊を見つめている。
馬に乗った乗馬帽子の少女。	日焼けした馬に乗る少女。
白い馬に乗った騎手がいる。	白馬を率いる女...
棒を持った淡いスカーフ姿の男。	日陰でソーダを飲みながら休んでいるランナー。
鳥は枝の上に座っています。	赤と茶色の鳥が枝にとまっている。
長い列車は線路の上にある。	線路の上の列車。
黒と褐色の犬が黒い羊を見ている。	ペンの中の茶色の羊を見つめる黒い犬。
パソコンが何台も並び、壁には絵が描かれている。	机の上に3台のパソコンとその他の機器を置いたホームオフィス。
テレビが置いてあるレトロなリビングルーム。	木のテーブルの上に横たわる灰色の猫。
野原で木の下を歩く牛の白黒写真。	カメラを見ている白黒の犬。
シルバーのアレオメヒコ・ジェットライナーが滑走路に座っている。	アエロメヒコ航空のシルバー機が滑走路を走っている。
ダートバイクに乗った男が、とても高くジャンプしている。	バイクに乗った男が、空をバックにジャンプしている。
馬に乗った乗馬帽子の少女。	茶色の馬に乗った少女。
白い小さな帆船を操る二人。	小さなヨットで航海するカップル .
白い飛行機がセメントに止まっている。	青いバイクが歩道に止まっている。
毛皮の帽子をかぶってポーズをとる人々。	緑と白の服を着たサイクリストと、それを見守る観客。
野原で草を食む3頭の牛 .	野原で草を食む数匹の羊たち。
車が路肩に停車している。	丘の前の道端に停まっていた銀色の車。
男は雑然としたテーブルに座り、ノートパソコンを使っている。	雑然としたテーブルの上に置かれたラップトップ・コンピュータを見ている男。
茶色のテーブルの上に横たわる黒い家猫。	ダイニングテーブルの上に寝そべる灰色の猫。
ダイニングテーブルとキャンドル、ワイン、ティーポット。	木製のテーブルに、キャンドル、ワイン、そして紫色のプラスチックのボウルが置かれています。
納屋の動物に見入る4人の子供たち。	羊を見る子供たち。
羊毛のバスケットで遊ぶ白黒の猫。	毛布の上に横たわる白黒の猫。
赤いカヌーを漕ぐ2人の姿が、静かな水面に映し出されている。	澄み切った湖に浮かぶ赤いカヌーに乗った二人。
車の横に、薄着の女性が立っている。	小さな赤い車の横に立っている薄着の女性。
乗客を乗せる赤い2階建てバス .	赤のダブルデッカーバスのボンネットを開けたところ。
男はマントを着てあぐらをかき、棒を持っている。	茶色の布を身につけ、木の棒を持ち、あぐらをかく男。
テーブルの上にロウソクを持った仏像が置かれている。	湖の上で小さなボートで釣りをしている男性。
階段の下にいる2匹の白黒の犬。	階段の下に犬が寝ていて、その横に別の犬が立っている。
食卓に座ってカメラに向かって微笑む3人。	老女二人、男一人で食卓を囲む。
色とりどりの列車が線路を走っている。	線路の上を走る、ほとんど黒塗りの列車。
白と赤のバスが走っている。	赤いバスが通りを走っている。
赤と青の飛行機がギアを下げて飛んでいる。	ランディングギアを下ろした第二次世界大戦中の戦闘機。
小川を下る小舟．	川を進む船。
4人の女性と2人の男性が、レストランの長いテーブルに座っている。	イタリアンレストランのテーブルに座る一団。
大海原に浮かぶ古風な木造帆船。	桟橋に停泊している古い木造の帆船。
野に立つ二匹のヤギの木に	大きな船が小さな白い船を引っ張っている。
草の上にあぐらをかいて座る男、背景には木がある。	海岸に近いオーシャンライナー、背景は家々。
大きな窓のあるリビングルーム、ソファ、椅子の白黒写真。	家具が置かれた部屋から森を眺める白黒のシーン。
青いホルターと茶色の馬のクローズアップ。	青い幌をかぶった馬のクローズアップ。
大きな黒い鳥が水の中に座っています。	鳥は水の中を泳いでいます。
クリーム色のソファに座る猫のクローズアップ。	白いソファで休むシャム猫。
自転車に飛び乗り、芸をする人。	アウトドアでダートバイクに乗る人。
黄色いスクールバスが停まっている。	野原に停車中の黄色いスクールバス。
緑のゴミ箱の横で、黄色い椅子の上に座るパグ犬。	大きなゴミ箱の横で、黄色い椅子に座っているブルドッグ......。
赤いバイクに座っているのは女性です。	白い羊は緑の丘の上に立っています。
オークションのテーブルの上に立つ羊。	オークション会場での羊の毛。
黒い電車のエンジンをクローズアップ。	黒い頭を持つ白い羊のクローズアップ。
革張りの椅子の上で眠っているオレンジと白の猫。	オレンジと白の猫が、黒い革張りの椅子でブランケットに横たわっています。
彼の線路の上を列車が走る。	列車が線路を下りてきて、二列の木の間を通る。
水面に浮かぶボートの上の二人の男。	大海原に浮かぶ木造のヨット。
草原に佇む白黒の牛。	野原に佇む黒と白の角のある牛。
街中を走る赤い2階建ての統一バス。	街角を走る2階建てバス。
ソファに座って窓の外を眺める2匹の猫。	窓から外を眺める猫......。
ホテル客室のテレビと机をランプで照らす。	ホテルの部屋には、テレビとノートパソコンがあります。
小さな自転車に乗った男性。	男がバイクでウィリーをしている。
3匹のヤギが犬に丸め込まれている．	3匹のヤギが犬に追いかけられる......。
ネイビーのドレスを着た女性が、白いテーブルの上でケーキをカットしています。	晴れた日にヘルメットをかぶった人が自転車に乗っている。
マウンテンバイクでウィリーをしている男性。	u2のサインを掲げた柱のそばでポーズをとる女性。
カーペットを敷いた床の上で、日焼けした子犬。	白いカーペットの上で寝そべる子犬。
黒い列車が線路を走っていく。	線路を走る列車。
白と紫のバイクをクローズアップした写真。	パソコンと書類が置かれた机のクローズアップ写真。
茶色の馬に乗った少女。	茶色の馬に乗った女性。
草原にたたずむ黒い犬。	草深い森の中に立つ長毛の犬。
台所で物を見ている二人の女性。	テーブルの上に座る3人のスーツ姿の男たち。
赤ちゃんと一緒にポーズをとる二人の女性.	赤ちゃんと一緒にポーズをとる女性。
テーブルを囲んでの食事。	リビングルームで4人がお菓子を持って座っています。
駅に停車中の列車	駅に停車中の列車
青いバイクが歩道に止まっている。	歩道に停まっていた青い原付バイク。
芝生の上に立つ青い鳥......。	緑の芝生の上に立つ青い鳥.
街角を走る赤い2階建てバス。	赤い2階建てバスが通りを走っている。
駅に停車中の2台の列車。	列車は駅に停車します。
馬に乗る女性の乗馬。	茶色の馬に乗っているのは女性です。
空っぽのオフィスの一室。	空いているオフィスの椅子
白馬に乗った男...	白い馬に乗った女...
線路を下る列車．	線路の上を走る黒い蒸気機関車。
青いソファに座り、カメラに向かって微笑む男性と女性2人。	キッチンに立ち、カメラに向かって微笑む男女。
レストランのテーブルに座る男女。	女性4人と男性2人がレストランの長テーブルに座っている。
縞模様のシャツを着た若い男が、2台の自転車を持っている。	ビーチの近くで2台の自転車を抱える赤毛の青年。
港に停泊中の大型客船と背後の木々。	海岸に停泊しているクルーズ船。
白い飛行機が滑走路を走っている。	スイスの白い飛行機が滑走路に近づいてくる。
交差点を渡る2頭の牛 .	2頭の牛が舗装された道路を横切る。
中央分離帯で草を食む数頭の牛。	道路に挟まれた草地に5頭の牛が放牧されている。
明るい部屋に、テレビ、布張りの椅子、コーヒーテーブル。	リビングルームに置かれた革張りのソファと木製のテーブル。
白いアヒルが地面に立っている。	黒い帽子をかぶった女性が地下鉄のそばに立っている。
黒い牛と茶色の牛が、根こそぎ倒れた木の前の平原に立っている。	畑の中の小さな雑木林の前に立っている黒い牛と茶色の牛............。
赤い2階建てバスが通りを走っている。	街角を走る二階建てバス。
草原で耳札をつけた日焼けした牛。	草原で羊の世話をする人。
紫と白のオートバイのフロントエンドのクローズアップ。	赤いスポーツカーの後部をクローズアップ。
洋服屋で買い物をする二人の女性．	衣料品店の二人の女性．
茶色の馬の頭のアップ。	黄色いスクールバスのクローズアップ。
レンガの梁の横に赤い帽子をかぶった人が立っている。	茶色の馬が草むらに立っている。
草原を歩く母馬の横を子馬が歩いている。	大きな馬の横を歩く若い馬のクローズアップ。
褐色の牛の横に立つ女性。	眼鏡をかけた女性が、野原で牛の横に立っている。
ソファーに座って窓の外を眺める2匹の猫。	二匹の猫が窓を眺めている。
トラックの荷台から犬が顔を出している。	バンの荷台から犬が顔を出している。
青いシフトドレスの女性が食品を切っている。	青いドレスの女性がケーキをカットしている。
白黒の猫がカメラを見上げている。	カメラを見ているグレー、黒、白の猫。
赤と黄色のバイクの上に座る2人のブルネットの女の子とサイドカー。	赤と黄色のバイクに乗ったカップルがポーズをとっています。
シンクにたたずむ小さな白い猫。	バスルームのシンクに座っているグレーと白の猫 。
赤いタンデム自転車の後部座席に乗った男性。	タンデム自転車の荷台に一人乗っている男。
セーターを着た小犬がカメラを見上げている。	ジャケットを着た白い小型犬がカメラを見上げています。
草むらに立って車を見つめる二人の男。	店内の椅子に座る二人の女性。
机の上のパソコン	机上で操作するコンピュータ。
カメラに向かって微笑む小さな子供。	白い花のそばのセメントの壁に座る小さな子供。
水に浮かぶ小鳥。	水に浮かぶアヒル......。
雪の中、建物の前に立つ女性。	ダイニングルームの前でポーズをとる女性2人と赤ちゃん。
Juliaと書かれた白いバスが、水辺と大きな船に近づいている。	白いバスと水とはしけを背景に。
明るいグリーンの壁とアートワークのあるホームオフィススペース .	明るいグリーンの壁のある小さなオフィス空間 .
線路の上を走る青と白の古い列車。	山岳地帯を走るブルートレイン。
テーブルの上に座っている若い赤ん坊の女の子。	テーブルの上に座る赤ちゃんと笑顔の女性。
サロンに停まっていた緑色の車。	サロンの前に停まっていた緑色の車。
浜辺に浮かぶ黄色い船。	岸辺の黄色い船。
青い布のダイニングテーブルの上に書類を並べたキッチンダイナー。	小さなキッチンと乱雑に置かれたテーブル、そして青いテーブルクロス。
駅に停車中の列車	屋内駅構内の列車。
灰色の猫が窓の縁に座って、カメラを見ています。	猫が窓辺に立ってカメラを見ている。
二羽の鴨が水辺にたたずんでいる。	鳥は水の中を泳いでいます。
干し草のあるペンの中の白黒の牛。	フェンスの向こうの黒と白の牛。
座ってギターを弾く男性	道路を走る赤と白のバス .
男女がカメラに向かってポーズをとっています。	砂の上に座ってカメラを見上げている猫。
赤い2階建てバスが通りを走っている。	街角を走る二階建てバス。
空港から離陸する緑と白の貨物機。	滑走路を離陸する白と緑の旅客機。
3頭の牛が草原で草を食べています。	野原で草を食む3頭の牛 .
茶色い電車が線路の上に座っている。	白い電車が線路に止まっている。
野原に佇む黒と白の角のある牛。	ソファに座っている猫の白黒写真。
白と黒の毛皮の囲いの中に2匹の猫が仲良く入っています。	牛をモチーフにした毛皮で覆われたドームの中に、2匹の子猫が座っています。
青いドレスを着た金髪の小さな子供が、母親のそばでテーブルの上に座っている。	ヘルメットをかぶった金髪の少女が、赤い自転車と一緒に座っている。
干し草のあるペンの中の白黒の牛。	白と黒の猫が土の中に横たわっている。
赤い2階建てバス。	赤いダブルデッカーバスの前面と左側面。
野原に停車中の黄色いスクールバス。	緑の草原に褐色の馬......。
馬の頭のアップ。	馬の頭部を横から見た図。
自宅でノートパソコンに向かう高齢者。	ソファに座ってラップトップを持つ老紳士。
大海原に浮かぶ古風な木造帆船。	大海原に浮かぶ木造のヨット。
山中に立つ羊．	丘の上に立つ大きな羊。
キッチン横の小さなソファに座る人々。	馬の背に座る小さな子供のそばに立つ一群の人々。
白い飛行機が滑走路を走っている。	白い飛行機が滑走路を走っている。
撫でられる子犬。	仔犬を抱っこして撫でる。
猫がキャットフードの袋の上に座っています。	長い枝に座る二羽の鷲。
木製家具のあるエレガントなダイニングルーム .	ピンクのダイニングルームと木の家具。
ソファに座った二人の男性の間に女性が横たわっている。	短パン姿の二人の男がソファに座っている。
ダートコースを走る2台のバイク。	ダートヒルを走る2人のダートバイカー。
ダートバイクに飛び乗る男。	自転車に乗った男が空中をジャンプしている。
白黒の猫がカメラを見上げている。	カメラを見ている白黒の犬。
グレーの猫にグリーンの瞳がカメラ目線。	グレーの猫にグリーンの瞳でカメラを見つめています。
二匹の子羊が草原の丘の上に立っている。	ダートヒルを走る2人のダートバイカー。
茂みの前にある岩の彫刻の上に座っているボトルの白黒写真。	石の上に置かれた水のボトル、背景には他の石や壁があります。
茶色の馬に乗った女性。	茶色の馬に乗った少女。
ソファの上に少女の黒と白の写真。	木の下にいる牛の白黒写真。
白黒の猫が茶色の椅子に座り、上を見上げています。	ウッドチェアに座って見上げる白黒猫.
野原に佇む黒と白の角のある牛。	野原にいる大きな黒白の牛。
ワインボトルを持った白い服の男と、赤いタートルネックに白いベストを着た女......。	野原でワインを片手にポーズをとる男女。
寒い庭に一頭の牛が座っている。	野原にたたずむ黒白の牛。
街角を走る2階建てバス。	赤い2階建てバスが通りを走っている。
窓辺で休んでいる大きな白黒猫。	シンクに座っている小さな白い猫。
羊に餌をやる少年．	羊に干草を与える少年。
建設現場で資材の横に立つ黒い犬。	工事現場の真ん中に立っている黒い犬。
黒いデスクトップの少女が、コーンフレークの箱と牛乳パックを開いて持っている。	黒いショートパンツとブーツを履いた少女が、青いバイクの横に立っている。
鉢の中の小さなサボテンをクローズアップしてみました。	白い子犬を抱く女性のクローズアップ。
白い羊は緑の丘の上に立っています。	羊が丘の上に立っている。
帽子をかぶった長髪の男が、半分空っぽの大きなコーラの瓶2本の間に立っている。	キャップとジャケットを着た男が、2つの大きなボトルの間を歩いている。
草原を背景に水面に浮かぶ白と黒の鳥。	観覧車をバックにバスが走っている。
日よけのついた木製の自転車。	老人たちが食卓を囲んでいる。
老朽化した木製のフェンスの白黒写真。	汚れた通りの近くにある古い木のフェンスの白黒写真。
店内の椅子に座る二人の女性。	二人の女性がカフェに座っている。
緑の草原に佇む2頭の茶色い馬。	褐色の馬が高い草の中に立っている。
ヘルメットをかぶった二人の男。	店の前に自転車を持って立つ二人の男。
滑走路をタキシングするアエロメヒコ航空のジェット機。	シルバーのアレオメヒコ・ジェットライナーが滑走路に座っている。
雪の中に座っている赤い鳥と他の4羽の鳥。	5羽の鳥が雪の上に立っている。
ダイニングルームを背景に椅子の絵を描く女性。	海を背景に浜辺を歩く男と少年......。
お店でゲームをしている人。	店舗でゲームをする男性。
縁側でテーブルを囲む一団	食卓を囲む人々
年配のアジア人カップルが生まれたばかりの赤ちゃんと一緒に食卓でポーズをとっています。	ダイニングテーブルを囲んでポーズをとる高齢者のグループ。
自転車を背景に、ヘルメットをかぶった少女。	女性が鎖につながれた小型犬を抱きかかえ、背景には椅子がある。
ステッカーがたくさん貼られた標識の裏側。	標識の裏側にはステッカーが貼られています。
本屋の前に自転車が止まっている。	書店の前に停まっていた緑色の自転車。
茶色い2階建てバスと観覧車。	観覧車の前を走る2階建てバス。
レンガの壁と窓の前に置かれた白と黒の椅子。	白い毛に覆われた頭の黒い羊が、他の羊と一緒に牧草地に立っている。
窓の外を眺める家猫。	窓の外を眺める白猫。
二頭の牛が野原で草を食んでいる。	緑の草原に褐色の馬......。
白馬に乗った黒い軍服の男...。	白馬に乗ったタキシードの男。
車内で寝ている猫に枕を持たせて。	アニマル柄のブランケットに寝そべる猫。
リビングルームに立つ2人の女性と1匹の黒い犬......。	リビングルームに立つ2人の女性とカメラの方を見る黒い犬。
ダートコースを走る2台のバイク。	ダートコースを走る2台のバイク。
赤いカヌーを漕ぐ2人の姿が、静かな水面に映し出されている。	木々を背景に赤いカヌーで漕ぐ二人。
青い旧式の車のヘッドライトをクローズアップしたもの。	青い車のヘッドライトのクローズアップ.
高速道路の高架下に人が立っている。	水辺で犬の散歩をする人。
模型の建物の近くを走る車 .	華やかな建物の中を走る車たち。
女性や子供がベビーカーを押して歩道を歩いている。	歩道をベビーカーで歩く女性と少女。
青とオレンジの飛行機が着陸装置を下げて飛んでいる。	赤と青の飛行機がギアを下げて飛んでいる。
若い女性がベイホースでダートライディングリングをしています。	男が白いたてがみの馬を見つめている。
白い鳥が木に登っている。	シーツの上に寝そべる白猫。
毛布の上に横たわる白黒の猫。	紫色の毛布の上で眠る白黒の猫。
駐車場入口に仮設看板を設置したビル。	バスのテールランプの後方をイメージした道。
テーブルを囲んでの食事。	縁側でテーブルを囲む一団
ソファに座って小さな赤ん坊を抱く男女。	ソファに座って赤ちゃんを抱く女性。
毛布の上に横たわる白黒の猫。	紫色の毛布の上で横向きに寝ている白黒の猫。
ラブシートの白黒写真。	自転車の白黒写真。
ダイニングテーブルを背にしたリビングルーム。	ダイニングルームを背にしたリビングルームの様子。
食卓にワイン、ビール、レモンを並べた女性。	4人の女性と2人の男性が、レストランの長いテーブルに座っている。
赤とグレーの電車がトンネルをくぐっている。	赤とグレーの列車が木々の間のトンネルを抜けていく。
ボンネットを開けた赤い2階建てバス .	ボンネットを上げた古い赤のロンドン・ダブルデッカー・バス。
ノートパソコンとパソコン用モニター。	ワークステーションのノートパソコンとパソコン。
白馬に乗った男...	白馬を率いる女...
ダイニングルームを背にしたリビングルームの様子。	大きなソファとダイニングテーブルのあるリビングルーム。
オレンジ色の子猫が革張りのソファに横たわっていた。	黒いソファに座る若いカップル。
オフィスチェアの上に寝そべる白猫。	シーツの上に寝そべる白猫。
南国のビーチに浮かぶ小さな黄色い船。	小さな女の子が石の棚の上に座り、白い花を咲かせている。
木造の建物の中で、2人の女性が白い羊の毛を刈っている。	木製の屋台で白い羊の毛を刈る二人の女性。
ヘルメットをかぶっている人が携帯電話で話している。	ヘルメットをかぶった人が白い建造物の近くを自転車で走っている。
地下鉄が駅に入ってくる。	駅に停車中の白い電車。
お店の前に自転車が止まっている。	書店の前に停まっていた緑色の自転車。
浜辺に立つ二人の男。	ツアーバスの前に立つ2人の女性。
手前にメガネとペットボトル2本を持った男性。	水筒を2つ前に置いて話している男性。
草原に佇む長毛の黒犬。	草原にたたずむアオカケス。
ランドリークローゼットの近くに小さな机と椅子。	日焼けした壁と洗濯機と乾燥機のある部屋。
赤い2階建てバスが通りを走っている。	赤い2階建てバスが通りを走っている。
鵞鳥の羽ばたき	水面で羽ばたく黒い白鳥。
茶色のテーブルの上に寝そべる灰色の猫。	木のテーブルの上に横たわる灰色の猫。
外の車の横に停まっているバイク。	車の横に止まっているバイク
茶色の馬をクローズアップ。	馬のクローズアップ。
犬とソファに横たわる少年.	少年は子犬と一緒にソファに横たわっている。
絨毯の上で寝そべる猫の白黒画像。	ラグに横たわる猫の白黒写真。
空港に停車中の大型ジェット機。	夜の空港に停まっている大きな飛行機。
椅子を乗せた木製の中古建材の山。	椅子の上に木の破片の山.
二人の女性がカフェに座っている。	沼で魚を捕る二人の男．
ハープラガーが8本、床に並んでいる。	ハープビールの瓶が8本、フローリングの床に並んでいる。
複数のデスクと緑の壁で構成されたオフィス。	明るいグリーンの壁のある小さなオフィス空間 .
白馬を率いる女...	白馬に乗ったタキシード姿の男。
カメラに向かって微笑む小さな子供。	カメラ目線の猫。
茶色の馬に乗った女性。	茶色の馬に乗る青い服の人。
映画上映中のテレビ画面の写真	壁掛けの薄型テレビでは、映画を上映しています。
植木鉢にとまった鳥。	漆喰の壁のそばの植木鉢にとまった鳥。
シンクの中に座っている白い猫。	バスルームのシンクに座っているグレーと白の猫 。
馬の上に乗る乗馬服の若い女性。	馬に乗った乗馬服の若い女の子.
二人は小さなボートを走らせている．	ヨットに乗る二人の女性．
小さな枝の上の小さな鳥。	氷の枝にとまった小鳥。
岩の上に座る2匹の動物．	長い枝に座る二羽の鷲。
二匹の猫がソファの背もたれに座って窓の外を眺めている。	ソファの背もたれに座って窓の外を眺める2匹の猫、海の写真 .
ウィリーするバイクの男。	車の横でウィリーするオートバイの人。
駅に停車中の客車。	黄色いエンジンの客車。
二人の若い女性が羊の毛を刈る．	羊の毛を刈る二人の女性．
銀色の電車のエンジンの左側.	黒い電車のエンジンをクローズアップ。
若いライダーは茶色の馬に乗ります。	茶色の馬に乗った若い女性のライダー。
小さな白い子羊、鼻を木につけて。	白い子羊が木の箱に鼻を当てている。
黒い列車が線路を走っていく。	長い列車は線路の上にある。
フィリップスの薄型テレビと2つのリモコンが映し出されています。	フィリップスのフラットスクリーンテレビと2つのリモコン。
客船が停泊している場所の前にいる。	ドアの前の段差に座っている三毛猫.
白とグレーの馬に乗った少女。	小さな女の子が白とグレーの馬に乗っています。
建設現場で資材の横に立つ黒い犬。	建設中の部屋に立つ黒い犬。
リビングルームには青いソファとツインベッド。	リビングルームに置かれた革張りのソファと木製のテーブル。
水中で鳥が羽ばたいている。	水面で羽ばたく黒い白鳥。
干し草の中に立つ白黒の牛が、カメラを振り返っている。	草の上に白と黒の羊が立っています。
毛布の上に横たわる白黒の猫。	猫用ベッドに寝そべる白黒猫。
馬の上に乗る乗馬服の若い女性。	茶色の馬に乗っているのは女性です。
離陸準備中の飛行機	ターマックに積まれる小型ターボプロップ機。
白い革張りのソファに財布と毛布が置いてある。	テレビで番組が放映されている。
四人漕ぎで川を下る．	4人でカヌーを漕いで水上へ
野原に佇むダークブラウンの馬。	緑の草原に褐色の馬......。
木製のキャビネットと家具を備えたキッチン。	木製のテーブルとキャビネットのあるキッチン .
床に置かれた白い自転車。	床に置かれた古いタイプの自転車。
コンクリートスラブの上に座る黒い鳥.	コンクリートの上に立つ黒い鳥.
飛行機の前で話す二人の男．	小型飛行機の前で話す2人の男．
草原に佇む暗い色の犬。	草原にたたずむ灰色の犬。
笑顔で自転車のヘルメットをかぶった金髪の若い女の子。	自転車を背景に、ヘルメットをかぶった少女。
2匹の猫、1匹は茶色、1匹は白で、青い毛布を敷いたベッドの上に横たわっています。	2匹の猫、1匹はジンジャー、もう1匹はベッドの上に横たわっている白。
ネコがホウキを攻撃しているところ。	バスルームのシンクに座っているグレーと白の猫 。
列車は駅に停車します。	駅に停車中の電車。
赤ちゃんを抱くカップル	生まれたばかりの赤ちゃんを連れたカップル.
餌を食べる小鳥	鳥の餌を食べる鳥.
黒い頭を持つ白い羊のクローズアップ。	黒い頭の羊のクローズアップ。
草原に佇む2頭の茶色い馬。	草原の真ん中に立つ茶色の馬。
ソファに寝そべる少年と犬。	ソファに寝そべる少年と犬。
赤い鳥が木にとまっている。	木にとまっている赤とグレーの小さな鳥。
バスが2台、路上に停車している。	路地に停まっていた黄色のスクーター。
カメラを見ている白黒の犬。	カメラを見ているグレー、黒、白の猫。
岩の上に座る2匹の動物．	茶色い電車が線路の上に座っている。
電車が線路の上を走っている。	線路の上の列車。
小さな白い犬とソファに横たわっている少年。	ソファに寝そべる少年と犬。
物置にある大きな銀色の機関車。	赤いストライプの入った銀色の電車のエンジンのクローズアップ。
バスケットボールの写真を背景に、テーブルに座ってお酒を飲んでいる女性。	サリーを着た女性がテーブルで何かを飲んでいる。
線路の上を走る緑の蒸気機関車。	線路の上を走る黒い蒸気機関車。
セミ・トラックの上に赤い小さな車が乗っている。	白いセミトラックの上に赤いスポーツカー。
電車の前で記念撮影をする男性。	銀色の電車の前に立っている男。
黒と赤のレーシングバイクに乗った黒い服の自転車乗りの人。	黒と白のリラで観客の前を疾走するサイクリスト。
キッチンのシンクとカウンター、そして棚に置かれたボウル。	小さなキッチンの棚やカウンターには、様々なアイテムが積み重ねられています。
女性が床に寝そべり、赤ん坊を抱きかかえている。	床に寝そべった男が赤ん坊を抱きかかえている。
フェンス越しに見る黒と白の牛。	カメラを見ている白黒の犬。
本棚がいくつもある雑然とした部屋にテレビがある。	テレビ、ステレオ、本棚のある部屋。
紫色の毛布の上で横向きに寝ている白黒の猫。	日向ぼっこしている白黒の猫。
大きなコンクリートの上を自転車で走る女性。	広いコンクリートの上をマウンテンバイクで走る女性。
広い野原に立つ2頭の牛．	牛は野原で草を食んでいる。
禿げた男が柵の向こうの黒い馬の鼻を触る。	鬚の生えた禿の男が、柵のところで白黒の馬の鼻を撫でている。
黄色いスポーツカーの横に立っている男性。	黄色いコルベットの横に立つ男。
赤いドアの灰色の家。	赤いドアの家
衣料品店の二人の女性．	ヨットに乗る二人の女性．
白い馬に乗った女...	白馬を率いる女...
牛舎にいる牛の白黒写真。	桶の上の牛の白黒写真。
赤いバイクを見つめる老紳士。	赤いバイクを見つめる男。
ソファに座るうつろな女性。	生まれたばかりの赤ちゃんを抱く年配の女性。
二階建てバスとロンドンアイの観覧車（背景） .	茶色い2階建てバスと観覧車。
黄色と黒の鳥が餌を食べる。	水上を飛ぶ鳥の群れ。
ペンで草を食む黒と白の牛たち .	池で水を飲む2頭の白黒牛。
草むらに停まっていた迷彩柄の小さな飛行機。	ピンクのシャツを着た小さな犬が、手すりに縛り付けられている。
電車の前に立っている人。	銀色の電車の前に立っている男。
曇り空の飛行場に停車中の小型飛行機。	曇りの日の空港に停まっていた小さな白い飛行機。
小型飛行機の近くにボートがある。	ボートは水中に、小型飛行機はドックに。
白馬に乗った男が闘技場にいる。	家畜がペンの中に立っている。
床に置かれたマッキントッシュのコンピュータ。	床に置かれたコンピュータ
自転車の後ろに乗っているおばあさん。	ボートは山の前にある水上にあります。
白黒の猫が茶色の椅子に座り、上を見上げています。	緑のゴミ箱の横で、黄色い椅子に座っている犬......。
羊が立っている。	野原にいる羊の横に、大きな犬が立っている。
ろうじんぐみ	ダイニングテーブルを囲んでポーズをとる高齢者のグループ。
ラブシートの白黒写真。	片方の端に財布があるソファの白黒写真。
茶髪の女性3人が微笑んでいる。	インド風のドレスを着た3人の女性が、混雑した部屋の中で微笑んでいる。
誰もいない駅の白黒写真。	ソファに座っている猫の白黒写真。
褐色と白色の牛は、トラフで食事をしています。	褐色と白色の牛が桶で食事をしています。
フェンスに囲まれた犬小屋にいる2匹の犬は、前を向いている。	ボートの船首でポーズを取る男の上に2人の女の子。
コンクリートの上に立つ黒い鳥.	緑の芝生の上に立つ青い鳥.
フェンス越しに見る黒と白の牛。	日向ぼっこしている白黒の猫。
マーケット広場でバイクに乗った数人の人々。	都市部では原付に乗る人が多い。
草むらにいる羊のアップ。	草の上に立って、その耳タグを持つ子羊のクローズアップ。
猫砂の上に仰向けに寝そべる家猫.	黒い防水シートの下で日焼けした家畜の猫.
巨大なキノコの前を通り過ぎる人々の群れ.	巨大なキノコの前を歩く4人組。
2羽の緑の鳥が、木の電柱に向かって飛んでいく。	電線の上を飛ぶ2羽の緑の鳥。
バイクに乗った人	誰もいない駐車場で、ヘルメットをかぶったオートバイの男の横に立つ男。
野原で草を食む3頭の牛 .	二頭の牛が野原で草を食んでいる。
両手を広げた若い女性が、"going places "バスの前に立っています。	その少女はバスの開いたドアの前に立っている。
道路と湖のそばの羊。	湖と山を背景にした道の端に羊がいる。
草原に佇む白黒の牛。	バスの横に立っている男性の白黒写真。
手袋をはめた手にとまる青い鳥。	手袋をはめた手に鳥がとまっている。
ケチャップパックを持つ赤ちゃん。	ケチャップパックを手にしたハイチェアの赤ちゃん。
馬の頭のアップ。	茶色の馬の頭のアップ。
ソファーに座って窓の外を眺める2匹の猫。	二匹の猫がソファの背もたれに座って窓の外を眺めている。
列車は駅に停車中です。	駅に停車中の列車
野原に佇むダークブラウンの馬。	野に立つ馬
ベンチに座っている男性が、歩道に座っている鎖につながれた犬を見ている。	ソファに座った女性が小さな赤ん坊を抱いている。
木の梁の上に寝そべり、カメラを見上げている小さな猫。	セーターを着た小犬がカメラを見上げている。
黒い鳥は地面に座っている。	鳥は枝の上に座っています。
イタリアンレストランのテーブルに座る一団。	六人掛けのテーブルでサラダを食べる。
牛がカメラを覗き込んでいる。	洗面台でカメラを見ている白とグレーの猫。
青いスクーターが歩道に止まっている。	歩道に停まっていた青い原付バイク。
生まれたばかりの赤ちゃんを抱く年配の女性。	ソファに座って赤ちゃんを抱く女性。
木に吊るされた餌台で、茶色の小鳥が食事をしている。	木にとまっている赤とグレーの小さな鳥。
