モール襲撃犯は「less is more」戦略をとった。	ケニアでは、攻撃者は「less is more」戦略を用いていた。
カンボジアの労働者の死を悼み、野党指導者が現れる	カンボジアの野党指導者が法廷に召喚される
低収益が株価を引き下げる	低収益がウォール街の株価を引き下げる
ソロモン諸島沖でM6.8の地震が発生	ソロモン諸島でマグニチュード6.3の地震 : Usgs
上海で液体アンモニアが漏れ、15人が死亡	上海で液体アンモニアが漏れ、少なくとも15人が死亡
フレンズ・オブ・シリア、野党連合をシリア国民の正当な代表と認める	米国、「シリアの友」、野党を唯一の代表と認める
ウィーナー、新たなセクスティング・スキャンダルでもNY市長選にとどまる	ウィーナー、最新のオンラインセックススキャンダルを受け流す
ロシア航空機墜落事故で死者数が増加	イタリアでのバス衝突事故、死者39人に
インドのメディア：英連邦首脳会議	インド首相、英連邦サミットを欠席
イラクで自爆テロ、葬儀を襲撃	シリアで自爆テロ
ハウスシスター」事件で7人が拘束される	中国、「ハウス・シスター」疑惑で7人を拘束
シリア軍警察署長、反体制派に離反	シリア軍警察長官が反体制派に離反
ボーイング787ドリームライナーが炎上、株価は大暴落	787型機の火災でボーイング社の株価が暴落
イヴェット・クーパー、同性婚法案を支持	ホワイトハウスが同性婚を支持
ベルギーのバス事故で5人死亡	ベルギーのバス事故、5人のうち10代が死亡
ナイジェリアの武装集団が外国人労働者7人を誘拐	ナイジェリアで外国人労働者7人が誘拐される
スイス人観光客がインドで集団レイプされる。	スイス人観光客がインドで集団強姦されたと警察が発表
パレスチナ人、西岸とエルサレムでイスラエル軍と衝突	パレスチナ人、西岸で治安部隊と衝突
イスラエル軍機がシリア国内を空爆	イスラエルがシリアに空爆を開始
イラン人による大統領選の投票	マリ大統領選挙でケイタが勝利
ダルフールの新たな部族間衝突で100人死亡	ダルフールの部族間衝突で9人死亡
パリの無人爆撃機に対する抗議が延期されました。	パキスタン北部で米軍の無人機攻撃により6人が死亡
パキスタンでバス事故、12人死亡	パキスタン北部で交通事故、10人が死亡
カーニー、BOEに高いハードルを課す	カーニー、イングランド銀行の改革に高いハードルを設定
バングラデシュのビル倒壊、8人を逮捕	バングラデシュの建物の犠牲者が352人になり、4人が逮捕された。
アフガニスタンの米軍基地で自爆テロ、3人死亡	アフガニスタンの米軍基地を自爆テロが襲った。
アフガニスタンの人々は、タリバンが迫っているにもかかわらず、大学に殺到している。	アフガン州知事がタリバンに離反
北朝鮮、南側との家族再会を延期	北朝鮮、南朝鮮と家族ぐるみの付き合いを延期
アップルの収益が再び減少、iPhoneは期待外れ	米国通商機関がサムスンを支持、iPhone 4の輸入禁止を決定
パキスタン北部で武装集団が外国人観光客10人を殺害	パキスタンで武装集団が外国人登山者11人を殺害
デビッド・ベッカムがサッカーからの引退を発表。	デビッド・ベッカムがサッカー界から引退する。
マット・スミス、『ドクター・フー』を4年で降板へ	マット・スミス、BBCの「ドクター・フー」を降板
同性婚をめぐる世代間対立	G20サミット、シリアをめぐり分裂したまま終了
イラクの自動車爆弾テロで23人死亡	イラクの爆弾テロで10人死亡
ナショナル・モールで放火した男が負傷して死亡。	ナショナル・モールで焼身自殺した男が死亡
タリバンの攻撃でアフガニスタンの民間人17人が死亡	アフガニスタンで連続攻撃、警官10人が死亡
中国人民元、月曜日には対米ドルで6.168元まで上昇	木曜日、中国人民元は対米ドルで6.1696元まで上昇
エジプト大臣、暗殺未遂から生還	シリア首相、暗殺未遂から生還
テキサス州の住民は、爆発事故の後、教会で癒しを求めています。	テキサス州の爆心地に住民が戻る
総理大臣に安倍晋三が選ばれました。	安倍晋三は日本の総理大臣である。
バーバラ・ブッシュ元大統領夫人がテキサス州の病院を去る	バーバラ・ブッシュ元大統領夫人が退院
ジャマート指導者の処刑をめぐるバングラデシュの衝突で2人死亡	バングラデシュのイスラム教指導者が処刑された。
シューマッハ、スキー事故でこん睡状態	ミハエル・シューマッハ、スキー事故でまだ昏睡状態、命がけで闘う
中国の警察署襲撃で11人死亡	中国の警察署襲撃で11人死亡
マリ、大統領選の投票が行われる	マリ、大統領選の決選投票の集計を開始
ブラッドリー・クーパーとJJ・エイブラムス、ランス・アームストロングの伝記映画撮影について協議中	ブラッドリー・クーパー、ランス・アームストロング役で伝記映画出演交渉中
ロシアでボーイング旅客機が墜落、50人死亡	ロシアのカザンでボーイング旅客機が墜落、50人死亡
EU閣僚、馬肉スキャンダル解決に向け決意表明	EU閣僚、馬肉スキャンダルで危機管理協議
ブルームバーグの後任としてデブラシオがニューヨーク市長に就任。	マイケル・ブルームバーグの後任として、ビル・デ・ブラシオがニューヨーク市長に就任。
タイ野党、総選挙ボイコットへ	タイ野党が選挙ボイコットを表明
バングラデシュの建物崩壊、死者540人に : 陸軍	バングラデシュの建物崩壊による死者数が1,000人を超える
プッシー・ライオットのメンバー、アリョーヒナがロシアで釈放された。	プッシー・ライオットのメンバー、マリア・アリョーヒナが刑務所から解放された。
ジャガン・レディが病院に移され、スィーマンドラ州では電力危機が続いている。	テランガナ州：ジャガンは木曜日を病院で過ごすことになり、スィマンドラ州では停電が続いている。
アシアナ機、サンフランシスコ空港に不時着	サンフランシスコ空港に飛行機が不時着
中央アフリカ共和国大統領、反乱軍に倒される	中央アフリカ共和国大統領、首相が退任
ブラジルがイングランドに2-2で引き分け、マラカナが再開される。	ブラジルがイングランドに2-2で敗れる。
中国、米投資協議再開へ	中国と台湾が歴史的な会談を行う
カリフォルニアの山火事：1,900人の消防士が被害を最小限に食い止めようと努力している（＋ビデオ）	カリフォルニアの山火事は拡大しているが、当局によると、消防隊は前進している。
ジョージ・W・ブッシュ、移民問題での激しい論争に警告	ジョージ・W・ブッシュ、移民に関する議論に参加
マンデラ氏が入院、治療に反応	マンデラ氏、喋れなくなり入院
ロシア、北朝鮮の核実験を非難	韓国、北朝鮮が3回目の核実験を行ったことを確認
バングラデシュの衣料品工場で働く数百人の労働者が病気に。	バングラデシュの工場で数百人が体調を崩す
イエメン自爆テロ、兵士を殺害	ロシア駅で女性自爆テロ、16人死亡
ロシアの炭鉱爆発で18人死亡	ロシアで炭鉱爆発、10人死亡
デモ隊が軍司令部に乱入	タイデモ隊が軍本部を襲撃
イスラエルがシリアに空爆	イスラエル、シリアに新たな空爆を開始
チュニジアで警察がデモ隊を解散させるために催涙ガスを発射。	カイロで警察がデモ隊に催涙ガスを発射
ブリザードが米国北東部を襲い、5人が死亡、70万人が停電。	ブリザードがアメリカ北東部を襲い、道路が閉鎖される。
エジプト、主要野党が大統領の対話要請を拒否	エジプト野党、モルシ氏との対話要請への対応を検討
2020年オリンピック開催地は東京に決定	レスリング、2020年東京五輪で採用へ
中国での地震で「約100人が死傷」。	中国での地震で数百人が死傷
5月の住宅着工件数は6.8％増	5月の住宅着工件数は6.8％増
フランス人ジャーナリスト2名がマリで殺害される	フランス人ジャーナリスト2人がマリで殺害される
キューバのカストロ氏、セラク大統領に就任	キューバのカストロ、セラック大統領を引き継ぐ
トンネルで車両炎上	トンネルから煙が上がり、燃えさかる車たち
ニュージーランドでマグニチュード6.9の地震が発生	イランでマグニチュード5.6の地震が発生
インドのビル倒壊で数十人が閉じ込められている恐れがある。	インドのビル崩壊で、救助隊はまだ20人閉じ込められているのを探すために競争している。
ネルソン・マンデラ氏が病院に搬送される	ネルソン・マンデラ氏が病院を退院
デイリープレスブリーフィング：南スーダン	デイリープレスブリーフィング：シリア
イスラム教徒がマリ北部の都市を自爆テロで攻撃	イスラム教徒がガオでマリアン軍を襲撃
歴史的な投票のためにバチカンに入る枢機卿たち	システィーナ礼拝堂に入る枢機卿たち、教皇選出のために
英国、アブ・カイタダの国外退去を決定	イギリス、過激派聖職者アブ・カイタダの国外退去を求める裁判に敗れる
フランス議会、売春に関する法律の改正を支持	ロシア議会、米国の養子縁組禁止を検討へ
タイ人がバンコクで抗議活動を続ける中、銃声と爆発音が聞こえた。	投票日前の抗議行動で銃声と爆発が発生。
イスラエル軍、北方国境に集中	エジプト軍、ムスリム同胞団とその支持者を制圧
北朝鮮が開城へのアクセスを遮断	北朝鮮、核施設の再稼働を明言
auの首脳がアフリカ・デーに集結	エジプトの青年指導者が4日間拘留された
4月23日、歴史の中の今日	1月21日、歴史上の今日。
マニングに禁固35年の判決	アリエル・カストロに1000年の禁固刑判決
米上院、財政の崖に関する法案を承認	公式発表：「財政の崖」で合意に達した。
テキサス州でスピード違反で止められたZimmermanは、警告で釈放された。	ジマーマンがテキサス州でスピード違反で車を止められ、警告を受けた。
イランのルハニ氏、シリアのタリバン化を警告	ロシア、中国、イスラエルによるシリア空爆に懸念
シリア、ダマスカスで神経ガス攻撃との報道を否定	イランからのコンピューター攻撃を撃退するために、米国の同盟国が支援を受ける。
中国株、経済会議を終えて上昇	中国株、水曜は高値引け
ロシア、300億ドルの太平洋への石油輸送網を発表	ロシア、250億ドルの太平洋への石油輸送網を発表
コロラド州の住宅で、警察が犯人を殺害、さらに3人が死亡しているのが見つかる。	米国で銃を持った犯人と警察がにらみ合い、4人が死亡。
ドルチェ＆ガッバーナ、脱税で有罪判決	ドルチェ＆ガッバーナ、イタリアの税務訴訟で罰金を科される
パキスタンでマグニチュード7.2の地震が発生 : CENC	パキスタンでマグニチュード7.7の地震が発生
シリアの化学兵器に関するUKの警告	西側は、シリアの化学物質に関する主張をめぐって、利害関係を強化する。
中国株、金曜は安値引け	中国株、水曜は高値引け
小惑星は地球と衛星の間を飛び交う	小惑星が地球を通過するフライバイ
マリ・タウン争奪戦はイスラム教の戦術を反映している	EU、北部のイスラム過激派に対抗するためマリ軍を訓練
2つのサンタトラッカーがクリスマスに競演	スペインはシエスタの時間を戻している
シリアの化学兵器輸送のための船舶訓練	シリアが化学兵器を爆弾に搭載し、アサド大統領の命令を待っている。
テキサス州肥料工場爆発、14人死亡と市長発表	テキサス州肥料工場爆発事故の生存者を救助隊が捜索中
イラクの攻撃で2人が死亡、11人が負傷。	イラクで新たな攻撃があり、15人が死亡、90人が負傷した。
米国はシリアが化学兵器を引き渡せると信じていいのか？	米国、シリアが化学兵器でサリンを使用した可能性を指摘
メキシコ人歌手、ジェニ・リベラが飛行機事故で死亡したとみられる。	Jenni Rivera、メキシコの音楽スター、飛行機事故で死亡
バングラデシュ裁判所、戦争犯罪の罪で初の死刑判決を下す	英国首相、スリランカに戦争犯罪を押し付ける
ムガベ氏、選挙戦の勝者となる	ジンバブエ：ムガベ氏、争われた投票で当選を宣言
インドネシア船沈没事故、死者15人に上る	インドネシア : インドネシアのボート転覆事故、死者11人に
エジプト裁判所、ムスリムブラザーフッドを禁止に	エジプト裁判所、ムスリム兄弟団の「活動」を禁止
イラン大統領選の投票結果、ルハニ氏がリード - 予備的結果	イランの初期集計ではルハニがリード
イスラエルとパレスチナ、囚人交換をめぐって会談	イスラエル議員団、囚人Xの事件に関する内部調査を要求
ベルファストでの国旗抗議デモで警察が襲撃される	政治家が旗色悪く会談
CBN、ポリマーノートを段階的に廃止する計画を改めて表明	ナイジェリア、ポリマーナイラ紙幣を変更する計画を発表
韓国、開城問題で北朝鮮に「最終会談」を提案	北朝鮮、米国とのハイレベル協議を提案
外国人観光客9人、パキスタン人1人が殺害される。	パキスタンで武装集団が外国人観光客11人を殺害
イラクにおける一連の攻撃に関するキャサリン・アシュトン上級代表の報道官による声明	イラクにおける死刑執行の再開に関するキャサリン・アシュトンEU上級代表の報道官の声明
エジプト、モルシ派抗議デモを前に警備を強化	エジプト、大規模な抗議行動に備える
ヤシモビッチ、パレスチナ人囚人の解放を承認するよう内閣に要請	イスラエル、パレスチナ人囚人104人の解放に合意
米国、NSAリーク者を再びスパイ容疑で告発	米国、スノーデン氏の情報漏洩をスパイ容疑で告発
パレスチナ人、西岸に新たなテントを建設	パレスチナ人による初の国連投票は象徴的かつ歴史的なものだった
バングラデシュの建物崩壊による死者数が362人に達する	バングラデシュのビル倒壊、死者580人に
イスラエル特使、入植計画で召集	英国、入植地問題でイスラエル特使を召喚
中国の将軍の息子はレイプで10年の刑を受ける	中国の将軍の息子は集団強姦で10年の懲役を受ける
ネバダ州の中学校で銃乱射事件が発生、2人死亡、2人負傷	ネバダ州：中学校で銃乱射事件、2人死亡、2人負傷
パキスタン西部を震源とする地震が発生。	パキスタン南部で中規模の地震が発生
ハマス男女共学禁止令が発効	ハマスが男女共学禁止に
バングラデシュの抗議デモで32人が死亡	バングラデシュの抗議デモで1人死亡
リーズで警察官が撃たれ、男が逮捕される	海軍調査委員会、死を偽装した将校の更迭を要請
ウクライナ首相、抗議デモで辞任	トルコ首相、デモ隊への強硬姿勢に回帰の兆し
オバマ大統領、一般教書演説で経済に再び焦点を当てる	ファクトボックス : オバマ大統領の一般教書演説の注目点
グーグル、インターネット接続用気球を打ち上げ	グーグル「国際的なタックスゲームをやっている
イラク、モルシ支持者へのエジプト弾圧を支持	イラク、エジプトでのモルシ支持者弾圧を支持
ロシア、アメリカの養子縁組禁止に一応のOKを出す	ロシア、養子縁組禁止を一次承認
コソボ臓器売買事件で5人に有罪判決	コソボ：臓器売買事件で3人に実刑判決
リティク・ローシャン、妻のスザンヌと別れる	リティク・ローシャン、スザンヌと離婚へ
フロリダのアパートで銃乱射、7人死亡のうち犯人は？	フロリダ州のアパートで銃撃戦があり、7人の死者の中にガンマンが含まれている。
オバマ大統領、就任演説で同性愛者の権利に関する進展を称賛	フランスで同性婚に数千人が抗議
イラクで爆弾テロが相次ぎ、15人が死亡	イラクで自動車爆弾、少なくとも49人が死亡
オバマ大統領は、シリアへの攻撃を保留にする衝撃的な行動をとった。	オバマ大統領、シリア攻撃を保留
イスラエルがシリアを攻撃、武器に関する緊張が高まる	シリア・デラアでの空爆で市民が負傷
パキスタン北西部で武装集団が9人を殺害	パキスタン北西部で武装勢力、兵士6人を殺害
サンフランシスコ航空機事故概要	サンフランシスコ航空機事故、2人死亡、181人負傷
バングラデシュのビル倒壊、8人を逮捕	バングラデシュのビル崩壊で労働者が抗議行動
ノロウイルスに襲われたX'masクルーズ客	行方不明のクルーズ客はNswの救急隊員
ダイアナ妃とドディ・フェイドの死に関して、警察に寄せられた新たな情報に、二人が殺害されたという主張が含まれているようです。	ダイアナ妃とドディ・アル・ファイドの死について、警察が新たな情報を入手し、再捜査している。
スノーデン氏、ロシアでの滞在を要請	スノーデン、初のロシア・ビデオを公開
中国株、水曜は安値引け	中国株、金曜日は高値引け
ナダル、胃の不調で全豪オープン欠場へ	ラファ・ナダル、全豪オープン欠場へ
ナレンドラ・モディ、パキスタンに厳しい対応を約束	インドのモディ大統領、パキスタンに厳しい姿勢を約束
タイ警察、デモ隊に催涙ガスを使用	ブラジル指導者、抗議行動について沈黙を破る
カリフォルニアの男、少女誘拐事件で無罪を主張	カリフォルニア州の男性、テロ事件で無罪を主張
エジプト裁判所、ムバラクの釈放を検討	エジプト裁判所、ムバラク氏の釈放を命令
ボーイスカウト、同性愛者の入所について決定を延期	ボーイスカウトアメリカ、同性愛者禁止令の解除に関する投票を延期
イラク南部で自動車爆弾2発、8人死亡	イラク北部で自動車爆弾テロ、14人が死亡
バンデルスロット、刑務所の中で結婚する	ジョラン・ヴァン・デル・スロッツ、ペルーの刑務所で結婚を計画
東京株式、0.26％安で終了	東京株、1.53％下落で終了
中国株価指数先物の終値が上昇 -- 12月4日	中国株価指数先物、安値引け -- 1月24日
今日の一枚：2013年8月7日	今日の写真：2013年4月11日
パレスチナ人、ガザでイスラエル軍の銃撃を受ける	イスラエル軍のガザ空爆でパレスチナ人2人が死亡
レッサーパンダ、国立動物園から姿を消す	行方不明になっていたレッサーパンダが国立動物園に無事戻りました。
ジェシー・ジャクソン・Jr.と妻、詐欺で有罪を認める	ジェシー・ジャクソンJr.と妻、詐欺で有罪を認める
米国、ベネズエラの外交官を追放	米国、ベネズエラの外交官を追放
bbcのベテラン・ホール、児童への性的虐待を認める	スチュアート・ホール、子供への性的暴行を認める
中国南部で交通事故、7人が死亡、3人が負傷	フィリピンの交通事故、20人死亡・44人負傷
ライアンエアー、過去最高益を記録するも、今年の成長率は鈍化するとの警告を発表	Stansted : ライアンエアー、年間利益が13％増加するも、今年の成長鈍化を警告
JFK没後50周年記念式典の開催について	JFK没後50周年、ダラスで初の追悼式典を開催
台湾でマグニチュード6.3の地震が発生	パキスタンでマグニチュード7.7の地震が発生
ボストンマラソンのニュースについて子供たちが話すのに役立つ本	ボストン・マラソンのゴール地点で2つの爆発があったとの報告。
ハイテクセクターが活況：グーグル、IBMが好調な決算を発表	グーグル、好決算で1000ドル超の高騰
オランダのベアトリクス女王、息子のために退位へ	オランダのベアトリクス女王が息子に譲位
トンネル崩落で運転手死亡	東京で起きたトンネル崩落事故による車の閉じ込め
ケニア大統領候補のプロフィール	イタリア人ジャーナリスト、大統領候補に選ばれる
イスラエル、パレスチナの囚人を解放	政府委員会、パレスチナ人囚人26人の釈放を承認
フィラデルフィアのビルが崩壊、8-10人が閉じ込められる可能性。	フィラデルフィアのビルが崩壊し、人々が閉じ込められたと報告された。
オバマ大統領、マンデラ一家と会談	オバマ大統領、ズマ大統領と会談し、マンデラ大統領に敬意を表す
米国上院、銃規制の議論を開始	米上院、銃規制法案の採決へ
水曜日の中国株は安くなる	フランスで中国人留学生が襲撃される
ダマスカスで自動車爆弾テロ、53人が死亡	イラクの首都で自動車爆弾テロ、13人の市民が死亡
シリアの友人」、反体制派への武器提供でドーハ会談	シリア会談、反体制派への軍事支援に合意
エジプトの指導者が3都市で非常事態を発令	エジプト大統領、3都市に非常事態を宣言
abvpのデモ隊がジャンタル・マンタルで警察と衝突、石を投げる。	ジャンタル・マンタルでデモ隊が警察と衝突、5人が拘束される
トルコ首相、イスタンブールでの抗議デモの終結を要請	トルコ警察、イスタンブールのデモ隊に催涙弾を発射
赤ブドウとブルーベリーが免疫系を高めると科学者が発表	赤ブドウ、ブルーベリーは人間の免疫力を高める
二人組、テロ行為で起訴	サウジアラビア生まれのナイジェリア人がニューヨークでテロ容疑で起訴されました。
EUがノーベル平和賞を受賞	EU、2012年ノーベル平和賞を受賞
サン・フェルミン牛追い祭り、バスクの旗に阻まれ開始が一時遅れる	サンフェルミン牛追い祭り開幕
カブールの自爆攻撃で、最大21人（ほとんどが外国人）が死亡。	カブールでの自爆攻撃で英国人が死亡
アイバイン殺人事件で元警察官を捜索中	元CIA職員、情報漏洩で禁固30カ月の判決
東京株式、0.88％安で終了	シンガポール株、0.44％安で終了
パキスタン裁判所、「冒涜的な」暴挙に答えを要求	パキスタンと国連の報告書、薬物使用の驚くべきレベルを明らかにする
インテルのMcafeeが、クラウド型ネットワーク・ファイアウォールの専門企業Stonesoftを現金3億8900万ドルで買収。	Mcafee、ファイアウォール ストーンズソフトを3億8900万ドルで買収
米国でマグニチュード4.1の地震が発生	フィリピンでマグニチュード7.2の地震が発生
バングラデシュの野党指導者に戦争犯罪の罪で死刑判決	バングラデシュ：逃亡者に戦争犯罪法廷から死刑判決
警官殺しの容疑者は頭を撃たれて死亡した	警官殺しの容疑者が銃で死亡
アフガニスタン東部で爆発、警察官2人死亡	中国の炭鉱で爆発、少なくとも28人死亡
リビアのベンガジにあるスウェーデン領事館に自動車爆弾、死傷者なし	ベンガジのスウェーデン領事館に自動車爆弾が直撃、けが人なし
ムシャラフ、ラル・マスジッド事件で逮捕	ムシャラフ、パキスタンで逮捕
イランは核協議で「ロードマップ」が得られることを期待している	ジュネーブでのイラン核協議に大きな期待
アフガニスタンの空爆で35人の武装勢力が死亡：政府関係者	アフガニスタンの空爆で12人の武装勢力が殺害される : 財務省
北朝鮮が短距離ミサイルの試射を行ったと報道された。	北朝鮮が短距離ミサイルを発射
タイのデモ隊が投票を妨害、暴力行為で1人死亡	タイのデモ隊がバンコクの投票所を封鎖
ベネズエラのチャベス大統領、癌で死去	チャベス： ベネズエラ政府高官、結束を図る
北朝鮮、3回目の実験で核保有国に近づく	NATO、北朝鮮の核実験は世界平和への重大な脅威と指摘
北朝鮮が3回目の核実験を実施	北朝鮮が3回目の核実験を確認
インド株は横ばいで始まる	インド株は安く始まる
マカオのギャンブル収入、2012年に過去最高の380億ドルを記録	マカオのギャンブル収入、2012年に過去最高の380億米ドルを記録
イスラエルとパレスチナ、米国で協議を再開	イスラエルとパレスチナが協議を開始
ザ・ノート 2013年11月25日（月）の必読記事	ザ・ノート 2013年10月8日（火）の必読記事
ネルソン・マンデラ追悼式	ネルソン・マンデラ氏死去 : ライブ中継
NMカウンティ、同性婚の審理に備える	同性婚に道を開く郡当局者もいる
レバノンの企業が政治の行き詰まりに抗議してストライキを実施	チュニジア大統領、政治危機を乗り越えられると確信
米空軍のヘリコプター乗組員4人が英国で墜落、死亡	英空軍ヘリ乗組員、墜落で死亡
2020年オリンピック開催地は東京に決定	2020年オリンピック開催地、東京が決定
マレーシア、空港で豪州の上院議員を拘束	マレーシア、空港で豪州議員を拘束
インド警察、ムンバイのレイプ事件の容疑者5人全員を逮捕	ムンバイ警察が集団強姦事件で5人目の容疑者を逮捕
サッチャー葬儀の警備が強化される	ケニアにおける新たなテロの脅威について、治安当局が懸念している。
南朝鮮、北がミサイルを発射したと発表	北朝鮮が短距離ミサイルを発射
馬肉スキャンダルがフランスに飛び火し、英国が工場を閉鎖。	EU閣僚、馬肉スキャンダル解決に向け決意表明
米、化学兵器でシリアに警告	シリアの化学兵器について、米国の懸念が高まっている。
イタリアでバス事故、37人が死亡	パキスタンでバス事故、12人死亡
アメリカ、グレートバリアリーフに爆弾を投下	米軍、オーストラリアのグレートバリアリーフに爆弾を投棄
アフガニスタンでタリバンの武装勢力38人が殺害された。	タリバン、アフガニスタンの米軍基地を攻撃
中国人民元、対米ドルで6.2689元まで上昇	中国人民元が対米ドルで6.2816まで弱くなる
米国がシリアの野党を承認	ロシア、シリアの野党を会談に招待
グーグル、テキサス州の風力発電所に2億ドルを投資	グーグル、テキサス州の風力発電プロジェクトに2億USドルを投資
エジプト、新憲法を採決	エジプト人による新憲法への投票
プレストンとイングランドの伝説的人物、トム・フィニー氏が91歳で死去	元イングランドの名選手、トム・フィニー氏が91歳で死去
中国、経済の罠を回避するために努力する	保険は経済成長を促進する鍵である
ベンガジで自動車爆弾、1人が死亡、5人が負傷	リビアのベンガジ外務省に自動車爆弾が直撃
アフガニスタンで路側爆弾、5人死亡	アフガニスタンで路側爆弾、警官3人が死亡
スリランカのタミール人、自治権拡大へ投票	キャメロンとプーチンのためのシリア会談
フランス軍、ティンブクトゥに迫る	フランス軍によるティンブクトゥへのアクセス制御
NATOの空爆でアフガンの子供2人が死亡	アフガニスタンでNATO軍兵士が死亡
パキスタンで武装集団が外国人観光客11人を殺害	パキスタンで武装集団が外国人登山者11人を殺害
韓国、共同工業団地の工事を中止へ	北朝鮮が共同工業団地への立ち入りを禁止
デリー・ギャング・レイプ容疑者「殴られ、毒を盛られた」。	デリー強姦事件の判決が再び延期に
ドンバレー・スタジアムの解体工事が始まる	スタジアムで解体作業開始
フランス、マリに軍事支援を約束	フランス人の大半がマリでの軍事作戦を支持している。
2013年最強の台風がフィリピンを直撃	フィリピンを直撃した台風24号（UTOR）で23人が行方不明
エジプト人による分裂憲法に関する投票	エジプト人による憲法改正の投票
リード、債務上限交渉で「多大な進展」を指摘	上院指導者は、米国の債務上限に関する協定に近づいているようだ。
エジプト・デモの拡大を求める声	エジプト・デモの死者数が49人に
サランガニでマグニチュード6.2の地震が発生	中国南部を震源とするマグニチュード4.3の地震が発生
ロサンゼルスの自動車事故で1人死亡、11人負傷	コタバトの爆発で6人死亡、33人負傷
イージージェット会長、退任へ	イージージェット会長、退任へ
オバマ大統領、大型予算案で社会保障制度の削減を改めて提案 : Aide	日本、米国に予算の遅れを早急に処理するよう要請
アフガニスタンの州議会で自爆テロ、14人死亡	アフガニスタンで自爆テロ、11人死亡
米国、アルカイダ指導者の捕獲を確認	米、アルカイダ指導者を捕捉するも、ソマリア攻撃は失敗
委員会は、最終的な大きな移民に関する決定を間近に控えている。	上院司法委員会、移民法案の策定で最後の大きな決断を迫られる
アフガンのインサイダー攻撃で米軍兵士が死亡	アフガニスタンの「インサイダー攻撃」でNATO軍兵士が殺害された。
犬が娘を殺した母親を過失致死の疑いで逮捕	サフォークで刺殺された男が殺人の疑いで逮捕される。
ロンドン・マラソン、ボストン爆弾犠牲者への黙祷を捧げる	ロンドン・マラソン、ボストン犠牲者に黙祷を捧げる
メッシ、バルセロナで通算300ゴール目、301ゴール目を記録	football : メッシ、逆転勝利でバルセロナ通算300ゴール目を達成。
カナダで列車事故、5人死亡・40人行方不明	カナダの列車事故、40人が依然行方不明
チュニジアの野党政治家が銃殺された	チュニジアの野党指導者が殺害され、抗議デモが勃発。
ウクライナのアザロフ首相と政府全体が辞任した。	ウクライナ政府関係者のカナダ出入国を禁止、抗議デモが継続中
国連、シリア支援の大幅強化の必要性を訴える	国連総長、シリア支援の大幅増額を迫る
ウォールストップのリードで株が急騰	ウォール街の株安
ジョージ・ジマーマン、トレイボン・マーティン殺害で無罪判決	ジマーマンがトレイボン・マーティン殺害事件の無罪判決を受け、抗議と冷静さを訴える。
内部告発者エドワード・スノーデン、モスクワに飛ぶ	NSAの内部告発者エドワード・スノーデンが香港を出発し、モスクワへ向かう。
イラク北部の爆弾テロで17人が死亡、133人が負傷。	レバノン北部で衝突があり、2人が死亡、6人が負傷した。
インサイダーが明かす2012年選挙の秘密	ベネズエラの選挙でカプリレスに注目が集まる
看護婦の死に対する王室の悲しみ	看護師の死に涙するラジオ・プランクスター
韓国、ロケット発射を延期すると発表	北朝鮮、問題のロケット発射を延期する模様
アフガニスタンで2人のNATO軍兵士が殺害された。	アフガンの攻撃でNATO軍兵士が死亡
米政府、「閉鎖の危機」。	オバマ大統領、共和党のシャットダウン緩和提案を拒否
クリティカルゲイツの回顧録がオバマ政権を揺るがす	ゲイツブラスト、オバマ政権を揺るがす
ジェフ・ベゾス、ワシントン・ポストの再建に2億5000万ドルを賭ける	ジェフ・ベゾス、ワシントン・ポストに2億5000万ドルを支払う
ブルックス、ハッキング容疑に無罪を主張	ブルックス、電話ハッキングの審理で無罪を主張
粛清は北朝鮮のエリートに冷ややかなメッセージを送る	キム叔父の粛清は、北朝鮮のエリートに冷ややかなメッセージを送る
南アフリカ、マンデラ氏の95歳の誕生日を祝う	南アフリカ共和国のネルソン・マンデラ元首相、病院に戻る
オバマ大統領、医療保険法は機能していると宣言	オバマ大統領、新医療法の有効活用を約束
大雨のため、クリスマスに洪水の恐れがあります。	新型の雨がさらなる洪水をもたらす
同性婚に抗議する数千人の人々	パリで数千人が同性婚に抗議
台湾の暴力団幹部が17年ぶりに空港で摘発される	ザンビア、石油取引でバンダ元首相を逮捕
ザ・ノート 2013年12月6日（金）の必読記事	ザ・ノート 2013年7月12日(金)の必読記事
イラン核協議、進展に期待しつつ開始	イラン核協議、ジュネーブで開始
タイの政治的抗議により、さらに多くの省庁が麻痺している。	タイのデモ隊、さらに多くの省庁を包囲
アマゾンのベゾス、2億5000万ドルでワシントン・ポストを買収	アマゾンのベゾス氏、2億5000万ドルでワシントン・ポストを買収
オバマ大統領の経済視察は、期待薄の中で行われた。	オバマ大統領、ボーイスカウトに同性愛者禁止令を廃止するよう奨励
イスラエル、空爆後のヒズボラ拒否を誓う	ヒズボラ・ベイルートの拠点で自動車爆弾、4人死亡 : 大臣
フランス、シリアに関する米ロの合意を歓迎	アラブ連盟、シリアに関する米ロの合意を歓迎
中央アフリカ共和国にフランス兵を増員	アフリカの首都で銃撃戦があり、新たなパニックが発生している。
国連決議、シリアの化学兵器廃棄を命令	ドイツはシリアの化学物質ミッションに協力する用意がある
独占最新情報 2 エジプトのプロムルシ同盟、交渉に柔軟性を示す	独占最新情報 1 エジプトのプロムルシ同盟、交渉に柔軟性を示す
デビッド・ベッカム、今季限りで引退へ	デビッド・ベッカムがサッカー界から引退する。
ヘリコプターがスコットランドのパブに墜落し、死者が確認された。	スコットランド警察、ヘリコプターがパブに墜落し、少なくとも1人死亡と発表。
リビア、4カ国との国境を突然閉鎖	リビアが国境を閉鎖、南部で戒厳令を発令
ギリシャでマグニチュード6.0の地震が発生 -- USGS	日本でマグニチュード5.0の地震が発生
武装集団がパキスタンで脱獄を行う	タリバン脱獄：パキスタンの刑務所を攻撃した250人の武装集団が逃亡。
ロシア中央部に隕石が落下、500人以上が負傷	ロシア中部に隕石が落下、400人が負傷
北朝鮮の核実験が心配される	北韓核実験
吹雪で北東がやむ	ブリザードがアメリカ北東部を襲い、道路が閉鎖される。
NATOのデモ隊にテロ容疑の無罪判決	NATOデモ隊にテロ以外の罪で有罪判決
シリアをめぐって信頼性が損なわれる」。	オバマ大統領：議会、世界の信頼を得るために
タリバンがパキスタンで我々の課題となる	パキスタンで大地震が発生、少なくとも33人が死亡
シリア北部の戦闘で123人が死亡	シリアの空爆で多数の死者
エジプト内相、爆弾から生還	エジプト内相、爆弾テロから生還
中国人民元、対米ドルで6.2767元まで下落	火曜日、中国人民元は対米ドルで6.1818まで弱くなる。
オバマ大統領、シリア行動に関する会談を開催	キャメロン、シリア軍事行動に関する議会投票に敗れる
エジプト「ムスリム兄弟団の資産を凍結」。	エジプト、ムスリム兄弟団の資金を凍結
禅のレポート：ハイメンテナンスは簡単ではない	ロシアの隕石がビルに穴をあける
プーチン大統領の安全保障上の制約が権利侵害にあたるという批判	プーチン大統領、ソチの安全保障に関する法令を発表 批判の声も
トニー・アボット、オーストラリア新首相に就任	トニー・アボット、豪州首相に就任
エジプト軍、同胞団を取り締まる	エジプト軍、ムスリム同胞団を取り締まる
ベネズエラ、チャベス大統領の健康危機で議会開催	チャベス危機の中、議会が開かれる
エジプト、さらなる抗議デモに備え、平静を祈る	エジプト、モルシ大統領への抗議デモに備え、静穏を祈る
シリア反体制派が会談を辞めると脅す	シリア反体制派、協議に合意
エジプトでモルシ支持者が抗議行動	モルシ支持派、エジプト政府の脅威に反撃
パキスタンで自爆テロ、警察官を殺害	パキスタンで自爆テロ、兵士3人が死亡
反政府デモ隊がキエフの街を襲う	ウクライナのデモ隊がレーニン像を倒した。
シカゴの男性、テロ事件の有罪判決を受ける	カブール銀行トップ、汚職で実刑判決
米無人機攻撃、パキスタン北西部で3人を殺害	米無人機攻撃、北ワジリスターンで7人死亡
ラッフルズプレイス、マリーナベイ間で線路故障のため運転見合わせ。	ラッフルズプレイス-マリーナベイ間で列車の運行に支障が発生しています。
かぶがあがる	米株は乱高下して緩和
マニング、政府機密漏洩で35年の判決	偽爆弾探知機の販売で英国人に10年の禁固刑
英国警察、ヘリ墜落にテロとの関連はないと発表	中国警察、衝突事故で8人の容疑者を捜索
ロシア南部で自爆テロ、13人死亡	ロシア、ボルゴグラードで自爆テロ、16人死亡
イラクの暴力的攻撃で41人が死亡、22人が負傷。	イラクで新たな攻撃があり、15人が死亡、90人が負傷した。
バングラデシュの建物崩壊、死者540人に : 陸軍	バングラデシュのビル倒壊、犠牲者600人超に
ケリー、ヨルダンを訪問、イスラエル・パレスチナの和平を議題とする	ケリー、イスラエル訪問を1週間延期
ユーロ圏の雇用者数が過去最高を更新	EUの雇用者数が過去最高を更新
7期目の就任が決まった反骨のムガベ氏、「卑劣な」西側諸国を非難	ムガベが再任される
ネルソン・マンデラの真の英雄はガンジーではなく、ネールだった。	ネルソン・マンデラ氏の健康状態が「不安定」な件
救済税に直面するキプロス人は、銀行から現金を引き出そうとする。	救済条件により、キプロスの銀行が経営破綻。
オバマ大統領、オバマケアにサインアップ	アメリカ人は期限までにオバマケアに加入するために奔走している。
ランス・アームストロング、オプラにすべてを告白	ランス・アームストロング、オプラのインタビューでドーピングを告白
アンディ・マレイは爵位に値する、デイヴィッド・キャメロンが語る	デイヴィッド・キャメロン : アンディ・マレーは爵位を受けるに値する
HUSHEN300インデックス、高値で終了 -- 10月14日	HUSHEN300インデックス、安値で終了 -- 3月12日
ベンガジ事件で米国務省が非難される	ベンガジ事件後、国務省の警備主任が辞職
サッカー・フランス、10月に初のオーストラリア戦開催	NRA幹部、問題発言後初めて質問に立つ。
在コロンビア・ホンジュラス大使、乱痴気騒ぎで解任される	ホンジュラス大使、大使館での乱交疑惑で辞職
シリアは化学兵器を廃棄せよ	リビア、最後の化学兵器を破壊
ちちゅうかいぶどう	イラン：大統領選で穏健派候補が勝利
アフガニスタン人3名が自爆攻撃で死亡	アフガニスタン東部の米軍基地で新たに爆発があり、アフガニスタン人3人が死亡した。
エジプト軍がシナイ半島で自爆テロ、6人死亡	エジプト軍がシナイ半島で自爆テロ、4人死亡
米経済指標の好結果を受け、アジア市場が上昇	アジア市場は、米国と中国の好材料で持ち直す
ネルソン・マンデラ氏が検査のため入院	南アフリカ：マンデラ氏、検査のため入院
イラン、世界6カ国と画期的な原子力協定に調印	イラン、世界各国と核兵器に関する協定に合意
パキスタンの政治集会で自爆テロ、9人死亡	自爆テロ、トルコの米大使館で警備員を殺害
エジプトでの衝突でモルシ支持者4人が死亡	モルシ支持者と治安部隊が衝突し、数十人が負傷した。
学生たちが電波に乗る	台湾沖でマグニチュード5.5の地震が発生
ピストリウスの警官、事件から降板	ピストリウス巡査、殺人未遂容疑で逮捕
ヴィニー・ジョーンズ、がんとの闘いを明かす 新曲	ヴィニー・ジョーンズ、皮膚がんであることを公表
パキスタンのタリバン指導者ハキムラ・メスードが無人機攻撃で殺害された。	パキスタンのタリバンは、ハキムラの殺害を流血で報いると復讐を誓う。
シリア中部のパン屋への空爆で数十人が死亡	シリアのパン屋への空爆で「数十人死亡」。
パキスタンで武装集団が兵士1人を殺害し、2人が負傷。	パキスタンで武装集団が6人のポリオ作業員を殺害
警察が容疑者の捕獲方法を確認	ボストンマラソン爆破事件の容疑者襲撃の模様が撮影されました。
シリアの化学兵器廃棄を開始	シリアの化学兵器の破壊は困難となる可能性がある。
カナダで洪水が発生し、別の都市が避難を余儀なくされている。	カリフォルニアの山火事により、家屋や大学から避難命令が出される
国連、米軍の無人偵察機はパキスタンの主権を侵害すると指摘	国連： 米軍の無人機攻撃はパキスタンの主権を侵害
オバマ大統領、マンデラ氏を「インスピレーション」と賞賛	オバマ大統領はマンデラ氏のインスピレーション効果を賞賛している。
オバマ大統領がイスラエルとパレスチナ人の意見を聞くために来日した。	ケリー、イスラエル・パレスチナ協議のためのアラブ人プランを歓迎
電子メール - 石油会社が大臣との面会についてトレーダーに質問した件	石油会社が不正取引業者に大臣との面会を依頼
ナイジェリアの警察襲撃で死者30人に	ケニアのバス襲撃で死者6人に
シリア、「化学兵器を申告し条約に署名する」。	ロシアとシリア、化学兵器に関する具体的な計画を発表
オーストラリア、高騰する国家債務上限を撤廃へ	豪州首相、インドネシアと議論しないことを主張
米国債務問題への期待からアジア市場は3週間ぶりの高値に	アジア株が3週間ぶりの高値に 米国の債務問題への期待で
モンティ首相が辞任	「パレスチナのファイヤード首相が辞任」。
南アフリ カ、「統合失調症」のマンデラ氏署名の誤りを認める	南アフリカ、マンデラ記念館での聴覚障害者の手話をめぐる「誤り」の可能性を認める
イラン、核協議に重大な問題が残っていると発言	イラン、「平和的」な核開発プログラムを維持すると宣言
クリスマスの群衆がベツレヘムに集まる	ああ、リトル・タウン・オブ・ベツレヘム、マジで。
スーダンのダルフールで和平監視団員7人が殺害された。	アビエイでの衝突で平和維持要員が死亡
NATO : シリア国境でパトリオット・ミサイル・バッテリーが運用開始	オバマ大統領：パトリオット・ミサイル・バッテリー、軍隊をシリア国境近くのヨルダンに駐留させる。
閉鎖3日目で米国株は暴落	株安、政府機関閉鎖3日目
ギニア、長らく延期されていた立法府の投票を実施	エクアトギニア人による立法府の投票
NATO : アフガニスタンの攻撃で3人の兵士が死亡	アフガニスタンの「インサイダー攻撃」でNATO軍兵士が殺害された。
イスラエル兵、ヘブロンでパレスチナの子どもを殴る	イスラエル兵、西岸でパレスチナ人女性を殺害
国連、イスラエルのシリア攻撃に警鐘を鳴らす	イスラエル政府高官、シリアへの2度目の空爆を確認
エジプト軍、シナイ半島の武装勢力に新たな空爆を開始	エジプト、シナイ半島の武装勢力に対する新たな攻撃を開始
フランス軍、アルカイダのマリ支部を攻撃	北マリ奪還の戦い：数百人のフランス軍がアルカイダ系反乱軍を追い返す
エジプト警察、同胞団に催涙ガスを発射	インド：集団レイプのデモ隊に催涙ガスを発射
シリア政権、和平会議への出席に合意	シリア、野党が和平会議出席で「原則」合意
アフガニスタン立法府、新選挙法を承認	アフガニスタン大統領、新選挙法を承認
アルジェリア、アルカイダ人質救出のため軍事作戦を開始	アルジェリア、人質のための国際部隊を検討
サンフランシスコ空港にボーイング777型機が不時着し、数十人が負傷。	アシアナ航空 ボーイング777がサンフランシスコ空港に不時着
ミャンマーのモスク火災で子供13人が死亡	ミャンマー警察、モスクの電気火災で子ども13人死亡と発表
米上院、「財政の崖」法案を採決へ 期限迫る	財政の崖 : 下院、財政の崖に関する法案の採決を延期 - ライブ中継
デリーの集団レイプ被害者、シンガポールの病院で死亡	デリーの集団レイプ被害者がシンガポールの病院へ搬送される
バースコントロールは緑内障のリスクと関係がある	避妊ピル「緑内障のリスクを2倍にする
バッキンガム宮殿の入口でナイフを持った男を逮捕	バッキンガム宮殿で逮捕された男が起訴された
コロラド州の雪崩で5人が埋まる	「コロラドの雪崩で5人のスノーボーダーが死亡
潘基文、シリアの化学兵器協定を見直す	禁止、シリアの化学兵器協定を見直す
イラク大統領、健康上の問題で入院中	イラク大統領、脳卒中で入院中
マレーシアの長期政権維持のための連立政権	マレーシアの連立与党が過半数を獲得
アルマゴール、囚人解放でネタニヤフ首相を非難	ヤシモビッチ、パレスチナ人囚人の解放を承認するよう内閣に要請
ベイルートのイラン大使館付近で爆発があった。	ベイルートのイラン大使館付近で2回の爆発があった。
ニューオリンズで銃乱射、19人負傷	警察 :ノラの母の日」銃撃事件で19人が負傷
ヘーゲル、米国防予算の "政治的 "変更を嘆く	ヘーゲル、国防費削減案を擁護
米国、ロシアへのフライトで液体・ジェルの機内持ち込みを禁止	ロシアへの直行便で液体物の機内持ち込みが禁止に
マレーシア、5月5日を選挙投票日に決定	マレーシア、画期的な選挙の日程を決定
NATO軍、アフガンの子ども2人を殺害	NATOの空爆でアフガンの子供11人が死亡
イラン大統領、新たな核協議を要求	イランの閣僚、核協議の失敗を西側の責任に
洪水で2人が死亡、75,000人がカルガリーの家屋から避難	洪水により75,000人がカナダから避難
アフガニスタンでNATO軍4人が死亡	アフガニスタンでNATO軍8人死亡
台風11号が中国東部に上陸	台風12号が中国南東部に上陸。
マンデラ氏、クリスマスを病院で過ごすことに	マンデラ・ムービー、南アフリカで今月公開
出口調査により、プーチン大統領の支持者がモスクワの投票で勝利したことが示唆された。	プーチン大統領の支持者がモスクワの選挙で勝利し、ナヴァルニー大統領は反感を表明した。
裁判官がジェームズ・ホームズの無罪を主張	ジェームズ・ホームズ、無罪を主張 - しかし心神喪失のオプションはまだある
スペインで列車事故、少なくとも45人が死亡	イラクのディヤラで自動車爆弾テロ、少なくとも13人が死亡
ダーワンがインドを破り、南アフリ カに大勝利	ダワンの1トンで、インドが南アフリ カに勝利した。
クリス・フルーム、ツール・ド・フランスの終盤戦へ	クリス・ブラウン コンサート中止のお知らせ
アップルアプリ、アラスカ空港の滑走路にドライバーを誘導	アップルアプリがドライバーを空港に送る
パキスタンで米軍の無人偵察機、武装勢力3人を殺害	米軍の無人偵察機、パキスタンで武装勢力4人を殺害
病院 : ベネズエラの刑務所暴動で61人が死亡	ベネズエラの刑務所での暴動で数十人が死亡したと報告されている。
エジプトでイスラム教徒が反撃し、衝突が勃発。	エジプトでコプト教司祭が銃殺される
韓国、一家団欒を延期	北朝鮮、戦争で傷ついた家族の統合を延期
フランシスコは祈りによって教皇職を始める	教皇フランシスコは祈りのためにバチカンを抜け出しました。
財政の行き詰まりを打開する道はまだ見えず、米上院が会合へ	米上院、財政難の中、珍しく日曜に会期。
エジプトの同胞団は、その指導者と同様に苦境に立たされている。	エジプトのムスリム同胞団が大規模なデモ行進を実施
ネルソン・マンデラ氏に賛辞を贈る女王	米大統領、マンデラ氏に賛辞を送る
中国の新型ステルスフリゲート艦が就役	ベラルーシとラトビア、国境委員会を設立へ
イラクの暴力で11人が死亡	イラクの暴力で7人が死亡
緊迫するウクライナの首都で、抗議デモが続いている。	ブラジルで抗議デモが続く
シリア、米・英の化学兵器に関する主張を拒否	米国はシリアが化学兵器を使用したと疑っている
エジプト・シナイで誘拐された英国人、解放される - 情報筋	エジプト・シナイで拘束されていた英国人2名がベドウィンに解放される
シリア、イランの核合意を歓迎	イラン、世界6カ国と画期的な核取引に成功
イスラエル、入植計画で欧州の反発を受ける	イスラエル、欧州諸国による最新の入植計画について説明責任を果たすよう要請される
イランが無人偵察機を捕獲したと発表、米国は紛失を否定	イランが米国の無人偵察機を押収したと発表、米国は事実でないと反論
エジプト、ムスリム兄弟団最高指導者を逮捕	エジプト、ムスリム同胞団を入国禁止に
オバマ大統領、記者会見で自身のジョークを披露	オバマ大統領、記者会見で評論家たちをからかう
アレン、ファローの虐待の訴えに手紙で反論	アレン、ファローの虐待の訴えに対し弁明
パキスタン北西部で武装集団が9人を殺害	イラクで武装集団が警官3人を殺害
リビアのアルクウェフィヤ刑務所から1,000人以上の受刑者が脱走。	リビアの刑務所から1000人の囚人が脱走
核のオプションとは何か？	北朝鮮の核準備態勢を示す写真
外国為替と金 2013年3月6日	為替と金 12 March 2013
イスラム教徒、ニジェールで自爆攻撃、21人死亡	シリア国境近くのトルコの町で自動車爆弾が20人を殺害
米国はシリアが化学兵器を使用したと断定した	国連、シリアの化学兵器廃絶を決議
スノーデン氏の父親がモスクワに到着	エドワード・スノーデンの父、モスクワに現る
イランの原子力発電所で放射能漏れはなし	米議会がイランの核取引に水を差す可能性
パキスタンのタリバン、無人機攻撃後に新指導者を指名	パキスタンのタリバン指導者が米軍の無人爆撃機で殺害された。
パキスタンで双子の爆弾テロ、少なくとも40人が死亡	現在、武装勢力はパキスタンの警察と戦っている。
カイロでの衝突でムスリム兄弟団支持者が死亡	エジプトでの衝突でムスリム兄弟団支持者が死亡
フェイスブックの収益はモバイル広告の加速で63％急増	フェイスブック、ユーザー数拡大で利益急拡大
シリア特使、国民統合政府を呼びかけ	シリア特使、紛争終結のための政治的変化を呼びかけ
3月11日のニュースまとめ	1月14日のニュースまとめ
イタリア・ツアーバス転落事故、37人死亡	イタリアバス転落事故、30人死亡
ロジャースとビデオトロンは、ネットワーク共有契約で範囲を拡大しました。	ロジャース、ビデオトロン・リーチ・ネットワークシェアリング、スペクトラム契約
中国株、木曜日は安値で終了	中国株、木曜日は安値引け
選挙で投票するベルルスコーニに、トップレスの女性たちが抗議の声を上げる	ブルガリア大統領、デモ隊を支持、解散総選挙に反対
インドネシア : インドネシアの火山噴火による死者14人のうち学童が死亡	インドネシア : インドネシアの火山噴火で6人死亡
バングラデシュのイスラム主義者の処刑が支持された。	バングラデシュが野党指導者を処刑
イランのルハニ大統領、米国との核合意は3カ月以内に可能との見解を示す。	イランのハッサン・ルーハニ大統領、数カ月以内に核合意を希望
イタリア新政権に関する合意	イタリア、連立新政権発足へ
オバマ大統領、ネルソン・マンデラ氏の死を悼む	南アフリカ、マンデラ氏を追悼・祝賀
ハワイ州、同性婚法案を可決	米上院、同性愛者労働者法案を可決
モディスのデリーへの行進の第一歩となるゴア	テクニオン、史上初めてロシアでエンジニアリングを指導
シンガポール株、0.4％高で終了	インド株は高く始まる
モルディブ、大統領再選挙を実施	モルディブで新たな大統領選挙が実施される
エジプト、ムスリム同胞団支持者1,004人の逮捕を発表	エジプト、同胞団幹部バディーの逮捕を命令
新世界貿易センターが米国で最も高いビルに認定されました。	ワン・ワールド・トレード・センターが米国で最も高いビルに選ばれる
What the papers say , Mar.12 , 2013	新聞に書いてあること、6月25日、2013年
イスラエル、1500戸の入植者用住宅を許可	イスラエル、さらに1800戸の入植者用住宅を公開
ピアーズ・モーガンが警察に尋問される	ピアーズ・モーガン、ハッキング事件で警察の事情聴取を受ける
シリアの野党、EUに反体制派への武器送付を要請	シリア野党、暫定首相選出のため会合
シンガポール株は0.11％上昇で終了	シンガポール株、0.54％高で取引終了
ムンバイのフォトジャーナリスト強姦事件が解決、5人の容疑者を逮捕	ムンバイ・ジャーナリスト集団強姦事件：被告人5人全員を逮捕
イエメンのモサドスパイで「イスラエル人」を逮捕	イスラエル軍、ヘブロンで2人を拘束
パキスタンの少女はつらい教訓を学んだ	タリバンに撃たれたパキスタンの少女がビデオに映る
エジプト暫定大統領、2人の顧問を任命	エジプト暫定大統領、新内閣を発足させる
オスカー・ピストリウスの恋人リーバ・スティーンカンプの葬儀が執り行われる	オスカー・ピストリウス「バスルームでスティーンカンプを撃った」。
中国、ヘリから初の空対空ミサイルを発射	中国裁判所、ボー・シライに汚職の罪で無期懲役の判決
英国、シリアの化学兵器に関する恐れを確認	シリアの化学兵器に「終わり」が近い
エジプトでの弾圧に非難が集中	egypt : エジプトの弾圧、世界的な怒りに包まれる
ニューヨークの待ち伏せで2人の消防士が死亡	ニューヨークの消防士2名が待ち伏せの末に保護された状態である。
エジプト、新暫定指導者を宣誓	エジプト軍、同胞団を取り締まる
パキスタンで自動車爆弾テロ、17人が死亡	パキスタンで自爆テロ、10人死亡
ウォーターフォードとダブリンの海岸で10人が救助された。	ダブリン湾でボートが転覆し、6人が救助された。
クラスノヤルスクで再会した2人のプッシー・ライオットのメンバー	解放されたプッシー暴動コンビが反プーチンデモを盛り上げる
パキスタンのタリバン上級司令官がアフガニスタンで捕まった。	パキスタンのシーア派、武装勢力からの保護を要求
スペイン列車事故の運転手、判事から質問受ける	スペイン事故の列車運転手、裁判官に尋問される
米国、フラッキングの水への影響に関する最初の報告書を発表	中国の男性たちがホテルに連れ込み、拘束されました。
化学兵器による攻撃をシリアの反体制派になすりつけたのはロシアだけである：米国	ロシア、国連にシリアの化学兵器使用に関する調査を検討するよう要請
フィリピン、反政府勢力と富の分配で合意	フィリピンと反政府勢力が「富の取引」に成功
西中国暴動による死者数は35人に上る	緊急 : 中国南部での火災による死者数が112人に増加
イスラエルがガザで空爆を開始	イスラエル、ダマスカス近郊で空爆を開始
フィリピンで洪水、6人死亡	フィリピンで豪雨、18人死亡
火星探査機、初の岩盤サンプルを採取	ワウリンカが初のグランドスラム決勝に進出
イムラン、NAの4議席から出馬	イムラン・カーン、NAの4議席から選挙に出馬へ
イスラエルの先駆的な電気自動車会社。	イスラエルの電気自動車会社、解散へ
ヒューストン・テキサンズ ヘッドコーチ ゲイリー・クビアク氏、試合中に倒れ、入院。	テキサンズのゲイリー・クビアク監督が倒れた後、安定した状態にある。
親パカ派タリバンの将軍が米軍の無人爆撃機で殺害された。	タリバン司令官、米無人機攻撃で死亡
Ankeet Chavan、結婚のため条件付き保釈を認められる	Ankeet Chavanが結婚のために保釈されました。
シリア北西部で自動車爆弾、20人死亡	シリア北部の自動車爆弾で20人が死亡
南朝鮮兵、北に越境しようとした男を殺害	北朝鮮、最後に残った南とのホットラインを閉鎖
スペインの列車事故、最大50人が死亡	スペインの高速鉄道事故、70人以上が死亡
エジプトで麻薬密輸の罪で外国人5人に死刑判決	エジプト、麻薬密輸の罪でパキスタンの5人に死刑判決
フランス、パリ南方で列車が脱線	フランス人乗客が語る、事故の悲惨さ
レーガン大統領の元報道官が死去	レーガン政権の元報道官、ラリー・スピークス氏が74歳で死去
エジプト、新憲法を採決	エジプト人による分裂憲法に関する投票
オバマ大統領、マンデラ氏の遺族と面会 入院中のマンデラ氏	オバマ大統領、マンデラ氏一家と面会へ 病院は訪問せず
イラン穏健派が大差で大統領選に勝利	イランが石油価格戦争の引き金を引くと脅す
低収益が米国株の下落を引きずり、取引開始	低収益がウォール街の株価を引き下げる
福島原発事故と闘った男性、がんで死去	福島原発事故と闘った元原発所長ががんで死去
ヘリコプターがパブに墜落し、3人が死亡した恐れがある。	パブ・ヘリ墜落事故で3人死亡の恐れ
ナイジェリア議員、贈収賄の疑いで起訴	ナイジェリア下院議員、300万ドルの賄賂受領で起訴
ルピーは対ドルで8ペソの下落。	ルピーは対ドルで22ペンス上昇。
イラン、来月に核協議を再開すると発表	イラン、敵の通信システムを妨害する能力があると発表
イスラエルのペレス大統領、和平交渉への復帰を要請	イスラエルのペレス大統領、和平交渉への復帰を要求
オバマ大統領、シリアについてホワイトハウスで13時15分（米国東部時間）に講演	オバマ大統領、ホワイトハウスでシリアに関する声明を発表 午後1時15分より
インド株は安く始まる	インド株 安値引け
米国、シリアに対する単独行動の可能性を準備	米国、シリアに対する行動の必要性を訴える
ベルファストで警察と小競り合い	チュニジアで弔問客と警官隊が衝突
新世界貿易センタービル	ワン・ワールド・トレード・センターが米国で最も高いビルに選ばれる
米当局、リシンの捜査で男を起訴	南アメリカの警察が農場への抗議で50人を逮捕
中国地震：死者数が増加	中国でのインフルエンザによる死者数が6人に
バングラデシュの建物の犠牲者が352人になり、4人が逮捕された。	バングラデシュの建築物犠牲者数が372人に達し、所有者が逮捕された。
アルジェリアのガス工場で25人の遺体が発見される	アルジェリアのガスプラントでさらに25人の遺体が発見される
RI、シリアでの化学兵器使用を非難	シリアの化学兵器に関する主張をめぐり、疑問が生じる
パキスタン地方で新たな強い地震が発生	パキスタンで新たに発生した強い地震。
インド軍、カシミール管制線沿いのパキスタン兵を殺害	インド軍、パキスタン軍基地を急襲
教皇ベネディクト16世、枢機卿たちに別れを告げる	ローマ法王ベネディクト16世、最後のバチカンを去る
ファッションデザイナー、リリー・ピューリッツァーが死去	デザイナー、社交家リリー・ピューリッツァー、81歳で死去
中国、新型空母で軍備近代化を推進	中国副首相、オーストラリア総督と会談
ブラジルの指導者、街頭抗議で危機的な会談を行う	ブラジルの指導者が改革投票を約束
熱帯性暴風雨アンドレアが東海岸を通過中	熱帯性低気圧「アンドレア」が東海岸に上陸。
新日本国政府、太平洋貿易協定への加盟を示唆 : レポート	日米、地域貿易協定に関連した協議を開催
インドネシアで列車事故、4人死亡	インドネシアの列車が燃料運搬車と衝突し、5人死亡
イスラエル、900戸の入植地を建設する計画を推進	イスラエル、入植者の新住宅建設計画を発表
ミス・ニューヨークがミス・アメリカの栄冠に輝く	ミス・ニューヨークがミス・アメリカの栄冠に輝く
ウェブサイトバトル嫌なコメント , 匿名性	ウェブサイトは、匿名性を排除することで、不快なコメントと戦う。
オーストリア、盗まれた56個の頭蓋骨を自宅の博物館に保管していたことが判明	オーストリア人男性、自宅で56個の頭蓋骨を発見され起訴される
オバマ大統領就任式	米下院、イラン就任式前に新たな制裁を支持
サウジアラビアの武装勢力容疑者、レバノンの拘束下で死亡	米軍の無人偵察機、イエメンで武装勢力6人を殺害
ナショナル・モールで焼身自殺	ワシントン・ナショナル・モールで男が焼身自殺
同性婚に抗議する数千人の人々	フランスで同性婚に数千人が抗議
インド・インク : イメージ・オブ・ザ・デイ : 1月27日	INDIA INK : 今日の一枚 : 3月20日
連邦議会議事堂で発砲があり、ロックダウンしている。	ライブ中継 : 発砲事件の報告を受け、連邦議会はロックダウンしている。
中国初の試験的自由貿易区がオープン	上海自由貿易区の運用を開始
パキスタンの西部で爆発があり、12人が死亡、25人が負傷した。	パキスタ西部で爆発、6人死亡・12人負傷
バングラデシュのビル倒壊事故からの抜粋画像	バングラデシュのビル崩壊で少なくとも200人が死亡
中国裁判所、メコン川流域の殺人犯に死刑を求刑	メコン川殺人事件の死刑判決を支持する裁判所
パキスタンのスクールバスでガスボンベ爆発、17人死亡	パキスタンのスクールバスをガスボンベの爆発が襲う
北朝鮮の貨物から、キューバとのミサイル修理取引が判明	キューバ・ミサイルを積んだ韓国船を押収
イスラエル軍、西岸でパレスチナ人5人を拘束	イスラエル軍、西岸でパレスチナ人5人を逮捕
利権がらみの抗議がブラジルを覆う	譲歩にもかかわらず、ブラジル全土で抗議が計画されている。
ドイツの選挙でアンゲラ・メルケルが3期目の当選を果たした。	ドイツ選挙でメルケル首相が大勝利
トルコ警察、イスタンブール公園デモエリア周辺に集結	英国警察、性犯罪者サヴィルの保護を否定
韓国人労働者、共同工場地区から離脱開始	韓国人労働者、共同工場地区から退去へ
上院は、ヘーゲルへの同意を進めるかどうか投票する。	ベネディクト、新居と新法王のもとに帰る
ロシアの鉄道駅で自爆テロ、15人が死亡、多数の負傷者	ロシアの鉄道駅で自爆テロ、14人死亡
グアテマラがソフトウェアの第一人者であるジョン・マカフィーを逮捕	グアテマラで拘束され、ソフトウェアの第一人者であるMcafeeは国外退去と戦っている。
カンボジアの野党指導者サム・レインシーが選挙をかき乱すために戻ってきた。	カンボジアの野党代表、世論調査に向けて国会に出頭
西側は和平交渉への参加を求めるシリアの野党票を歓迎	シリアの野党、会談の代表団を指名へ
オバマ大統領、竜巻の被害を受けたオクラホマ州を訪問	オバマ大統領、竜巻の被害を受けたオクラホマ州を訪問
オバマ大統領が休暇に入り、財政の崖に合意せず	ジョン・ブーナー : 謙虚な出自から、財政の崖は彼の破滅につながるかもしれない。
ビデン氏、米中関係における信頼を呼びかけ	ビデン氏、中国との「新しい関係」構築のための信頼関係を呼びかけ
シリア、反体制派の町で自動車爆弾、少なくとも12人が死亡	シナイ半島で自動車爆弾、エジプト兵少なくとも10人死亡
ケリー：40億ドルのパレスチナの経済計画は機能する可能性がある	ケリー：イランとの核協議はまだ終わっていない
バングラデシュのビル倒壊、死者359人に	インドのビル倒壊、死者72人に
中央アフリカの戦闘で数十人が死亡	中央アフリカ共和国で衝突が発生し、98人が死亡
リビア、石油反対派に軍隊の行動を予告	プリンストン大学に爆弾の脅威があり、避難を余儀なくされる
トルコの2つの組合が警察による暴力に抗議し、月曜日にストライキを要求	トルコ騒乱：警察による弾圧に組合がストライキを呼びかけ
[ティッカー】フィッチ、ギリシャの格付けを引き上げ	ムーディーズのギリシャの格付けが引き上げられました。
ナイジェリアの石油地域で武装集団が警察船を待ち伏せ。	スーダン警察、人権委員会への抗議を阻止
シリアを出たロシア人がレバノンに渡る。	ロシア、レバノンのシリア人難民に人道的支援を提供
アフガニスタンで「内部者」の攻撃により米兵2名が殺害される。	パキスタン西部の爆弾テロで兵士8人が死亡
南アフリカの象徴、ネルソン・マンデラ氏が入院	南アフリカのネルソン・マンデラ氏が入院
フェレール、全豪オープン準々決勝に進出	フェレール、錦織を下し、全豪オープン準々決勝へ進出
UBS、米国住宅ローン訴訟で和解	ubs、米国住宅ローン訴訟で和解し、6億ポンドを請求される
ローマ法王フランシスコ、苦しみに対する世界の無関心を非難	ローマ法王フランシスコ、ランペドゥーサで死亡した移民を追悼
マンスール判事がエジプト暫定大統領に就任	エジプト暫定大統領にアドリー・マンスール法官が就任
南北朝鮮が協議に合意	南北朝鮮、異例の会談を開催
アフガニスタン東部で爆発、少女10人が死亡	アフガニスタン南部で爆発、9人が死亡 : 政府関係者
ケニア警察がアル・シャバブの主要な勧誘者、資金提供者を逮捕	ケニア : 反テロリスト警察に逮捕された2人組
オバマ大統領、水曜に銃規制案を発表へ	オバマ大統領、銃規制案を提示へ
ボストン・マラソンで2人が死亡、数十人が負傷。	ボストンマラソン襲撃事件で見つかった爆弾は2個のみ
シリアの化学兵器が海に沈む可能性	米国、シリアの化学兵器備蓄を海上で破壊へ
大統領、スリランカとのエコ・パートナーシップの早期締結を要請	パキスタン首相、スリランカとの経済関係強化に言及
センター不正利用問題で3人を釈放	エブテメタで3階建てビルが倒壊
ギリシャのショッピングモールで爆弾が爆発し、2人が負傷。	アテネのショッピングモールで爆弾が爆発し、2人が負傷。
ラオス航空機墜落事故、豪州人6人死亡	ラオス航空機墜落事故、数十人死亡
メリーランド州のモールで銃撃、犯人を含む3人死亡	メリーランド州のモール銃撃で3人死亡
国連、シリアの攻撃でサリンが使用されたことを確認	戦争犯罪」：国連、シリアの化学兵器攻撃でサリンを使用と認定
モンスタートラック事故、7人死亡	メキシコの「モンスタートラック」事故で6人死亡
フロリダ州沖でボート転覆、4人死亡	セントビンセント島で大雨により8人死亡
カンヌの泥棒、ホテルで武装強盗、5,300万ドルの宝石を盗む。	カンヌで強盗が5300万ドル相当の宝石を盗む、警察発表
メルケル首相、ドイツで3期目の選挙に挑む	ドイツ選挙でメルケル首相が大勝利
パキスタンで武装集団が女性政治家を殺害	パキスタンで武装集団が女性教師5人を殺害
元ヴァージニア州知事のボブ・マクドネルが汚職で起訴された。	バージニア州の元知事ボブ・マクドネルと妻が汚職で起訴された。
スプリンターのタイソン・ゲイとアサファ・パウエル、禁止薬物に陽性反応	米国のスプリンター、タイソン・ゲイ、禁止薬物に陽性反応
本州でマグニチュード6.3の地震が発生 : CENC	サンタクルス諸島でマグニチュード6.0の地震が発生 : CENC
パキスタン、アフガニスタンのタリバン最高幹部囚人を解放へ	パキスタン、土曜日にタリバン上級司令官を釈放
カーダシアン離婚、裁判準備中	苦戦するホテルは価格競争に突入
エジプト裁判所、ムバラク氏の釈放を命令	エジプト裁判所、ムバラクの釈放を命じる
米捜査当局は、逮捕されたボストン爆弾犯への質問を待っている。	ボストン爆弾の容疑者を捜索するため、警察が通りに集結。
ネルソン・マンデラ氏、手術を受ける	' ネルソン・マンデラ氏が回復中 '
中国南部で交通事故、10人死亡・5人負傷	中国東部で交通事故、1人死亡・39人負傷
ルピー安の影響を受け、ボリウッドがコストを3分の1に削減	ルピー危機の影響を受け、ボリウッドがコスト削減を実施
女性、自動車保険料が高くなる	女性ドライバーは保険料の値上げに直面する
米国中西部で竜巻が発生し、6人が死亡、周辺地域は壊滅的な被害を受けた。	米国中西部で竜巻、暴風雨が発生、5人死亡
中国、規制当局に監査記録へのアクセスを許可	中国、米国の台湾への武器売却に反対
シンガポール株、0.26％上昇で終了	シンガポール株は0.11％上昇で終了
イランと原子力機関、大統領選後初の会談	IAEA、イランで選挙後初の核協議を開催
中国新首相、米ハッキングの主張を否定	中国の李首相、米国のハッキング非難を「根拠なし」と断じる
南スーダンで米軍機が衝突、4人が負傷	南スーダンでの避難活動中に米軍機が銃撃された。
ニュージーランド、同性婚を合法化へ	ニュージーランド、同性婚の合法化を決議
Dzhokhar tsarnaev、ボストン爆破事件の容疑について無罪を主張	ボストンマラソン爆破事件で起訴されたDZHOKAR TSARNAEV。
中国の将軍の息子はレイプで10年の刑を受ける	中国軍歌手の息子、集団強姦で懲役10年
P.G.警察は、子供が死亡した事故の運転手を探しています。	ニューオーリンズ母の日パレード銃撃事件の犯人を警察が捜索中
エジプト、大統領選を議会選の前に実施へ	エジプト暫定大統領、新内閣を発足させる
ペンタゴン、シリアへの攻撃をより強化する計画を調整	ローマ法王、シリアへの祈りに参加した人々に感謝
東ティモール、殺傷事件で武術クラブを禁止に	東ティモール、殺傷事件で武道館を禁止に
アフガニスタン立法府、新選挙法を承認	アフガニスタン大統領、新選挙法を承認
パキスタンで、軍はもう一人のタリバンと戦うことを固く決意している。	パキスタン軍、タリバンとの戦闘を断固として拒否
エジプト軍、誘拐犯の襲撃を推し進める	エジプト、モルシ大統領、人質ビデオ公開で会談を否定
マンデラ氏の埋葬を受け、南アフリカの人々が哀悼の意を表す	南アフリカ、マンデラ氏の国葬を実施
ボストンマラソンで「大きな音」を聞く。	ボストン・マラソンのゴール地点で2つの爆発があったとの報告。
クリプティック・クロスワード - 4月27日(土)	クイズ・クロスワード 4月27日(土)
コスタ・コンコルディアのキャプテンを過失致死罪で審理へ	コスタ・コンコルディアの生存者は、1年後の体験を詳述している。
イスラエル大臣、ケリー氏のボイコット警告を非難	イスラエル大臣、ケリー氏のボイコット警告を非難
ケニア最高裁判所、選挙結果を支持	ケニアのSCが選挙結果を支持
アンジェリーナ・ジョリーの叔母が乳がんで死去	アンジェリーナ・ジョリーと乳がんの複雑な真実
ミャンマーのスー・チー氏、党の結束を促す。	スー・チー氏、党の結束を促す
水曜日のための10のこと	今日のために知っておくべき10のこと
ホワイトハウス、国防請負業者、自動的な歳出削減の害について議論	ホワイトハウス、国防企業、自動的な支出削減を協議
ベネズエラのチャベス大統領、癌で死去	ベネズエラのチャベス大統領、癌のため58歳で死去
コロラド州の洪水の死者が4人に	コロラド州の洪水で、数千人に避難勧告が出された。
ザンビア元大統領を逮捕	ザンビアのルピア・バンダ元大統領を逮捕
米上院、イエレン氏を次期FRB議長に選出	米上院、新中央銀行総裁にジャネット・イエレンを選出
パレスチナの囚人26人がイスラエルの刑務所から解放される	パレスチナの囚人が癌で死亡、イスラエルの刑務所に不安の声
相次ぐ明るいデータでアジア株が上昇	強い米雇用統計を受けてアジア市場は上昇
イラク北部の爆弾テロで17人が死亡、133人が負傷。	イラクで新たな攻撃があり、15人が死亡、90人が負傷した。
インドの反強姦デモで負傷した警官が死亡	レイプ事件で負傷したインド人警察官が死亡
シリア政権、ダマスカス近郊で5,000人を避難させたと主張	シリア軍、ダマスカス近郊で掃討作戦を継続
キプロス救済発言で市場に警鐘	キプロス救済は、なぜいつものユーロのナンセンスに過ぎないのか
派閥がビアンカ・オジュクウAPGAナショナル・リーダーを指名	ビアンカ・オジュクウがアプガ・ナショナル・リーダーとなる
シリアでの化学兵器使用は決定打にならない	米国は、シリアによる化学兵器使用の決定的な証拠はないと見ている。
ガンマンが村を襲撃し、12人が死亡	インドで爆発、5人死亡
エジプト、ムスリムブラザーフッド紙を閉鎖	エジプト : ムスリム兄弟団副団長を逮捕
中国西部で強い地震、47人が死亡	中国西部で強い地震、少なくとも75人が死亡
ノーベル賞受賞作家ドリス・レッシング氏死去	ノーベル賞受賞者ドリス・レッシングさん、94歳で死去
スノーデン氏、ロシアに亡命の礼を言う	スノーデン氏、亡命先のロシアに感謝
上院、イエレン氏をFRB議長に承認	米上院、イエレン氏を次期FRB議長に選出
フランス軍、マリの主要都市を奪取	フランス軍が重要な町を押さえる
ニカラグア、ベネズエラがスノーデン氏に亡命を申し出る。	ボリビアのモラレス大統領、スノーデン氏の亡命を要請されれば認めると発言
ボストン爆破事件の容疑者がバージニア州に埋葬された。	ボストン爆弾の容疑者がヴァージニア州の墓地に埋葬されている。
巨大で非常に危険な竜巻がオクラホマシティに向かっている。	オクラホマ市を襲った竜巻で5人のうち母親と乳児が死亡
アラバマ州のスクールバス銃撃事件で人質のドラマが長引く	ネバダ州：中学校で銃乱射事件、2人死亡、2人負傷
パレスチナ大統領、西岸地区政府樹立のため学者を任命	パレスチナ大統領、イスラエルに和平交渉を望む
パキスタンで爆発、5人死亡、50人負傷	ボストン爆発、3人死亡・138人負傷 : メディア各社
パキスタンのマララさん、手術を待つため病院を離れる	マララさん、イギリスの病院を去る
シリアの首都でインターネットと電話のサービスが回復しました。	シリアでインターネットサービスが再開
エセックス・ホテルのプールで2人の死体が発見される。	エセックス・ホテルのプールで男女の死体が発見される。
シリアの首相、爆弾テロから生還	シリア首相、首都での爆弾テロから生還
パキスタン、シャワル地区での米軍機による空爆を非難	パキスタン、ミーランシャーでの米軍機による空爆を非難
テキサス州の爆心地に住民が戻る	住民がファルージャに戻る
南アフリ カ、ネルソン・マンデラ氏のために祈る	ネルソン・マンデラ氏のために祈りと歌で一致団結する南アフリカ
イランのアフマディネジャド氏、側近との選挙出席で起訴の可能性	アフマディネジャド氏、選挙出席で告発される可能性
モルシ支持者、少なくとも38人が衝突で死亡	エジプトでの衝突でモルシ支持者数十人が死亡
ミリバンド、最低賃金強化を公約	ポルトガルと中国、科学研究の提携を強化
シンガポール株、0.44％安で終了	シンガポール株式は0.5％高で終了
控訴の結果を待つスナイパー	新生中国の栄光
雇用統計を前に米国株式先物は上昇	株式先物は上昇、FRBに注目
水曜日の中国株は安くなる	中国株、金曜は安値引け
アップル株、iPhoneの失望で大打撃	アップルの株価が11％下落、業績が悪化したため
EU、ジンバブエに対する制裁を更新	EU、ジンバブエに対するダイヤモンド制裁を解除
パレスチナ自治区 : パレスチナ人、米和平交渉の青写真を拒否	パレスチナ占領地：どこにも行けないルートに直面するパレスチナ人
バングラデシュの工場火災で、オーナーらが起訴される	バングラデシュの工場で50人の生存者が発見された。
エジプト、湾岸諸国の投資家を誘致へ	エジプト、投資家の誘致に乗り出す ...
米露、シリアで合意に達する	米露、シリアの兵器で合意に達する
パレスチナ人、ヨルダンと和平交渉のスタンスを調整	ハマス高官、ガザ・PA和平交渉の調整を否定
緊迫したタイ選挙で3つの州で投票が中止された。	カンボジア野党、ハンセン氏当選を否定
ミス・ニューヨークがミス・アメリカ2013の栄冠に輝く	ミス・ニューヨークがミス・アメリカの栄冠に輝く
オバマ大統領、プーチン大統領とのモスクワ会談を中止	オバマ大統領、プーチン大統領との会談を中止
KLCI先物は日中混合で取引されています。	KL株、日中値動きまちまち
パキスタンで米軍の無人機による空爆の疑い、5人死亡	米無人機攻撃、パキスタンで少なくとも10人死亡
エジプト裁判所、ムバラクの釈放を命令	エジプト裁判所、ムバラク氏の釈放要請を却下
オランド、不倫疑惑で法的措置の恐れ	フランソワ・オランド、不倫騒動で法的措置の恐れ
イラン人亡命者、イラク・キャンプで死亡を報告	イラクのアシュラフ基地でイラン人亡命者、少なくとも47人が死亡
ブレードランナー」ピストリウス、殺人容疑に異議申し立てへ	ピストリウス刑事、7件の殺人未遂容疑で逮捕
パキスタン南西部で爆弾爆発、10人が死亡	パキスタンで大規模な地震が発生、39人が死亡
イスラエル軍、ヘブロンで2人を拘束	イラン核問題で問われるイスラエルの信頼性
エジプト人によるイスラム教の憲法に関する投票	エジプト憲法投票について、投票所の判事が有権者に指示」。
デービッド・キャメロン、戦争犯罪の疑いでスリランカに警告を発する	スリランカ、戦争犯罪の疑いで警告を受ける
メキシコ、激しい抗議デモの中で大統領に就任	前ニューメキシコ州知事リチャードソン氏、北朝鮮実験禁止を迫る
モルシ支持派、カイロで機動隊と衝突	キエフでデモ隊と機動隊が衝突
エジプト全土で衝突が発生し、4人が死亡、多数の負傷者が出ている。	エジプト暴力事件：カイロのイスラム大学で衝突、学生死亡
ヘリコプターがロンドンの鉄道駅近くに墜落。	ロンドンでヘリコプターが墜落
インドネシアの首都は、交通の混乱を緩和するために地下鉄を祈る。	ジャカルタは交通渋滞を緩和するために地下鉄を祈る
中国新防衛地域に日本機飛来	日韓の軍用機、中国の新防衛圏に反旗を翻す
台風被災者がフィリピンの店舗を襲撃	台風12号、フィリピンで死者15人
レバノンのヒズボラの拠点で自動車爆弾が15人を負傷させた。	自動車爆弾がレバノンのヒズボラの拠点を襲う
RF FM、シリアの野党に対し、シリアで拘束されたすべての外国人の即時解放に協力するよう要請	韓国野党候補、世論との差を縮める
カナダで列車事故、5人死亡・40人行方不明	中国南部で地滑り、8人死亡・11人行方不明
米上院、ジャネット・イエレン氏を米連邦準備制度理事会議長に選出	上院、次期連邦準備制度理事会議長にジャネット・イエレンを選出
アフガン警察、タリバンの戦闘員5人を殺害	タリバン5人、アフガン警察5人が待ち伏せで殺害された。
ハキムラ・メフスードが無人爆撃で死亡した後、カーンがパキスタンのタリバンの新指導者に指名されたという。	パキスタンのタリバン指導者ハキムラ・メスードが無人機攻撃で殺害された。
イラクで爆発、少なくとも66人が死亡	バクバで爆発、少なくとも47人死亡
ロシア、化学兵器備蓄の75％以上を廃棄	英国は、アサド大統領が化学兵器を使用する可能性がある証拠を見た。
イラン地震の死者数が増加	アルジェリアの人質死亡者数が増加
スアレス、カップ戦でのカムバックを目指す	フランス、マリ地上戦へ
モルディブ・チーム、インドで選挙を視察	リバーマン元FMの裁判の証言が始まる
ヨーロッパ北部を襲った暴風雨Xaverにより、死者数は6人に上る。	ヨーロッパ北部を襲った暴風雨により、死者数が増加。
パキスタンがアフガニスタンのタリバンのトップ囚人を解放	パキスタンがアフガニスタンのタリバン戦闘員7人を解放
レバノンでガンマンが航空会社のパイロットを誘拐した。	レバノンで武装集団がトルコ航空のパイロット2名を誘拐。
NZの同性婚に対する様々な反応	ニュージーランド、同性婚を合法化
テレビ気象予報士のフレッド・タルボットが性犯罪の訴えで逮捕される	天気予報士のフレッド・タルボットが「性的虐待」で拘束された。
米軍の無人機攻撃でパキスタンにて5人死亡	パキスタンの無人機による空爆で最大6人が死亡
インドでビル倒壊、25人死亡の恐れ	インドでビル崩壊、14人が死亡、数十人が閉じ込められる。
中国、果物売りが死亡し、市職員を拘束。	ナプサンはベイジューの指導力が崩壊した後、手綱を取る。
ソマリアのシバブがナイロビ・モール襲撃の犯行を主張	シリア反体制派、レバノンでの殺害を主張
シリア軍、反体制派の戦略的町に侵入	シリア軍、反体制派の町への攻撃を開始
イスラエル、パレスチナの囚人解放に合意	イスラエル、パレスチナの囚人26人を追加で解放
カイロのモルシ派集会で衝突が発生し、数十人が死亡。	エジプトでモルシ派の集会で衝突、70人以上死亡
タイの野党がバンコクの閉鎖を開始	タイのデモ隊がバンコクで「シャットダウン」を開始。
スペインの列車事故の運転手が尋問される	スペインの列車運転手ガルソン氏、判事から尋問を受ける
フランス、シリア兵器に関する米露の取引で突破口を開くと歓迎	フランス、シリアに関する米ロの合意を歓迎
アフガニスタンの「インサイダー攻撃」でISAF兵士が死亡。	アフガンの「インサイダー攻撃」で英兵が射殺された。
象牙海岸の暴走で約60人が圧死	象牙海岸の暴走で61人死亡
グラスゴーのヘリコプター墜落事故、捜索終了	グラスゴー・ヘリコプター墜落事故：少なくとも6人死亡
マラソン爆弾で3人死亡	タリバンがボストンマラソン爆破事件への関与を否定
インドでスイス人観光客が集団レイプされた。	インドでスイス人観光客が集団レイプされた。
インド、巨大サイクロンに備える	インド、サイクロン「フェイリン」に対する緊急警報を発令
マケイン上院議員、ウクライナで野党指導者と会談	SFG会合、マリ情勢をレビュー
コロラド州銃乱射事件の発端となったとされる学生銃撃犯に対する懲戒処分について	動機の鍵を握る学生への懲戒処分
トンネル崩落事故で多数の死者	シリアの空爆で多数の死者
夜間の給油所閉鎖は予定されていない。	インド政府、夜間のガソリンスタンド閉鎖案を却下
クリントン氏、ベンガジ攻撃について今月中に証言へ	クリントン氏、仕事復帰 ベンガジ攻撃で証言の予定
数万人のウクライナ人がキエフで抗議行動	ブータンで数万人が投票のために並ぶ
カルザイ、タリバン和平交渉のためパキスタンを訪問	アフガニスタン大統領、タリバン交渉のためパキスタン訪問を延長
英仏海峡水泳選手の特注車いすが盗まれる	チャンネルスイマーの車椅子が盗まれる。
天安門で自動車事故、3人死亡	天安門広場で事故、3人死亡
シンガポール株、金曜日は安く始まる	シンガポール株、木曜日は高く始まる
オバマ大統領、経済活性化を約束	オバマ大統領、議会に経済対策を迫る
クルド人反政府勢力、3月にトルコから撤退：報告書	クルド人反政府勢力、トルコから撤退へ
中国北西部で2つの地震が発生、11人死亡	中国で双子の地震が発生、89人が死亡
ホワイティバルガーに2年連続の終身刑を宣告	ホワイティー・バルガー、恐喝と殺人の罪で終身刑に
ケニア軍によるモール崩壊	ケニア軍がモールの崩壊を招いたと当局が発表
日本、第3四半期のGDP成長率を年率1.1%に修正	日本のGDP成長率、年率1.1%に下方修正
在UAEパナマ公館、選挙に向け準備中	エジプトのイスラム主義政党、選挙に向けて結束
バングラデシュの建築物災害による死者数が500人を超える	バングラデシュのビル崩壊：死者580人に上る
アルジェリア人質事件終了、死者数は不明	アルジェリア人質事件、大虐殺に終わる
エジプト外務省、モルシ派抗議デモの終結を再度要請	エジプト : モルシ派抗議デモの後、カイロの衝突で子供が殺される
南アフリカのマンデラ氏、病院に搬送される	南アフリカ：マンデラ氏、入院中
中国人民元、対米ドルで6.2689元まで上昇	中国人民元が対米ドルで高値更新
ラ・ボードウォークでの死亡事故について、警察が男を尋問しています。	警察は、ラテンアメリカの自動車運転による死傷事件の容疑者を逮捕した。
