南アフリカの基礎はネルソン・マンデラ氏の記憶の上に築かれている。	オーストラリアの政治家、ネルソン・マンデラ氏の死を悼む
トルコ機動隊 催涙ガス タクシム広場 抗議行動	トルコの機動隊がタクシム広場に入る
シカゴでの銃乱射事件は、取り締まり強化のギャップを示している。	シカゴでの銃乱射事件は、取り締まり強化のギャップを示している。
連邦政府、車と車の安全通信を義務化へ	グアテマラ、元独裁者の大量虐殺の有罪判決を覆す
ウクライナのデモ指導者が閣僚を指名、ロシア軍が警戒態勢に	ウクライナ、ロシアの「挑発」に対して行動を起こさず
北朝鮮、会談の申し出を拒否	北朝鮮がロケット弾2発を発射
チャールズ皇太子、プーチンをヒトラーに例える	チャールズ皇太子、プーチンをアドルフ・ヒトラーに例える
マララさん、スノーデンさん、ベラルーシ人がサハロフ賞候補に	逃亡中のスノーデン氏が欧州人権賞の最終選考に残る
イラン、イラクへの軍事介入に反対を表明	ダマスカス軍事空港付近で爆発
イスラエル首相、イラン大統領の偽善を非難	ギリシャ首相、偽善的な連合を非難
フィラデルフィアのビル崩壊で1人死亡、他の人は瓦礫から引き上げられる。	フィラデルフィアのビル倒壊、6人の死亡を確認
カイロで反モルシ派のデモ後、警察が若者と衝突。	エジプト : 警察がプロモルシー派のデモ隊と衝突
外交官トップがミュンヘンで会談、重要な時期に	外交官トップがイランの核開発について協議
スノーデン氏「エクアドルから難民申請書類を渡される」。	スノーデン氏、モスクワから飛び立つ模様
世界報道の自由の日」に寄せるNA会長のメッセージ	パキスタンは世界報道の自由の日
EU外相会合、シリアの武器禁輸を協議	EU外相会合、シリアの武器問題で解決策を模索
フィリピンの地震による死者数が185人に増加	フィリピンの地震による死者数は144人に上る。
陸軍ジェット機、パキスタン西部の空爆で武装勢力38人を殺害	米軍の無人偵察機、パキスタンで武装勢力4人を殺害
エジプト警察、カイロのデモ隊に催涙ガスを発射	カイロで警察がデモ隊に催涙ガスを発射
エルバラダイ、エジプト首相に就任へ	エジプト首相にリベラル派のエルバラダイ氏が就任 イスラム教徒は反感を持つ
フィリピン、汚職で2人目の上院議員を拘束	フィリピン、強力な台風から立ち直る
ドイツ特使、イランとG5＋1の協議に楽観的	イラン、今後の核協議に慎重な楽観的見方
スペインを代表するフラメンコギタリスト、パコ・デ・ルシアが死去。	スペインのフラメンコギタリスト、パコ・デ・ルシアが66歳で死去
中国砕氷艦、不審物に向かって進路変更	中国の捜索機、「不審物」発見
スノーデン氏、亡命のハードルにぶつかる	スノーデン氏、亡命のハードルにぶつかる
南インドのビル崩壊で死者47人に	インド南部でビル倒壊、4人死亡
パキスタン、2つのテレビ局の放送を一時的に禁止	パキスタン、FBI捜査官の訴えを棄却
パレスチナの囚人がラマッラのムカタに到着した。	パキスタン人囚人がジャムーの刑務所で暴行される
中国南部で交通事故、10人死亡・5人負傷	ガザ市での交通事故で5人が負傷
マット・スミス、BBCの「ドクター・フー」を降板	マット・スミス、BBCの「ドクター・フー」を降板
タイ政府はバンコクでのデモを鎮圧するため、治安部隊を増強している。	タイ国軍の治安部隊は抗議の声が小さくなっても兵舎に留まる。
麻生氏、ナチス発言で辞任を拒否	スペイン首相、汚職疑惑で辞任を拒否
レバノンのトリポリで2つのモスクの外で爆発があり、29人が死亡。	レバノン北部の都市で2つの爆発が発生
パキスタンの戦闘機が「タリバンの隠れ家」を爆撃。	パキスタンはシリア側への武器供給停止を望んでいる
台湾の4-6月期の経済成長率は2.27%。	中国の経済成長率、最新四半期は7.8%に回復
ケニアで2度目の攻撃、8人が死亡	ケニアで2度目の攻撃、15人死亡
米国、行方不明の英国人船員の捜索を公開後に再開	米沿岸警備隊、行方不明の英船員の捜索を一時中断
インドでビル崩壊、救助隊が瓦礫をかき集める	バングラデシュのビル倒壊事故からの抜粋画像
イラクの爆弾テロ、少なくとも13人が死亡	イラク、教会付近の自動車爆弾で少なくとも14人が死亡
タメルラン・ツァルナエフがバージニア州に埋葬される。	ボストン爆弾の容疑者がヴァージニア州の墓地に埋葬されている。
エジプト軍、モルシ派の抗議キャンプへの立ち入りを制限へ	エジプト軍、プロモルシー派の抗議キャンプを排除へ
ノーベル賞作家ドリス・レッシング、94歳で死去	ノーベル賞受賞者ドリス・レッシングさん、94歳で死去
野党党首、安倍首相の経済政策を批判	ジンバブエの野党「MDC」が、ロバート・ムガベの選挙勝利に挑戦する。
ボストン爆破事件で3人の容疑者の身柄を確保	ボストン警察、マラソン爆弾事件で3人の身柄を確保と発表
ウクライナの野党党首、さらなる抗議行動を望む	ウクライナのデモ隊がレーニン像を倒した。
ネルソン・マンデラ氏に賛辞を贈る女王	南アフリカラグビー界、マンデラ氏を追悼
米国株式市場の下落は緩やか	技術売りでアジアの株式市場は下落
ビルマで反ムスリムの暴力事件が発生、1人が死亡、10人が負傷	WORLD BREAKING | アジア : ミャンマー : 反イスラムの暴力が勃発
パキスタンで米軍の無人機による空爆の疑い、5人死亡	米軍の無人機攻撃でパキスタンにて5人死亡
ザ・ノート 2013年5月24日（金）の必読記事	2013年10月29日（火）付のザ・ノート必読記事
中国南西部で鉱山事故、22人が死亡	パキスタン南西部で爆発、2人死亡、数十人負傷
ニューヨーク市警のツイッター発信が大失敗	ニューヨーク市警のツイッターキャンペーンが裏目に出る
ニューオリンズで銃乱射、19人負傷	警察 :ノラの母の日」銃撃事件で19人が負傷
イタリア沖で別の移民船が転覆	イタリア沖で別の移民船が転覆、27人死亡
トルコの捜索終了、最後の行方不明者が発見される	トルコの捜索終了、最後の行方不明者が発見される
イラン、イスラエル・パレスチナ和平交渉の失敗を予言	イスラエル・パレスチナ協議再開に向け暫定合意 - 米国
オリビア・コルマン、2度目のBAFTA賞受賞	BAFTAS 2013 : オリビア・コルマンが2つの賞を受賞
タイタニック・ヴァイオリン、史上最高額の140万ドルを記録	タイタニックのバイオリンが170万ドルで落札される
Ankeet Chavan、結婚のため条件付き保釈を認められる	Ankeet Chavanが結婚のために保釈されました。
JALのエアバスからの初受注は、Boeingに打撃を与えた。	日本航空、エアバスA350を31機（95億ドル）受注
シエナ・ミラー、英国電話ハッキング裁判にて証言	シエナ・ミラー、ハッキング裁判での報道を「苛立たしい」と批判
イスラエル軍、エルサレムでパレスチナ人2人を襲撃	エルサレムで入植者がパレスチナ人を殴打
EU、対ロ制裁を延長	ナイジェリアがロシア人船員の武器取引容疑を取り下げた。
キューバ、外国投資に「大きな役割」を見出す	下院、政府再開案の採決へ
' äėglee ' äô star cory monteith found dead in hotel room.	コーリー・モンティスの死体が発見される：カナダ人スター、31歳。
レバノン首相が「統一内閣」を組閣 レバノン首相は就任から10カ月余り、深刻な対立を解消した上で幅広い政治グループを取り込んだ内閣を発足させた。	ベイルート：レバノン首相は昨日、就任から10カ月余りを経て、さまざまな政治団体を含む内閣を発足させた。
イラン大統領、世界の舞台でデビュー	イラン大統領候補、西側諸国の制裁を解除すべきと発言
エジプトでの抗議活動で数人が死亡	トルコ首相、抗議行動に警告
米国務省、テロ攻撃の可能性があるとし、広域旅行警報を発令	米国、アルカイダの脅威を理由に世界的な旅行警報を発令
キャメロン、ハラール肉に「懸念なし」。	退役軍人健康調査により、ケアの遅れの隠蔽が確認される
ミシェル・オバマ、『PARKS AND RECREATION』への出演が決定	ミシェル・オバマ、「PARKS AND RECREATION」に出演決定
シンガポール株は0.11％上昇で終了	シンガポール株、0.45％下落で終了
世界最高齢の男性、116歳で死去	世界最高齢の男性、116歳で死去
GM、リコールに手間取る、議会の記録で判明	モバイルワールドコングレス 未来型スマートフォン
レバノンでの爆破事件の死者数は47人に上る	レバノンの自動車爆弾テロで45人が死亡、容疑者1人を逮捕
ギリシャ極右指導者、公判待ちで投獄	ギリシャ極右指導者、公判待ちで投獄
バングラデシュの工場経営者ら逮捕、死者数350人に迫る	バングラデシュの工場経営者が逮捕される
エジプト兵4人、シナイ半島の待ち伏せで死亡	エジプト兵3人がシナイ半島の自動車爆弾で死亡
北京の空母、南シナ海から帰還	中国、南シナ海に空母を派遣
エジプト裁判所、ムバラク、イスラム教徒に対する裁判を審理	エジプト裁判所、不正蓄財のムバラク氏を一時的に釈放
モスクワのクリミア成功は、ウクライナの東部国境を引き直すことになるかもしれない。	メルケル首相：ロシアの行動は破局につながる可能性がある
ネルソン・マンデラ氏、95歳で死去	ネルソン・マンデラ氏が死去、95歳
ベルギー王アルベール2世、息子のために退位へ	ベルギー王アルベール2世、退位へ
ナチス・ゲシュタポ長官がユダヤ人墓地に埋葬された」。	ナチスの長をユダヤ人の墓地に埋葬した。
スイスの最低賃金最高額投票	スイス、世界最高水準の最低賃金を投票により決定
ラッド首相就任	ラッド氏が豪州新首相に就任
ドネツク州、デモ隊が政府のロケット弾を積んだトラックを拘束	タイの反政府暴動が拡大する中、デモのリーダーが「私を迎えに来て」と発言。
イージーライダーのスター、カレン・ブラックが74歳で死去	イージーライダーの女優、カレン・ブラックが癌で死去
コロナシオン・ストリートのビル・ローチェが逮捕されました。	コロナシオン・ストリートのスターが「素晴らしい」新セットを称賛
ロシア、EUとの協定に反対しウクライナに警告	反乱軍がウクライナのヘリコプターを墜落させた
レッドソックスがタイガースを破り、ワールドシリーズに進出。	レッドソックスがタイガースを5-2で下し、ワールドシリーズ進出を決めた。
中国での地震で少なくとも22人が死亡	中国での地震で少なくとも89人が死亡
エルナンデスの二塁打でメキシコが勝利	エルナンデスの2点タイムリープでメキシコが日本に勝利
ロズベルグ、父を偲んでモナコで勝利	F1 : ロズベルグ、モナコでの勝利にもかかわらず控えめな姿勢を崩さず
グラスゴー・ヘリコプターの死者数が9人に	地震による死者数が260人に
デビッド・ベッカム、今季限りで引退へ	デビッド・ベッカムがサッカー界から引退する。
アフガニスタン：自爆テロ、軍用バスで8人死亡	道路脇の爆弾でアフガン兵8人死亡
中国、経済担当高官を解任	中国FM、アセアン諸国の高官を招聘
韓国大統領、有力な叔父の処刑を歓迎	北朝鮮、金正恩が権力者の叔父を解任したと見られる
EU、ミャンマーと投資保護協定の締結を目指す	中国、もはや投資先としてトップではない：世論調査
テヘルカ編集長が性暴力事件に巻き込まれる	テヘルカ編集長、性犯罪疑惑で退任
鉄の女マーガレット・サッチャー、87歳で死去	マーガレット・サッチャー元英国首相、87歳で死去
エジプトでの衝突でモルシ支持者4人が死亡	エジプトに集まった数千人のモルシ支持者
国連、南スーダンの石油都市での民族間殺戮を非難	国連、南スーダンの民族殺害を非難
バンコクで警察がデモ隊に催涙弾を発射	デモ隊に催涙弾を発射
撮影 , 抗議行動 , タイの投票	デモ隊が事前投票を妨害
中国株価指数先物、安値引け -- 4月23日	中国株価指数先物の終値が上昇 -- 12月4日
カナダ、太平洋岸への石油パイプラインを承認	カナダ政府、太平洋への石油パイプラインを承認
イエメン襲撃でフィリピン人7人が殺害された。	シリア兵、爆弾攻撃で死亡
北東部を覆う嵐、ニュージャージー州で16インチの積雪	フォーラム、日中間の安定した関係を要請
イスラエルが空爆事件を終了、パレスチナ人は批判的	イスラエル軍砲艦がパレスチナの漁民に発砲
デモ隊がキエフのレーニン像を倒した。	ウクライナのデモ隊がキエフのレーニン像を倒した。
ブルックス、ハッキング容疑に無罪を主張	DAVE LEE TRAVIS、すべての起訴について無罪を主張
イラン、「核兵器破壊工作を阻止」。	イラン、核施設での妨害工作を検出と発表
ジャマイカとの絆を感じさせるリバプールの勝利	日本の選挙：安倍晋三は地滑り的な勝利を喜んでいる。
火曜日、中国人民元は対米ドルで6.1184まで上昇	中国人民元、月曜日には対米ドルで6.168元まで上昇
国際的な兵器専門家がシリアを離れ、オバマ大統領が声明を発表する。	兵器専門家がシリアを離れ、米国は攻撃準備に入る
譲歩にもかかわらずブラジルに集まった抗議者たち	譲歩にもかかわらず、ウクライナの抗議は続いている。
女王、ロンドン兵士襲撃事件を視察	エリザベス2世、先週殺害された英兵の兵舎を訪問
インドと中国の軍隊が事実上の国境に退却し、対決の取り決めをした。	インド、中国が事実上の国境線の後退に合意したと発表。
二人目の容疑者が捕まり、ボストンで安堵の表情	警察が容疑者の捕獲方法を確認
シリア軍、反乱軍から十字軍城を奪還	シリア軍、歴史的な十字軍の城を奪還
サウジ、レバノン軍に30億ドルを供与	サウジアラビア、レバノン軍に30億ドルを供与
ウクライナで赤十字の職員が解放された	シリアで赤十字のメンバーが誘拐された
シリア特使、反対運動なくして和平交渉なしと発言	シリア：キャメロンとオバマ、西側諸国への介入に近づく
クイーン、史上最大の空母を指名へ	女王が巨大空母に命名
バングラデシュの武装集団が待ち伏せ爆弾で囚人車から逃亡	バングラデシュの刑務所のバンが待ち伏せされる
マリで116人を乗せたアルジェリア航空機の残骸が発見される。	マリで発見されたAiralgerie AH5017便の残骸。
有力なパレスチナ人は一つの民主国家を求める	アラブ連盟、和平交渉におけるパレスチナの姿勢を支持
ロシア機墜落、数十人死亡	アラスカ飛行機事故、10人死亡
サウスウエストジェット機、機首直撃	サウスウエスト・ジェット機のノーズギアが先に着地した。
米国小売業者、バングラデシュの工場安全協定に合意	小売業者70社がバングラデシュの工場安全に関する新協定に合意
米国政府の閉鎖が始まる - ライブアップデート	ヘルスケアとの確執で政府閉鎖が始まる
アフガニスタンで自爆テロ、14人死亡	アフガンの首都で自爆テロ、1人死亡
中国、月への探査機とローバーを打ち上げる	中国、初の月面探査機を打ち上げ
クルシドの旅に注目が集まる．	欧州連合（EU）財務相会議
オーストラリア、過去最低の金利に引き下げ	オーストラリア、史上最低の2.75%に金利引き下げ
中国通信、ジェット機捜索の遅れを非難	ジェット機捜索のため中国船10隻を待機させる
クラシッククロスワード - 6月1日(土)	クラシッククロスワード - 4月20日(土)
韓国が短距離ミサイル30発を試射	韓国が短距離ミサイルを発射
プラハの爆発でパレスチナの外交官が死亡	プラハの爆発でパレスチナの外交官が死亡
カラカスでデモ隊が警察と衝突	ブラジルでデモ隊と警官隊が衝突
中国国家主席、インド副主席と会談	中国国家主席、米国務長官と会談
パキスタンの列車で爆弾爆発、12人死亡	パキスタン南西部で武装集団が9人を殺害 : 警察
ロンドン東部のシェレカ・マーシュで殺害された10代の少女は首を撃たれていたと警察が発表した。	ハックニー銃乱射事件：10代のシェレカ・マーシュは首を撃たれて出血多量で死亡した。
ナイロビのテロ事件で死者59人に	エジプトでの暴力による死者数は638人に上る
中国「平和の箱舟」、木曜日にフィリピンに向けて出発	中国がフィリピンに援助隊を派遣
フランス、論争の的になっている「大富豪税」の課税を容認	マニラ、テロ対策チームを増強
イラン反体制派「イラクで殺害された」。	フランス、欧州での影響力を失う
ジェームス・ガンドルフィーニ、51歳で死去	ネルソン・マンデラ氏、95歳で死去
約9百万人が「深刻な借金」を抱えている	英国の借金地獄：900万人が「深刻な借金」を抱えている
エジプト、ムスリム兄弟団リーダーのバディを逮捕	エジプト、ムスリム兄弟団が「怒りの行進」を呼びかけ、さらなる暴力に備えよ
ボストン・マラソンのゴール付近で2つの爆発が発生。	ボストン・マラソンのゴール地点で2つの爆発があったとの報告。
パキスタンの列車で爆弾爆発、12人死亡	インド東部で爆弾爆発、5人死亡
新冷戦	新しい冷戦？
インドネシア東部で強い地震が発生。	インドネシア東部沖でマグニチュード6.6の地震が発生
キューバの「レディース」、8年遅れでEU賞受賞へ	キューバの「レディース」、8年後にEU賞を受賞へ
ブラジルのバス事故、14人死亡	アリゾナスカイダイビング事故で2人死亡
米国：アサド大統領がシリアの反体制派に化学兵器を使用	アサド、化学兵器の引き渡しに合意
バングラデシュの崩壊で死者194人に	バングラデシュのビル崩壊で少なくとも200人が死亡
イスラエルの十代の若者たちが西岸で行方不明に	イスラエル、西岸で行方不明の十代の若者3人の遺体を発見
大統領、マンデラ氏の死を悼む	マンデラ氏の死を悼む世界
ベイルートのイラン大使館付近で2回の爆発、7人が死亡。	ベイルートのイラン大使館付近で爆発。
イスラエル、入植地への補助金を拡大	イスラエルが入植助成を拡大
シンガポール株、0.31％高でスタート	シンガポール株、月曜日は安く始まる
自爆テロ、イラク軍新兵23人を殺害	バグダッドで自爆テロ、イラク軍新兵13人が死亡
シリア軍、モスクに樽爆弾、5人死亡	ボストン爆発事件の手掛り探し
耳の聞こえない客がスターバックスを提訴、「馬鹿にされている」と主張	聴覚障害者のスターバックス常連客、「馬鹿にされた」と提訴
モスクワの地下鉄で火災が発生し、数千人が避難している。	モスクワの地下鉄で火災が発生し、数千人が避難している。
パキスタンで雨と鉄砲水により38人が死亡。	ブラジルのスタジアム崩壊で3人死亡
イエメン北部でシーア派のアルフースィー戦闘員が7人を殺害。	イエメン北部の宗派対立で少なくとも5人が死亡
イラン、シリア和平交渉から除外される：国連	シリアの空爆で多数の死者
リビア、国連安全保障理事会に支援を要請	ケリー氏、国連安全保障理事会にシリア問題への対応を要請
ケリー、議会にシャットダウンの終結を呼びかけ	ブラジル議会、インターネット法案を承認
カナダ列車計画容疑者、起訴を拒否	エジプトで解放されたカナダ人、まだ帰国していない。
東ウクライナの分離主義者がロシアへの加盟を要請	クリミア議会、ロシアへの加盟を決議
ラッド氏、新首相に就任	イスラム教徒は宗派の違いから身を隠している。
月の石は、地球の軌道が衝突して生まれたことを示している。	インディアンの大臣が正面衝突で死亡
オバマ大統領、北朝鮮をパリア国として非難	オバマ大統領、北朝鮮を「弱いパリア国家」と非難
ブラックベリー、第2四半期は9億6,500万ドルの損失	ブラックベリー、第2四半期は9億6,500万ドルの損失
オクラホマ州で竜巻が家屋を破壊、1人死亡	竜巻がカンザス州を襲う。負傷者なし
エジプト、シリアに対する軍事行動に強く反対	シリアに対する軍事行動の見通しに対する反応
親ロシア派の反政府勢力がマレーシア航空機を墜落させたと発表 : ウクライナ	ロシアはウクライナをめぐる対案を用意している。
ジャカルタの船について議論することはない : Abbott	イラン核協議で合意せず
米国は、シリアがおそらく化学兵器を使用したと考えている。	米国はシリア政府が化学兵器を使用したと考えている
エジプト、野党が大統領の演説を批判	パキスタン、野党が大統領選をボイコット
シリア戦争は何年も続くと見られている	シリア政権、数百人の囚人を解放
ロシア、地中海で弾道ミサイルを発射と発表	イスラエル、地中海で米国と共同ミサイル実験を実施と発表
インドネシアで火山が噴火 -10万人が避難、空港閉鎖も	火山噴火により3空港が閉鎖
イラクの暴力的な攻撃で49人が死亡、148人が負傷。	イラクの攻撃で2人が死亡、11人が負傷。
ウクライナのヤヌコビッチ氏は辞任するつもりはないと述べた。	ウクライナ野党、ヤヌコビッチに辞任を要求
アフガニスタン東部で鉄砲水が発生し、58人が死亡。	アフガニスタン東部で爆弾により16人が負傷。
空港での緩い銃撃の動機を調査する捜査官	ロサンゼルス空港での銃乱射事件の動機を探る。
マーガレット・サッチャー、元英国首相、87歳で死去	マーガレット・サッチャー、87歳で死去
インドの6歳の少女が学校でレイプされたとの報道を受け、怒りの声が上がっている。	インドの少女（6歳）が学校でレイプされた後の怒り
ジャネット・イエレン、女性初の連邦準備制度理事に就任へ	米上院、ジャネット・イエレン氏を米連邦準備制度理事会議長に選出
世界各国、ルハニ政権下のイランが核協議を再開	イラン核協議で稀に見る進展を求める世界各国
エジプトで禁止されているムスリムブラザーフッド	エジプトでは軍が優位に立つ
カナダ石油列車爆発事故、さらなる死者が予想される	カナダで列車事故、5人死亡
フィリピン、台湾の漁師襲撃事件でコメント見送り	ケニアのモール襲撃で示されたビンラディンへの揺さぶりの継続
マンデラ氏追悼式に群衆、高官が集結	オバマ大統領、マンデラ大統領の葬儀で自撮り写真を撮る
オバマ大統領、イスラエルとパレスチナの自制を要請	オバマ大統領、イスラエルとパレスチナの交渉担当者に会う
ロシア、グリーンピース医師を釈放	ロシアの裁判所、グリーンピースの船医を保釈
ロシア航空機の残骸が1年ぶりに発見された。	ロシア、リビアの大使館を攻撃を受けて避難させる
イエメンの結婚パーティーに米軍無人機攻撃、17人死亡	米無人偵察機、イエメンの結婚式の車列で誤って14人を殺害
中国製造業景気指数、11ヶ月ぶりの低水準 : HSBC	中国、9月に製造業が拡大
フランス、児童の美人コンテスト禁止へ	フェイスブック、モバイルペイメントサービスをテスト
歴史上の今日、12月2日	4月23日、歴史の中の今日
ロード・パルンボ、息子ジェームスとの関係に希望を託す	オスカー・ピストリウス、精神鑑定に送られる：その意味するところは？
シリアの化学兵器輸送のための船舶訓練	国連、シリアの化学兵器に関する決議を採択
インド・ムンバイのビル崩壊、死者29人に	インドネシアの鉱山崩落で死者12人に
ニジェールでのテロ事件で過激派が犯行声明	ギリシャの武装勢力、「黄金の夜明け」殺人事件の犯行声明を発表
親ロシア派がクリミアでウクライナ海軍基地に入りました。	クリミア軍、ウクライナ海軍本部を襲撃
行方不明になっていた韓国の海運王の遺体が野原で発見されました。	セウォル号事件：韓国海運界の大物社長の遺体発見
ネルソン・マンデラ氏の容態に進展なし	ネルソン・マンデラ氏の病状が好転
ビル崩壊で1人死亡	米ビル崩壊で6人死亡
ウクライナ：キエフの衝突で9人死亡	キエフの衝突で圧力を受けるウクライナ
誘拐されたナイジェリアの少女たちを探すため、米軍が監視飛行を実施	米軍の偵察機がナイジェリアの少女誘拐事件に参加
インドネシア沖でマグニチュード6.4の地震が発生	ロシア・クリル諸島沖でマグニチュード6.9の地震が発生
副議長、新たな性犯罪の申し立てに直面	ニゲル・エヴァンス副議長を再逮捕
CIA長官、シリア協議のためイスラエルを訪問	CIA長官がイスラエルでシリア情勢を協議
ジョージ王子がセント・ジェームズ・パレスで洗礼を受ける。	ジョージ王子の洗礼式がロンドンで行われた
モンティ・パイソン、新番組で再結成へ	モンティ・パイソン、舞台で再結成へ
イタリア外相、ガーナ共和国副大統領と会談	ベルギー首相、犠牲者に哀悼の意を示す
アトランタ市郊外の消防士を人質にした犯人が死亡したと警察が発表した。	The lede : ビデオ : ジョージア州で消防士を人質にした犯人。
ブラッドリー・マニング-ウィキリークス事件、量刑判断へ	マニング・ウィキリークス事件、判決段階に入る
グラスゴーのパブに警察のヘリコプターが墜落、数名の死傷者が出る。	グラスゴーのクラブの屋上にヘリコプターが墜落。
エジプト世論調査：98％が新憲法に「賛成」投票	エジプト、憲法に関する重要な投票を実施
イラン、世界6カ国と画期的な核取引に調印	イラン、世界各国と核兵器に関する協定に合意
マンデラ氏追悼式での指導者、家族の言葉	オバマ大統領、マンデラ記念館でキューバのカストロと握手
イスラエル軍、西岸での夜間襲撃でパレスチナ人6人を逮捕	イスラエル、エルサレム出身者を非市民と認定
ハーグ、ジンバブエの選挙実施に懸念	ジンバブエ：選挙への重大な懸念
香港株は高値で終了	インド株は高く始まる
ポール・デスマレイに敬意を表する要人たち	ジェームズ・ガーナーに敬意を表するスターたち
サウスウエスト、コンピュータの不具合でフライトを停止	コンピュータの不具合により、サウスウエストのフライトに遅れとキャンセルが発生。
シリアのバチカン大使館が迫撃砲の銃撃を受ける	シリアのバチカン大使館が迫撃砲に襲われる、負傷者はなし
北朝鮮が共同工業団地への立ち入りを禁止	北朝鮮が重要な工業地帯へのアクセスを遮断
カシミール地方で武装集団が観光客10人を殺害	ケニアの教会で武装集団が襲撃され、4人が死亡。
イスラム過激派、外国人観光客9人、パキスタン人1人を殺害	パキスタンで武装集団が外国人観光客11人を殺害
西側勢力、ソマリアのイスラム過激派基地を攻撃	西側諸国は、モディと仲良くするために奔走している。
香港、返還記念日に民主化大集会を開催	香港で大規模な民主化集会が開催されます。
イラクで自爆テロ、20人死亡	イラクの小学校で自爆テロ、15人死亡
スリナガルのJK事務局で大規模な火災が発生	スリナガルの事務局付近で火災発生
ボホールの地滑りで子供5人が生き埋め	アフガニスタンの攻撃で子供9人が死亡
インドネシアの火山が噴火し、高温の溶岩で6人が死亡	インドネシアで噴火、5人死亡
インドのビル崩壊で少なくとも11人が死亡	イラクで爆発、少なくとも66人が死亡
エジプト大統領選挙が始まる	エジプト、待望の大統領選挙法を発表
米国の人気伝道師の息子、リック・ウォーレンが自殺。	米国の人気伝道師ウォーレンの息子が自殺した。
第16回中国・EU首脳会議で中国・EU2020年協力戦略アジェンダが発表される	全文：中国-EU 2020年協力戦略アジェンダ
イタリア議会、新首相を支持	ニューヨークで列車脱線事故、4人死亡
ロシア連邦議会、インターネット規制の新法案を可決	ロシア、地中海で弾道弾が発射されたと発表
パキスタンで自爆テロ、4人が死亡、13人が負傷	ツイッター、パキスタンでコンテンツをブロック
ウクライナ反政府勢力、東部の拠点から脱出	ウクライナ、反政府勢力を主要拠点から撤退させたと発表
今季最強の超大型台風「ハイエン」がフィリピンを直撃	超大型台風8号（ハイエン）がフィリピンに迫る
NATO、ウクライナの弾圧を非難	タイ国債券は地域一番
中国、EUのワイン輸出を調査へ	クリスティ捜査が過熱
中国株、火曜日は高値引け	水曜日の中国株は安くなる
コナン・オブライエン、ホワイトハウス特派員の夕食会に出席	オバマ大統領とオブライエンが、ワシントンDCでのホワイトハウス特派員の夕食会について語る。
ボストン爆弾の容疑者を起訴 宗教的な動機があるとみられる	ボストン爆発事件の容疑者が病院のベッドで起訴されました。
アジア市場、中国貿易統計でまちまち	アジア市場、中央銀行の景気刺激策への懸念で低迷
世界最高齢者、日本で死去 116歳	世界最高齢者、木村次郎右衛門さん死去 116歳
インドにおける外国為替レート	シンガポールでの外国為替レート
コロラド州の山火事、風向きが悪化し90棟以上が焼失	コロラド州の山火事は、州史上最大の財産破壊となる可能性がある。
死刑廃止に向けた世界的な進展が見られる	イラン外交官：専門家レベルの協議で進展あり
インドネシア島沖でマグニチュード6.3の地震が発生	タイでマグニチュード6の地震が発生
米国、アフガニスタン政府、タリバンとの和平協議を開催へ	パキスタンがタリバンとの直接会談を実施
テロリズムとイスラエル・パレスチナ紛争のニュース（January 22 ' äď 28 , 2014 )	テロとイスラエル・パレスチナ紛争のニュース ( July 31 ' ä ď August 6 , 2013 )
「シリアへの介入は遅すぎるか早すぎるかのどちらかだ」。	国連事務総長：査察団、シリアでの調査終了に4日必要
ギリシャ警察、ドイツ人をスパイ容疑で逮捕	イスラエル報道、会談再開の代償を嘆く
イラン核交渉団、カザフスタンに向けて出発	イランの核開発には1000億ドル以上の費用がかかっている。
1月の米工場受注は0.7％減	1月のドイツ工場受注は回復傾向
カブールのホテル襲撃、9人のうち外国人4人が死亡	カブールのホテル襲撃、死者の中に外国人も
リビアの外務省を武装集団が取り囲み、要求を突きつける	リビア外務省を武装集団が取り囲み、要求を突きつける
台風による死者数が3633人に	エジプトでの死者数が638人に上る
ウガンダ大統領、反同性愛法案に署名	ウガンダの大統領、厳しい反同性愛法に署名
ロシア議会、プーチンのウクライナでの軍事利用を容認	ロシアはウクライナ南東部を編入する意図はない：FM通信
ブラッドリーマニングに敵対行為に対する無罪判決	ウィキリークス兵士ブラッドリー・マニング、敵国支援で無罪判決
G7 「ロシア制裁を強化する」。	ウクライナはロシアの侵攻を恐れている
ロックバンドの飛行機がイリノイ州に緊急着陸。	ロックバンドの飛行機がイリノイ州に緊急着陸。
ロシア首相、クリミア訪問2日目。	ロシア、シリアの前提条件設定に警告
カリフォルニアの受刑者に強制給餌することを認める判事	米判事、ハンスト中のカリフォルニア州受刑者に強制給餌を容認
ベネズエラの刑務所で暴力団が16人を殺害	ベネズエラの刑務所で16人が殺害された。
国連化学兵器専門家、シリアを訪問	米、シリアで化学兵器使用と発表
中国南部の森林火災で消防隊が出動	ホキアンガの低木の火と戦う消防士たち
アフガニスタンでの米軍死者、2,153人に	アフガニスタンでの米軍死亡者数
イスラエルとパレスチナ、月曜に再会談を求める：米政府高官	パレスチナ人：ケリー・ミッションの失敗を望んでいない。
シリア、化学兵器の放棄に合意	シリア、化学兵器を製造しない。
トロピカルストームカレンが米国メキシコ湾岸を狙う	トロピカルストームカレンが上陸する見込みです。
アイルランドの土と戦いの詩人、シーメス・ヒーニー氏死去 74歳	アイルランドの詩人でノーベル賞受賞者、シーメス・ヒーニー氏が死去、74歳
バングラデシュのイスラム教徒が、無神論者のブロガーに反対する集会を開いた。	バングラデシュのイスラム教徒が、無神論者のブロガーに対する行動を要求するために集会を開いた。
マレーシア航空MH17便のウクライナ東部における墜落事故について	マレーシア航空機がウクライナとロシアの国境で墜落。
ソマリア中央部のレストランで自爆テロ、13人が死亡	カブールで自爆テロ、少なくとも4人が死亡
アンソニー・ウィーナー、新しい世論調査で4位に後退	ニューヨーク市長選の新投票でウィーナー氏が4位に転落
インド、中国が事実上の国境を越えたと非難	上院、下院、国境資金で衝突中
クリスチャンと結婚したスーダンの妊婦に、「背教」の罪で死刑判決	スーダン、背教の罪で死刑判決を受けたクリスチャン女性を釈放
米外交官ケリー氏の妻、病院に緊急搬送	ジョン・ケリー国務長官の妻が病院に運ばれる
イラン大統領選挙でハッサン・ルーハニ氏が勝利。	マドゥロ、ベネズエラ大統領選の投票に勝利
ケリー、中東和平プロセスで「静かな戦略」を追求する	ケリー氏、中東和平を推進するためイスラエル指導者と会談
北朝鮮、原子炉の再稼働を表明	北朝鮮が会談を提案：複合施設再稼働の可能性
エジプト裁判所、ムバラクの釈放を検討	エジプト裁判所、ムバラクの釈放を命令
アフガンの首都で自爆テロ、8人死亡・13人負傷-警察	シリアの旧市街で自爆テロ、4人が死亡
ボストン爆発事件の容疑者が病院のベッドで起訴されました。	1週間後：ボストン、爆破事件の犠牲者を追悼 容疑者、言葉失う
インドの洪水救援にさらなる雨を	インド北部で米国人観光客が集団強姦される : 警察
東アフリカの主なテロ攻撃について	国連安全保障理事会、ケニアの首都で発生したテロ攻撃を非難
ロシア、ウクライナ停戦に応じる	キプロス、ウクライナの資産を調査
赤シャツ隊長、軍隊に反対しないよう呼びかけ	オイルリグ・スパット：北京、軍を派遣せず
金正恩が「犬より悪い」叔父を処刑した。	北朝鮮、キム・ジョンウン氏の叔父を処刑
ワールドカップブラジル大会での色とりどりの応援。	メルケル首相、ワールドカップ決勝戦に出席へ
ロシア、ウクライナへの権利支援案を評価	ロシア、モスクワでイスラム過激派の容疑者を拘束
ファタハ、イスラエルを承認しないことを支持	パキスタンは今回の無人機攻撃を非難している。
アフガニスタンでの攻撃で12人が死亡	NATO : アフガニスタンの攻撃で3人の兵士が死亡
マンデラ氏、入院中	マンデラ氏は依然として「集中治療室」にいる
韓国フェリー乗組員の公判が開かれる	セウォル号フェリー乗組員、裁判を受ける
ゲルググ首相の盟友が大統領に-出口調査	ジョージア州の億万長者首相の味方が大統領に-撤退世論調査
エジプト、新憲法を採決	エジプト人による新憲法に関する投票
米無人機攻撃、パキスタンで6人死亡 公式サイト	米軍の無人偵察機、パキスタンで武装勢力4人を殺害
ベトナム、行方不明機からの信号を検出	中国、行方不明機の捜索範囲を拡大
クリケット-イングランド対オーストラリア 第4テストスコアボード	クリケット-イングランド 155-4 vs オーストラリア , 第4テスト - ティー
ペルーでDprkの誕生日を祝う会	キュリオシティ・ローバーが火星着陸1周年を迎える
INDIA INK : 今日の一枚 : 5月21日	INDIA INK : 今日の一枚 : 1月16日
オーストラリア首脳陣が突然の首脳投票で追放された。	ギラード首相、指導者投票で失脚
オバマ大統領、エジプトでの暴動を非難、軍事演習を中止	パキスタンはエジプトでの暴力を非難する
アルゼンチン、洪水被害者のために喪に服すことを宣言	ペアレンツデマンド 保育園入園共通フォーム
インドで食中毒、少なくとも20人の子供が死亡	バグダッドのカフェで爆弾テロ、少なくとも38人が死亡
王子の洗礼式、古さと新しさが融合	ジョージ王子の洗礼式はいつ？ 洗礼式プラン、ロイヤルベビーの名付け親とすべての詳細。
新聞に書いてあること、5月20日、2013年	各紙が伝えていること , 11月 19 , 2013
Google、Kit Kat搭載の携帯電話「nexus 5」を発売	グーグル、PCでの検索結果を再設計
ヒズボラを狙った爆撃がベイルート南部を襲う	ベイルート南方のヒズボラ地区で爆発が発生
米国と同盟国、ウクライナ問題でロシアへの制裁を追加へ	EU、ウクライナ問題でロシアに新たな制裁を発動
イラクの首都で自動車爆弾、少なくとも16人が死亡	バグダッドで自動車爆弾、少なくとも47人が死亡
韓国との協力で成り立っていた工場が沈黙する	南北朝鮮、会談で沈黙を破る
中国首相、インド副大統領と会談	ヒズボラ、レバノン新大統領の選出を要請
サウジアラビア、国連安全保障理事会に席を確保	サウジアラビア、国連安全保障理事会の議席を拒否
アルジェリア大統領、検査のためフランスへ	アルジェリア大統領、軽い脳卒中の後、検査のためフランスへ
ケニアのショッピングモールでイスラム教徒が人質30人を拘束中	ケニア・モール包囲で死者数が増加
マンチェスター・シティ、3年ぶり2度目のプレミアリーグ優勝	マンチェスター・シティがプレミアリーグのタイトルを獲得。
米無人機攻撃、パキスタンで11人死亡	米無人偵察機、パキスタンで16人を殺害
MH17の犠牲者の遺体はオランダに搬送された。	MH17の死者はオランダに空輸されました。
エジプト、シナイ半島の攻撃で警察官を殺害	エジプト兵、シナイ半島の攻撃で死亡
イラン核協議の延長の可能性	イラン核協議前に原油が108ドルを割り込む
ロシアの精神科施設で火災、38人が死亡	ロシアの精神病院火災、38人死亡のおそれ
ロシア、国連軍縮条約に署名しない可能性を警告	国連、画期的な兵器禁止条約に迫る
シリアに関するディディエ・レインダースの発言	オバマの一日：シリアに関するプライムタイム
北朝鮮：専門家は対話を呼びかけ、中国が役割を果たすべきと指摘	北朝鮮は共同工業団地を禁止し、南との最後の関係を断つ
月曜の中国株は高く始まる	中国株、木曜日は安値引け
ソニー「Xperia Z2」、ノキア「Xシリーズ」を発表	イタリア、ベルルスコーニ氏の政治活動禁止を命じる判決
新型コロナウイルスは、おそらく人から人へ感染する可能性があります。	who : 新型ウィルスは人から人へ感染する可能性があります。
マンデラ氏、病院に戻る 「深刻だが安定している」状態	ネルソン・マンデラ氏、病院に戻る 「深刻だが安定している」状態
イーストハーレム爆発事故の死者数が増加	メキシコの暴風雨による死者数は増加の一途をたどっている
ウクライナ首相、抗議デモで辞任	英首相、10代の若者殺害事件を非難
ロイヤルデマのDJが局を相手にアクションを起こす	タリバン、アフガニスタンの米軍基地を爆撃
アーセナル vs ストーク・シティ」ライブ中継!	トッテナム対マンチェスター・シティ」ライブ中継
ビジネスニュース＆マーケット : 2013年4月17日の出来事	ビジネスニュース＆マーケット : 2013年6月20日の出来事
トラに襲われた動物園の職員が死亡	ニュージーランド在住のインド人教師が襲撃され死亡
イラン、世界大国と新たな核協議を開始	イラン、世界大国が新たな核協議を約束
トロピカルストームカレンが米国メキシコ湾岸を狙う	熱帯性暴風雨カレンは、米国メキシコ湾岸に近づくと弱まる。
インドのビル崩壊で労働者が死亡	バングラデシュのビル崩壊で76人が死亡
NWAZIRISTERNでドローンによる空爆を受け、6人が死亡。	パキスタンでバス事故、12人死亡
パキスタンの基地で爆弾テロ、20人死亡	パキスタン西部の爆弾テロで兵士8人が死亡
北朝鮮が短距離ミサイル3発を発射	韓国が短距離ミサイルを発射
パキスタンのバス爆破事件で政府職員17人が死亡	パキスタンの教会で爆弾テロ、少なくとも78人が死亡
パキスタン北西部で自動車爆弾、37人が死亡	パキスタン北西部で爆弾により3人が死亡
マレーシア航空、北京行き239人乗りの航空機と連絡が取れなくなる。	マレーシア航空、北京行きの飛行機が消息を絶つ
マイクロソフト、最大18,000人の雇用を削減と発表	マイクロソフトが18,000人の人員削減を実施
マレーシアの人々は、安定か変化を求めて世論調査を行う。	マレーシアの選挙：初めて権力を賭けて投票するマレーシア人
火事で中国の古いチベットの町が破壊された。	火事で中国のチベットの町が破壊された。
ヤフー、タンブラーを現金11億ドルで買収することに合意	ヤフー、タンブラーを11億ドルで買収へ
インド、世界最大の選挙で投票開始	インドの有権者、世界最大の選挙を開始
シリア北部の自動車爆弾、少なくとも12人が死亡	シリアの空爆、アレッポで少なくとも18人死亡
フィリピン地震、死者73人に	フィリピンの地震による死者数が85人に増加
深セン市の株価指数が月曜日は高くなる。	深セン市の株価指数が下落 -- 10月31日
行方不明の亡命者の捜索終了	行方不明者の捜索範囲を狭める
ウクライナ大統領、東部での7日間の停戦を命令	ウガンダのムセベニ大統領、反同性愛者法案への署名に合意
ワシントンD.C.で少なくとも12人が死亡...	バロチスタン南西部で強い地震が発生し、少なくとも150人が死亡。
ICCチャンピオンズ・トロフィー：インド対南アフリ カ	チャンピオンズ・トロフィー：インド対南アフリカ
最高裁、ミシガン州でのアファーマティブ・アクションの禁止に関する裁判を扱う	最高裁、ミシガン州アファーマティブ・アクションの裁判を審理へ
9月30日付イラン主要紙の見出し	21日付イラン主要紙見出し
サイクロンがインドに破壊の跡を残す	サイクロンファイリンの避難がインドの村人の命を救った
タリバン、西アフガニスタンで警官15人を殺害	米無人偵察機、アフガニスタン東部で2人を殺害
チュニジア政府を支援するため、何千人もの人々が結集。	チュニジアのイスラム主義政権を支持するため、数千人が集まる。
ハリー王子、米軍戦没者に追悼の意を表す	米大統領、マンデラ氏に賛辞を送る
南アフリカのマンデラ氏、病院に搬送される	ネルソン・マンデラ氏が病院に搬送される
ボストン・マラソンのゴール付近で2つの爆発が発生。	ボストン・マラソンのゴール地点で2つの爆発があった。
エジプト南部で衝突、少なくとも2人死亡	北コーカサス鉄道駅の爆発で少なくとも18人死亡
冬の嵐イオン: 州別...	ウィンターストーム・ジャヌス：州別情報
バグダッド南方で53人の死体が発見された。	イラク当局：バグダッド南方で50人の遺体発見
バグダッドのキリスト教地区で爆弾テロ、20人が死亡	バグダッドのキリスト教地区で35人が死亡。
中国、Bo xilaiの公判日を決定	中国・坊小蕾裁判、4日目に突入
イスラム教徒はラマダン開始の準備をする	ムスリムたちは、分裂の終結を祈っている。
日本、ロシア軍機に対してジェット機を発進させる	分離主義者がウクライナ軍機を墜落させ、数名が死亡。
ドイツで数千人の英国人が生活保護受給を申請	数千人の白衣のアムステルダム市民がMH17のためにデモ行進
パキスタンで米軍の無人機による空爆の疑い、5人死亡	米軍無人偵察機、パキスタンのイスラム神学校を標的にした疑い
オバマ大統領、オバマケアに署名へ	オバマ大統領、竜巻の被害を受けたオクラホマ州を訪問
イラク攻撃で15人死亡、サッカー場で爆弾か	イラクの電撃攻撃で46人が死亡
ゼネラル・エレクトリック、第3四半期は9％の減益	GE、第3四半期は9％の減益
中国人民元、対米ドルで6.1535まで軟化	中国人民元が対米ドルで高値更新
イスラエルがシリアを爆撃、特使が和平交渉に向け圧力をかける	シリア東部で激しい衝突、米国が和平交渉を後押し
ロシア、死去した弁護士マグニツキーに有罪判決 遺族裁判で	ロシア、死去したマグニツキー弁護士を死後裁判で有罪に
「トレイヴォンは私だったかもしれない	トレイボン・マーティンは...
ミャンマー、宗派間暴力で44人を逮捕	禁止令、シリア攻撃は宗派間暴力を悪化させると警告
米国、ロシア、シリア協議3日目に突入	米露、ジュネーブでシリアの武器取引に合意
ケリー国務長官、パレスチナ人受刑者103人の釈放を求める会談再開構想を発表	ケリープランに囚人解放、和解凍結を盛り込む
警察 : ベルファスト大聖堂地区で爆発が発生	カブールで爆発、外交区域で自爆攻撃
シリア人がパリでエルドアンに抗議、ベネズエラ人はシリアへの支援を強調	トルコのエルドアン大統領、シリア問題で分裂したイランとの関係修復のために来日
首相、日本訪問中に核取引と投資を求める	マンモハン首相、日本との原子力協定締結に期待
米、ミサイル発射実験を延期 北朝鮮情勢の緊迫化で	北朝鮮に駐在する大使館は、緊張にもかかわらず、そのままである。
オバマ大統領、ネルソン・マンデラ氏の遺族と個人的に面会へ	オバマ大統領、マンデラ一家と会談へ
アメリカでの銃乱射事件で少なくとも6人が死亡	ソマリアでの攻撃で少なくとも20人が死亡
フィリピンの政変で武装集団が10人を殺害	フィリピンの火山噴火で5人死亡
イスラエルがレバノンから無人機を撃墜	イスラエルがレバノンからの無人機を撃墜
イラン政府高官：米国によるイラン特使のビザ発給拒否は、核協議に影響なし	イランの交渉担当者、最新の核協議に明るい表情
イスラエル、和平交渉に先立ち、パレスチナ人囚人の第一陣の解放を承認	シリアの野党、和平交渉への参加を確認
エジプト建国記念日での大規模な衝突	エジプト蜂起記念日に激しい衝突が発生
オーストラリア、過去最低の金利に引き下げ	オーストラリア、過去最低の金利に引き下げ
NATO : アフガニスタン南部で5人のアメリカ人が殺害された。	アフガニスタン南部で路側爆弾、警官3人が死亡
クリーブランド誘拐犯アリエル・カストロが独房で首を吊った状態で発見された。	クリーブランド誘拐犯アリエル・カストロが独房で首を吊っているのが発見された。
シリアの野党統一は、崩壊の危機に直面している。	シリアの分断された野党の闘争は、より広いシリアの闘争の中にある
グーグル、自動運転車のプロトタイプを公開	グーグル、自動運転車のコンセプトカーを公開
バングラデシュの衣料品工場で火災、8人死亡	バングラデシュの衣料品工場が崩壊、149人が死亡
米国、イランとの取引で警戒する湾岸諸国を安心させるよう努める	ヘーゲル、イランでの合意後、不安な湾岸諸国を安心させるよう努める
ウクライナ、「統一会見」を開催	ローマ法王、シリアでの「武器を売るための戦争」を非難
政府、団体から台風被害救済のために数百万ドルの寄付を約束	カナダ、台風被害救援に500万ドルを約束
ギリシャ、国営放送を停波	ギリシャ、経費節減のため国営放送局を閉鎖へ
パキスタンのムシャラフ、ブット暗殺で逮捕される	パキスタンのムシャラフ大統領、法廷に初登庁
エジプト・ムスリム同胞団長の公判期日が決定	シリアのムスリム同胞団、苦戦を強いられる
グアテマラ裁判所、元独裁者に大量虐殺の有罪判決	グアテマラの前指導者に大量虐殺の有罪判決
レッサーパンダ、動物園から短時間で脱走	インド、火星への行進
イスラエル人医師、パレスチナ人囚人への強制給餌で外国で裁かれる可能性	イスラエルの西岸支配は、パレスチナ経済に何十億もの損失を与えている。
ワシントンのマリファナショップは歴史的なセールスを準備中	ワシントンのマリファナショップは歴史的なセールスを準備中
リオの空港職員、FIFAワールドカップ前夜にストライキを実施	リオデジャネイロの空港職員がワールドカップ前夜にストライキを実施
ケニアのショッピングモールでの殺傷事件で、国際的な科学捜査チームが調査に参加	逮捕された英国人、ケニア攻撃捜査に重要ではない
ムスリム兄弟団トップの息子が殺害される	エジプト、ムスリム兄弟団リーダーのバディを逮捕
イラン、世界6カ国と画期的な核取引に調印	イラン、世界6カ国と画期的な核取引に成功
ヴァージニア州で熱気球が炎上	熱気球が「火事で墜落」。
マンデラ氏追悼式での指導者、家族の言葉	マンデラ氏追悼に世界が一致団結
ムンバイ・インディアンズがT＆Tに対抗	インドネシア、大統領選で大接戦
各紙が伝えていること , 11月 20, 2013	新聞に書いてあること、10月10日、2013年
amazon、ストリーミングビデオ用の新デバイスを発表	アマゾン、新型ストリーミングビデオボックス「Fire TV」を発表
パレスチナ大統領、ヨルダン外相を表敬訪問	パレスチナ人、少女へのセクハラで逮捕
オバマ大統領、新運輸長官を指名	オバマ大統領、失意の退役軍人長官と面会へ
中国人民元、対米ドルで6.1059元まで軟化	中国人民元、対米ドルで6.1070まで上昇（金曜日
フランス人が緊縮財政のためにワインセラーを手入れするオークション	米国、ウクライナとの協定を評価し、具体的な行動を呼びかけ
オバマ大統領、イラン国連特使の入国拒否を目的とした法律に署名	オバマ大統領、イランへの新たな制裁を行わないよう要請
米国とロシア、シリアの化学兵器押収に合意	シリアの反政府勢力、化学兵器取引に懐疑的
フロリダで殴られた若者がイスラエルで解放される	パレスチナの若者がイスラエルの銃撃による傷で死亡
韓国下院議員、開城団を視察	韓国、北朝鮮に閉鎖工場に関する協議を要求
アルジェリア人神父、北アフリカのキリスト教の遺産について講演	テルストラ、ニューヨークで中国サイトのリストアップを申請
4月5日付イラン主要紙の見出し	8月18日付イラン主要紙主筆の見出し
パレスチナの和解の意味	ベルギー国王、退位説の中、国民に演説
ロシアの精神病院で火災、38人が死亡	ロシアの精神病院火災、38人死亡のおそれ
ハイジャック犯、ジュネーブ空港に着陸後、逮捕。	ハイジャック機がジュネーブに着陸
PKB、ワッカー・ユーニス氏をヘッドコーチに任命	ワカル・ユーニス、パキスタンの監督に復帰
米国、シリアに対する行動の必要性を訴える	サウジ、イスラエルのシリア攻撃に対し国連に行動を要請
アンカラのデモ隊が警察と衝突	ペルーデモ隊と警察との衝突
韓国との関係改善を求める北朝鮮指導者	北朝鮮、外国人に南朝鮮からの出国を促す
イラクの暴力的な攻撃で49人が死亡、148人が負傷。	イラクで新たな攻撃があり、15人が死亡、90人が負傷した。
イラン、6カ国による専門家会合を再開へ	イラン、「有益な」専門家レベルの核協議に明るい兆し
プエルトリコ人、児童ポルノ制作で逮捕	インドの教祖が強姦の疑いで逮捕される
ウクライナ、EU通商協定に調印 ロシアがクリミア編入を最終決定	ウクライナ最高裁判所、クリミア独立を「違憲」と断じる
バングラデシュの崩壊、捜索終了、死者数1,127人	バングラデシュの崩壊による死者数が620人を超える
ウクライナ危機について中露のFMが意見交換	中国国家主席、アルゼンチン訪問のため到着
アサド大統領はトルコに対し、シリアの反政府勢力を支援したことによる「重い代償」を警告している。	シリア反体制派への武装をめぐり、内閣が対立している。
インド株 安値引け	香港の株価は2.33％高で終了
イラクの暴力的攻撃で19人が死亡、42人が負傷。	イラクの攻撃で43人が死亡、86人が負傷。
インド強姦罪の判決	インド人強姦致死傷者の有罪が確定
世論調査 : コーリー・ブッカー、ニューヨーク州上院選で早くもリードを奪う	ニジェラ・ローソン「10年間毎日コカインを摂取していた」。
イラン核協議で合意	イラン核取引、数十年にわたる論争の末に成立
エジプト軍報道官、軍への扇動行為を糾弾	月内労働省発表
スノーデン氏は、私たちの公正な裁判に「チャンスはない」と考えている。	スノーデン氏は、米国で公正な裁判を受けるチャンスは「ない」と考えている。
12月30日付イラン主要紙見出し	7月6日付イラン主要紙主筆の見出し
コネチカットの列車衝突事故、数十人が負傷	インディアンの大臣が正面衝突で死亡
インドの列車で爆発、1人死亡	州：暴力を扇動するイシバに資金を提供しない。
英国女王、新王子を訪問	英国王室、新生児王子に会う
ウクライナ：議会抗議デモで3人死亡	ウクライナ大統領、抗議活動終結に向けた協議を呼びかけ
N.C.フェアの事故でライドオペレーターが起訴される	N.C.ステートフェアのライドオペレーターが事故後逮捕される
韓国フェリー避難をめぐる混乱が明らかになった記録	フェリー避難をめぐる混乱が明らかになった記録
消防士が帰還	ウォール街は小幅安で終了
シリア政権、和平会議への出席に合意	ロシア : シリアは会議への参加に同意した
UKの投票で軍事行動が拒否される	英国、シリアの軍事行動を拒否
ニュージーランド、同性婚を合法化へ	ニュージーランド、同性婚の合法化を決議
シンガポール株は0.37%上昇で終了	シンガポール株式は0.41％高で終了
ベネズエラ大統領、中国を訪問へ	セネガル大統領、中国訪問へ
カイロのデモ隊は弾圧の脅威を拒む	カイロのキャンプで、抗議者たちは、掘って、生きている。
行方不明機の捜索はベトナムの島々へ	行方不明のマレーシア航空機がベトナム沖で墜落した。
イランが石油価格戦争の引き金を引くと脅す	男はハリー王子を殺すと脅迫したことを認めている
マレーシア航空、行方不明者の親族に捜索の進捗状況を報告	マレーシア航空、行方不明便の副操縦士を調査中
スターたちがコーリー・モンテイスに敬意を表する	ジェームズ・ガーナーに敬意を表するスターたち
マンチェスター・ユナイテッド チケット売上・利益ともに減少	マンチェスター・ユナイテッドのオーナー、マルコム・グレイザー氏が死去、享年85歳
ロサンゼルス空港職員、9/11脅迫で起訴	ロサンゼルス空港の職員が9/11の脅迫で起訴される
ザ・ノート 2013年5月24日（金）の必読記事	ザ・ノート 2013年8月23日（金）の必読記事
クリスティアーノ・ロナウドがハットトリックを達成し、ポルトガルが2014年ワールドカップ決勝トーナメント進出を決めました。	ロナウドがハットトリックを達成し、ポルトガルがワールドカップ出場を決めました。
ネイマール、ブラジルをベスト16に導く	ネイマール、ブラジルをワールドカップ・ベスト16に導く
ウクライナ、一方的な停戦を実施へ	ウクライナ、一方的な停戦を申し出る
英国王室のフィリップ王子が「試験的」手術に臨む	英国フィリップ王子が入院
日本、消費税のヒアリングを開始、元銀行副総裁が段階的な引き上げを要請	日本、消費税増税の公聴会を開始
3回の爆弾テロで兵士6人、市民1人が死亡。	タイ南部で学校爆弾テロ、2人死亡
ストーン、2度目のハイドパーク公演を追加	ローリングストーンズ、2度目のハイドパーク公演を追加
イタリア巡礼者、バス転落で死亡	イタリア・バス転落事故、乗客死亡
各紙に掲載された内容、2013年8月19日付	新聞に書いてあること , 12月30日 , 2013
ヘイズに関する5カ国の会議	プーチンの結婚に終わりを告げる
パキスタン地方で新たな強い地震が発生	パキスタンで新たな地震が発生。
シリア反体制派、アサド大統領にラマダン期間中の停戦を提案	シリア反体制派、アサド政権にラマダン期間中の停戦を提案
ソマリアでの攻撃で少なくとも20人が死亡	イラクの刑務所襲撃で少なくとも60人が死亡
ウエストゲートモール襲撃犯、ナイロビで4カ月計画	ウェストゲート襲撃犯はナイロビで4ヶ月間計画を練っていた、と当局が発表。
国連安全保障理事会、ガザでの人道的停戦を要請	国連安全保障理事会、ガザでの無条件停戦を要求
本州でマグニチュード6.3の地震が発生 : CENC	台湾でマグニチュード6.7の地震が発生 : CENC
火曜の中国株は高値引け	水曜日の中国株は安くなる
イラクの首都で自動車爆弾、58人が死亡	イラクの首都で自動車爆弾テロ、13人の市民が死亡
外資系企業、新たな「開放」に注目	中国でのキャリアが増える可能性が高い
ウクライナのデモ隊が反政府集会のため路上に復帰	ウクライナのデモ隊がキエフのレーニン像を倒した。
カナダの貨物列車爆発、死者3人に、さらに増加へ	カナダ政府 ' 監視 ' 列車爆破の状況
米国のファーストフード店労働者が最低賃金をめぐって全国的なストライキを計画	ファストフードの従業員が賃上げを要求してストライキ
ナイジェル・ファラージ、シリア難民を英国に受け入れるよう政府に要請	シリア難民を英国に再定住させる計画はない」。
イスラエルのペレス大統領、和平交渉への復帰を要請	ゴンザルベス、ドメスティックレップへのプレッシャーをかけ続ける
パキスタン陸軍の新司令官、ラヒール・シャリフに注目が集まっている。	フランスで河川水位が上昇し、洪水警報が発令されました。
火曜日、中国人民元は対米ドルで6.1184まで上昇	中国人民元が対米ドルで6.1510まで弱くなる
ラジオ : イスラエル、パレスチナの囚人解放を拡大へ	米国：イスラエルはパレスチナの囚人の解放を延期せよ
モルシ支持者が計画を拒否	エジプトでモルシ支持者がデモ行進
エジプト裁判所、同胞団支持者10人に死刑判決-関係筋	トルコ首相、支持者に集会の準備を指示
オバマ大統領、イスラエルの10代の若者3人の殺害を非難	西岸で行方不明のイスラエル人少年たちの遺体を発見
ロンドンの路上で兵士の首をはねようとした男たち、法廷で目撃される	オーストラリアがインドネシア大統領をスパイしていたとの報道
ウクライナのデモ隊がバリケードを再構築	プーチン大統領、ウクライナについて演説 抗議デモ隊はバリケードを再構築
メル・スミス氏が60歳で死去、英国の人気コメディー作家に追悼の意	グリフ・リース・ジョーンズ：メル・スミスは「生きるための力」だった。
ニューヨークのビルが崩壊し、3人が死亡、63人が負傷。	フランスのビル崩壊で2人死亡、9人負傷
火曜の中国株は高値引け	木曜日、中国株は安値引け
INDIA INK : 今日の一枚 : 7月2日	INDIA INK : 今日の一枚 : 3月4日
アフガニスタンで14人が死亡、アジアのイスラム教徒がイードを祝う	パキスタンとアフガニスタンで52人が死亡し、アジアのイスラム教徒がイードを祝う。
リビアのベンガジでスウェーデン領事館に自動車爆弾、死傷者なし	ベンガジのスウェーデン領事館に自動車爆弾が直撃、けが人なし
ロシアの炭鉱は中国に新たな販路を求める	ロシア外相、国連総長と会談へ
ウクライナ、親ロシア派が自治権拡大を要求	スーダンのデモ隊が政権退陣を要求
イラク軍、ティクリート奪還に向けて闘う	イラク軍、ティクリートで勝利を宣言
イラン、イスラエルによるシリア空爆の疑惑を非難	民主党、シリア攻撃をめぐり分裂か
イスラエル、ガザ休戦の4時間延長に合意	イスラエル、ハマスが12時間の停戦に合意したと報道される。
韓国のバスターミナルで火災、5人死亡	韓国のバスターミナルで火災、7人が死亡
パキスタン軍司令部付近を爆撃	パキスタンのレストランで爆弾テロ、15人が負傷
アフガニスタンで民間人4人、NATO軍兵士3人が殺害された。	アフガニスタンで3人のNATO軍兵士が殺害された。
メキシコのキャンディー工場で爆発、1人死亡、40人負傷	2件の交通事故で3人死亡、21人負傷
デモ隊は革命を取り戻すために通りをうめつくした	エジプト : デモ隊がムスリム兄弟団の本部を襲撃
東京株式、0.24％下落でスタート	東京株式、0.52％上昇でスタート
オーストラリア、スリランカに亡命者を海上輸送で返還	オーストラリア : オーストラリア、スリランカに亡命者を戻す
Shankill blast victims to be remembered	ワニの犠牲者の遺体を回収
ナイジェリアでの爆発で118人が死亡	ロシアで新たな爆発があり、10人が死亡
gleeのスター、コーリー・モンティスがカナダのホテルの部屋で死んでいるのが発見されました。	グリー」のスター、コーリー・モンティスの死体が発見されました。
クロアチア、歴史的なEU加盟へのカウントダウンを開始	クロアチア、EU加盟へカウントダウン
ヨランダの死者数、3,621人に上る	ケニア赤十字、死者数68人に
東京株式、0.13％高で終了	東京株式、0.75％安で終了
イラン、新たな核協議に応じる用意があると発言	イランのハメネイ師、核協議への支持を改めて表明
トルコで警察とデモ隊の衝突が続く	トルコ警察がデモ隊と戦い、広場を確保。
医療カードを拒否された方は、HSEに連絡するようお願いします。	メディカルカード計画を擁護するHSEボス
中国西部に世界最大のビルがオープン	イタリア、大統領選で中道左派が分裂
ハスーン、モーリタニア代表団に「シリアに課された陰謀は、特にパレスチナをめぐる姿勢をターゲットにしている」と発言	ムフティ：シリアに対する陰謀は、特にパレスチナに対する姿勢を対象としている。
イスラエル人、西岸で投石を受け軽傷	イスラエル軍、ウェストバンクの襲撃でパレスチナ人を殺害
エジプト・デモの死者数が49人に	エジプトでの暴力による死者数は638人に上る
香港で民主化運動が行われる	香港で大規模な民主化集会が開催されます。
米上院、イエレン氏を連邦準備制度理事会議長に選出	米上院、新中央銀行総裁にジャネット・イエレンを選出
シリアの野党、画期的な和平交渉に合意	シリアの野党が協議に参加するよう迫られている
バグダッドで自爆攻撃、8人死亡	バグダッドで自爆攻撃、24人が死亡
貧困統計はモディの開発主張を疑う	GM、リコール補償の請求受付を8月1日より開始
ウクライナで親ロシア派の反政府勢力が投票を実施へ	シリア反乱軍：レバノンでヒズボラ兵を殺害した。
ジョージア人による新大統領の投票	ジョージア州の億万長者首相の味方が大統領に-撤退世論調査
米国でMERSの呼吸器疾患が発見されたことを当局が確認	サーズ様呼吸器疾患（MERS）の最初の患者が北米で報告される。
戦犯と英雄について：アリエル・シャロンのホワイトウォッシュ（白塗り） ä	戦犯と英雄について：アリエル・シャロンのホワイトウォッシング
オバマ大統領、6月7-8日にカリフォルニアで中国・習近平と会談へ	オバマ大統領、ホワイトハウスでウクライナ首相と会談
EU、ヒズボラ軍事部門をテロ集団と認定	EU、ヒズボラ軍事部門をテロリスト入りさせる
ロジャースとビデオトロンはネットワーク共有の契約を締結しました。	ロジャース、ビデオトロン・リーチ・ネットワークシェアリング、スペクトラム契約
ナイジェリアの首都で、誘拐された少女たちのための抗議活動が禁止された。	ナイジェリアのボコ・ハラムの襲撃で数人が殺害された。
ドイツ、イラン核合意を歓迎	シリア、イランの核合意を歓迎
マレーシアの飛行機事故で著名なエイズ研究者が死亡	エイズ研究トップがマレーシアの飛行機で墜落死
新聞に書いてあること、6月25日、2013年	各紙に掲載された内容、2013年8月19日付
パキスタンで武装集団が外国人9人を殺害	パキスタンで武装集団が観光客9人を殺害
中国に取り残されたインド人貿易商2名が帰国	イラクに取り残されたインド人看護師46人が帰国
カリフォルニア州知事、干ばつによる緊急事態を宣言	カリフォルニア州知事、山火事が続く中、干ばつによる緊急事態を宣言
イスラエル政府高官、パレスチナ人との和平交渉は数カ月かかると指摘	イスラエルの空襲でパレスチナの3歳の少女が死亡
17 : 02 イラクの自動車爆弾テロで23人死亡	シリアの爆撃で11人の子供が死亡
中国人民元、対米ドルで6.1559元まで下落	火曜日、中国人民元は対米ドルで6.1818まで弱くなる。
ムンバイのビル崩壊で2人が死亡、さらに多くの人が閉じ込められている。	ビルが倒壊し、2人が閉じ込められる
シリア北部で空爆、数十人死亡	ウクライナはクリミア問題で一歩も譲らない
イスラエルとパレスチナ、前向きな会談の後、「最終的な」和平交渉に臨む	イスラエル軍、ウェストバンクの衝突でパレスチナ人武装勢力3人を殺害
中国旅行者、マレーシアで拉致される	中国、ベトナムから拉致した子どもたち10人を帰国させる
日本の政治家、セックス発言で謝罪	日本の市長は米国に謝罪し、「慰安婦」についての間違った言葉を否定した。
イラクの攻撃で4人死亡、6人負傷	イラクの攻撃で43人が死亡、86人が負傷。
国連査察団、シリアの化学兵器に関する進展に期待	米国はシリアが化学兵器を使用したと結論づけていない-ホワイトハウス
ニゲル・ファラージに対する抗議行動で2名の逮捕者が出た。	ケリー氏、中東への集中出張を終え、前進を誓う
ガンマン、リビア兵15人を殺害	シリア近郊で武装集団がレバノン軍3人を殺害
コスタ・コンコルディアの操業完了の写真	コスタ・コンコルディア操業のタイムラプス
イラン核協議、3日目に突入	イラン核協議、3日目に突入
譲歩にもかかわらずブラジルに集まった抗議者たち	利権がらみの抗議がブラジルを覆う
ラッド首相、9月7日の選挙を呼びかけ	ラッド首相、9月7日の世論調査を呼びかけ7日投票
イラン核協議、今週中に再開の見込み	英国：イラン核協議は重大な局面を迎えている
タイ選挙前日のバンコクが緊迫	バングラデシュ：選挙を前に弾圧がエスカレート
イスラエル軍、パレスチナの武装勢力2人を殺害	イスラエル軍、パレスチナ人武装勢力を襲撃で殺害
中国 ' ėwill protect interests ' äô of foreign business	オバマ大統領、ウクライナでプーチンと「直接対決」。
台風の影響による死者数は17人に上る。	パキスタンの洪水、死者84人に
D.C.、マリファナの非犯罪化を決議	ワシントンDC、マリファナ非犯罪化へ投票
豪州沖で亡命船が沈没し、多数の死者が出ている。	マンデラ氏、入院3日目を迎える
北朝鮮、キム氏が有力な叔父の処刑を歓迎	北朝鮮の謀略：権力の行使
マーガレット・サッチャー、脳卒中のため死去	マーガレット・サッチャー、87歳で死去
中国国家主席がオランダに到着、国賓訪問と核サミットのため	中国国家主席、ベネズエラに到着、公式訪問のため
イスラエル、和平交渉に新たな打撃を与えるためパレスチナ人を制裁	イスラエル、和平交渉再開に向け、パレスチナ人囚人を解放へ
エジプトでスカイニュースのカメラマンが殺害される。	エジプトでスカイニュースのカメラマンが殺害される
緊迫するウクライナの首都で、抗議デモが続いている。	ウクライナの首都で抗議デモが続く
かぶがあがる	株は序盤に高くなる
FBIの音声専門家がジマーマン裁判で証言	ジマーマン裁判の陪審員選定が始まる
イラン核協議、11月まで延長へ	イラン核協議、11月24日まで延長
フランス人ジャーナリスト2名がマリで誘拐され死亡	マリ北部でフランス人ジャーナリスト2人が誘拐され、殺害された。
12月14日付イラン主要紙主筆の見出し	7月29日付イラン主要紙主筆の見出し
ボストン爆破事件の容疑者、出廷へ	ボストン爆破事件の容疑者を埋葬
イラン、シリアへの戦争の波及を警告	イラン代表団がレバノン、シリアに向かう
インドのビル倒壊、死者42人に	インドの建物崩壊による死者数が25人に
オバマ大統領、双子の製造拠点設立を発表	米国株、製造業データで後退
5人をテロ行為で起訴	テロ行為で5人を起訴
オバマ大統領、2016年までにアフガニスタンから軍を撤退させる計画を明らかにした。	米国政府閉鎖：オバマ大統領は共和党に対し、協議を望むなら米国経済への脅威を取り除くよう指示。
米国とNATOは、ロシアがウクライナ国境から引き揚げたことに疑問を呈した。	ロシアがウクライナ国境から撤退する兆候はない、と当局者が述べた。
前パキスタン大統領ペルベス・ムシャラフが再び逮捕される	元パキスタン軍司令官ペルベス・ムシャラフ氏の保釈が認められる
FTSEマレーシア取引所の最新情報です。11時30分	マレーシアのFTSE取引所の最新情報です。午後3時
グラスゴーのヘリコプター墜落事故、捜索終了	グラスゴー・ヘリコプター墜落事故：女性PCが犠牲者に
イラン、シリア紛争に関する会談の提案を支持	イラン、イスラエルがロケット弾について嘘をついていると発言
米無人機攻撃、パキスタンで武装勢力4人を殺害	米無人機攻撃、パキスタンで10人死亡
フィリップが11日ぶりに退院	マンデラ氏、10日ぶりに病院を離れる
骨片「キング・アルフレッドの可能性あり	ウィンチェスターの遺跡はアルフレッド大王のものかもしれません。
イスラエル、パレスチナ人囚人の第2グループを解放	イスラエル、パレスチナの囚人26人を解放
タイ政府、2月2日に選挙を実施と発表	フィリピン政府、共産主義者との和平交渉は失敗と発表
JAXA｜ジャンプ中に衝突した2人のスカイダイバーが死亡	アリゾナでジャンプ中に衝突し、2人のスカイダイバーが死亡。
英国の元首相マーガレット・サッチャー氏、87歳で死去	マーガレット・サッチャー元英国首相が死去
アイアンマン」のジェットパック、ハワイで懸念される	アイアンマン」のジェットパックに懸念の声
イスラエル、パレスチナの囚人を解放	イスラエル、パレスチナの囚人26人を解放
フランス、シリアでの責任を回避しないと表明	フランス、シリア問題でEUに結束を促す
ボストン爆破事件の容疑者を監視カメラで確認、逮捕はせず	ボストン爆破事件の容疑者はFBIの監視下に置かれていた、と母親が語っている。
中国の北朝鮮に対する怒りは、我々に対する心配を上回る。	中国、北朝鮮への怒りが米国のステルス飛行への懸念に打ち勝つ
中国人民元が対米ドルで高値更新	中国人民元、対米ドルで6.1705元まで下落
ベルファストで若者が撃たれ、男が拘束される	男性（40）、銃撃の後、逮捕
モルディブ大統領選を警察が阻止	マリ大統領選挙でケイタが勝利
インド軍、インド統治下のカシミール地方で武装勢力3人を殺害	インド軍、インド統治下のカシミール地方で武装勢力司令官を殺害
シリア北西部で自動車爆弾、20人死亡	パキスタン北西部で自動車爆弾により40人が死亡
コロラド州知事、学校銃乱射事件の被害者を見舞う	コロラド州知事、学校銃乱射事件の被害者を見舞う
イラン、東側諸国との石油スワップを拡大	イラン、外交官の早期解放を要請
トルコ大統領、沈静化を訴える	テキサス州議会、人工妊娠中絶法を暫定的に承認
北朝鮮がミサイル30発を海に向けて発射実験	韓国、海へ砲弾100発を発射
ドニゴール州の住宅火災で男性が死亡	コークの住宅火災で女性が死亡
ドーハのガス爆発、12人が死亡、数十人が負傷	シリアのミサイルで26人が死亡、うち8人は子供
ホッキョクグマのDNAが「肥満対策に役立つかもしれない」と話題に	ホッキョクグマの研究が肥満との闘いを後押しするかもしれない
ウクライナ大統領選の投票所がオープン	e.tv ガーナで最も影響力のある賞のノミネーションが開始されました。
INDIA INK : 今日の一枚 : 4月21日	INDIA INK : 今日の一枚 : 5月2日
fast & amp ; furious」のポール・ウォーカー、自動車事故で死亡	ポール・ウォーカー、死亡 : 『ワイルド・スピード』のスター、40歳、自動車事故で死亡
フランス人ジャーナリスト2人がマリで殺害される	フランス、マリで殺害された2人のフランス人ジャーナリストを確認
シリアのハマで空爆、男性1人が死亡	米無人機攻撃、パキスタンで11人死亡
パキスタンのタリバン指導者ハキムラ・メスードが無人機攻撃で殺害された。	パキスタンのタリバン、新酋長を選出、前代未聞の復讐を誓う
トルコ首相と大統領が抗議行動への対応をめぐって衝突	トルコ大統領、全国的な抗議デモの沈静化を呼びかけ
パキスタンで武装集団が観光客9人を殺害	パキスタンの遠隔地のホテルが銃撃される。
イスラエルとハマス、ガザの一時休戦を観察へ	イスラエルとハマス、一時的な停戦を受け入れる
中国、新疆ウイグル自治区で暴力事件が多発	中国のオンライン人口が6億1800万人に増加
中国での火災で120人が死亡、親族が警察ともみ合いに	中国工場で火災、119人死亡 怒る遺族が回答求める
イラン、塩素爆弾に関する主張を否定	イラン、核施設に関するMKOの主張を否定
インドの大臣夫人、不倫の噂の末に「不自然な死」を遂げる	大臣夫人の死は「不自然」である。
カロライナ州の海沿いのモーテルで銃撃、3人死亡、1人負傷	モスクワ近郊の列車衝突事故、4人死亡・30人負傷
ボストン爆破事件の容疑者の埋葬は合法と思われる。	ボストン爆弾テロ事件、最後の犠牲者が病院を去る
中国南部で道路陥没、5人死亡	02 : 中国で地震、41人の156人が死亡
南アフリカ大統領：マンデラ氏は回復している	アフガニスタン大統領、米国との協定締結を延期
世界のニュースアップデート、あなたは何を知っている必要があります。	労働省の50ポンド税率 : 知っておくべきこと
写真で見るシリア内戦	シリア内戦和平交渉、イラン招致で危機的状況に
パキスタン地方で新たな強い地震が発生	パキスタンで震度6弱の地震が発生
パキスタン北部で住宅火災が発生、7人が死亡	米無人機攻撃、パキスタン西部で8人死亡
アフガニスタン大統領選の世論調査で、アブドラがリードを広げる。	アフガニスタン大統領官邸付近で爆発音がした。
イムラン、同僚殺害をライバルになすりつける	パキスタンのイムラン氏、党員殺害でライバルを非難
バングラデシュ、工場の犠牲者を追悼	バングラデシュの工場安全協定を支持する小売業者
ナショナル・モールで放火した男が死亡した。	ナショナル・モールで男性が放火、病院に搬送される。
日本、イルカ狩りを擁護 米国の批判を受け	日本、米国からの批判を受けイルカ漁を擁護
ナイジェリアのショッピングモールが爆破され、12人が死亡。	インドの野党集会前に爆発、4人死亡
フィリピンの台風による死者数は4,460人に : 国連	フィリピンの台風による死者数が5,000人を超える。
イラクで相次ぐ攻撃、少なくとも95人が死亡	イラク北部で自爆攻撃、少なくとも12人が死亡
中国政界のトップアドバイザーがギリシャの首相と会談	中国政界のトップアドバイザーがイエメン大統領と会談
プラハの爆発でパレスチナの外交官が負傷	アパートでの爆発でパレスチナ大使が負傷
ウクライナ指導者、危機回避のための協議を約束	ウクライナ指導者、危機回避のための協議を約束
中央ヨーロッパで洪水が発生し、大惨事が続いている。	欧州の洪水は引き続き大きな被害をもたらしている。
東アジアにおける米軍のプレゼンス	ロシアの脅威を受け、NATOは軍事的プレゼンスを拡大。
米国はシリア政府が化学兵器を使用したと考えている	米国はシリアが化学兵器を使用したと疑っている
世界各国とイラン、12月30日に専門家による核協議再開へ	イラン核専門家、世界大国と来週にも協議再開へ
エジプトのムスリムブロスフッド、撤退を拒む	エジプト裁判所、ムスリム同胞団指導者に終身刑の判決
カナダのバス、列車事故で少なくとも6人死亡	パリの列車事故、少なくとも6人死亡
中国国家主席がギリシャ首相と会談、より強固なパートナーシップを呼びかけ	中国国家主席、インド副主席と会談
アストラゼネカが41億ドルを支払い、ブリストル・マイヤーズ スクイブを糖尿病治療薬提携から買収	アストラゼネカ、糖尿病治療薬のベンチャー企業であるブリストルを最大41億ドルで買収
イタリア人逃亡犯、ドミニカ共和国で逮捕	オーストラリアの砕氷船、新たな救助活動のために南極大陸東部に到着
インド、米国が来週、中国に関する協議を行う。	エジプト、来週にもIMFと融資に関する協議を行う予定
米連邦航空局、テルアビブへの米軍機の飛行禁止を解除	米連邦航空局、イスラエルへの米軍機の飛行禁止を解除
イスラエルがガザで地上攻撃を実施。	イスラエル、ガザで地上攻撃を開始
ルクセンブルク首相、スパイ疑惑で退陣	ルクセンブルク、スパイ問題で投票
エフード・オルメルト（前イスラエル首相）、汚職で6年の実刑判決	エウド・オルメート、イスラエルで6年の刑を宣告される
ブラヒミ、和平交渉の進展の遅れについてシリアに謝罪	調停官、和平の進展がないことをシリア人に謝罪
エジプトのデモ隊がモルシ退陣を最後通告	ウクライナのデモ隊が警察と新たな衝突を起こす
ソチオリンピックを知る5つのポイント	エタノールについて知っておくべき7つのこと
中国株、水曜は安く始まる	中国株、月曜は安値圏で推移。
緊張が高まる中、米国はミサイル発射実験を延期した	ウィリアム・ハーグ：ミサイル実験中止の決定は「賢明なもの」。
北京の火災、10人死亡	北京の火災、10人死亡
世界最高齢の男性、116歳で死去	日本：世界最高齢の男性、116歳で死去
インドと中国が国境協定を締結、その他8つの協定を締結	インドと中国、国境を越える河川に関する協定を締結
中国中部で建設事故、3人死亡・4人行方不明	ベトナムのボート事故、1人死亡、8人行方不明
パキスタンの人々が画期的な選挙で投票	パキスタンで画期的な選挙が実施されるも、攻撃で29人が死亡
ベネズエラ、米国外交官3名を追放	ベネズエラ、米国外交官3名を追放
中国北部の都市に深刻なスモッグが発生し、フライトがキャンセルされた。	中国北部の都市で重度のスモッグが発生し、フライトがキャンセルされた。
ロシアはテロ行為を阻止したと主張している。	ロシア、地中海で弾道弾が発射されたと発表
パキスタンで中国人観光客3人が死亡	ナイジェリア南部で7人の誘拐犯が殺害された。
セブンスワールドカップはケニアの手の届くところにある	若者死亡事件の公判が始まった。
米国と中国、関係の亀裂を埋めることはできない	中国：行方不明者の希望が薄れ、救援が焦点に
パキスタン北部で武装集団が外国人観光客10人を殺害	イスラム過激派、外国人観光客9人、パキスタン人1人を殺害
オーストリア、盗まれた56個の頭蓋骨を自宅の博物館に保管していたことが判明	盗まれた頭蓋骨が自宅の美術館で発見される
エジプト、シナイ半島の武装勢力に対する攻勢を開始	エジプト、シナイ半島の反乱軍に対する攻撃を開始
記録的な南西の熱波が致命的になる	南西部の熱波で少なくとも1人死亡、40人が入院
デトロイト、破産法の適用を受ける：米判事	デトロイトが破産保護の対象に
アルジェリア大統領、脳卒中の治療を受けている : 国営メディア	ブルガリア大統領、選挙での膠着状態を打破しようとする
英国ノーベル賞受賞作家ドリス・レッシング氏死去	ノーベル賞受賞作家ドリス・レッシング氏死去
イスラエル政府、会談に先立ち新たな入植地を許可	イスラエル、和平交渉に先立ち、新たな入植地を承認
ワールドカップ・ライブ : フランス 0-0 ドイツ	ワールドカップ・ライブ : ドイツ 0-0 ガーナ
2020年大会の開催地は東京に決定	2020年オリンピック開催地決定戦は東京が勝つ
パキスタン・タリバンの指導者が米軍の無人爆撃機で殺害された。	パキスタンのタリバン首領の葬儀が行われることになった。
プーチン、クリミア併合条約に調印	09 : 32 プーチン、クリミア併合に署名
連邦航空局は、テルアビブへの米国便の運航を引き続き禁止している。	米連邦航空局、テルアビブへの米軍機の飛行禁止を解除
フランス、エジプト暴動で利益を得る過激派に警告	フランスは、エジプトでの暴力によって過激派が利益を得ることを恐れている。
中国特使、南シナ海をめぐるベトナムとフィリピンの非難に反論	中国の習近平氏、ベトナムに南シナ海の平和を望むと発言
オーストラリア最大のタバコ違法輸入シンジケートで、さらに4人が逮捕されました。	たばこシンジケートが警察に摘発される
イエメン：北部で戦闘、120人以上死亡	ジャネット・イエレン : あなたが知らない5つのこと
オバマ大統領は連邦議会理事会の補欠に動き、フィッシャー氏を第2委員に任命した。	オバマ大統領、予算について共和党と協議する意向を表明
パキスタンのムシャラフ氏、ブット氏殺害で起訴される	パキスタンのムシャラフ、ブット死亡で起訴
イラン大統領、シリアでの化学兵器使用を非難	シリアでの化学兵器使用の疑惑を調査する
末端社会	オールド・テレビ・アラインメントは、エッジが割れる
国連、シリア和平会議にイランを招待	国連：イラン、シリア和平会議に出席を要請
イタリア・バス事故の死者数が増加	スターバックス、従業員に大卒の道を開く
選手に殴られたサッカー審判が死亡	警察 : 選手に殴られたユタ州のサッカー審判が死亡
ドイツの選挙でアンゲラ・メルケルが僅差で勝利することになった。	マラウイ新大統領が就任、選挙で争った末に
マガルフのホテルから転落した英国人ティーンエイジャーが死亡	マガルフのホテルで英国人青年が転落死
イスラエル、パレスチナ人37人を拘束、逮捕作戦継続中	イスラエル、入植者に対するパレスチナの姿勢を批判
反政府勢力、シリアのアラウィ派村で民間人21人を殺害	アフガニスタンで爆弾テロ、18人が死亡
世界が被災したフィリピンに緊急支援	台風12号（ハイエン）：被災したフィリピンに救援物資を送る。
パレスチナのハンガー・ストライカーとイスラエルが合意に達する	イスラエルの襲撃でパレスチナの活動家が拘束された。
アサド、シリアは国連軍縮決議に従うと発言	シリアのアサド大統領、国連決議の遵守を誓う
韓国大統領、フェリーの対応に謝罪	韓国大統領、フェリー事故について「申し訳ない」とコメント
イランで食糧価格の高騰が懸念される	アメリカのクリス・ホーナー、ツアー・オブ・スペインで優勝
オバマはシリア承認について土壇場で決断した	オバマ大統領、シリアへの限定的軍事行動を検討
