紫色のボールで遊んでいる犬のペア。	紫色のサッカーボールで遊ぶ2匹の犬。
鳥が着水する。	舟は水に浮く．
3人の子供がフェンスの上や近くに立っている。	3人の子供たちは、フェンスの上やそばに立っています。
黒い犬が白いボールをくわえて水面から顔を出す。	黒い犬が白いボールを咥えて水から上がってくる。
紫のシャツとピンクのヘッドバンドの少女がポーズをとっている。	帽子をかぶり、ブルージーンズをはいた少女がブランコにのっている。
植木の前で穴を掘る茶色の犬	線路脇を歩く人たち......。
プールを泳ぐ茶色と白の犬。	裏庭のプールで泳ぐ茶色と白の犬。
2匹の灰色の犬が、緑の芝生の上を一緒に走っている。	緑の草原を走る2匹の灰色の犬。
赤いソリに乗った男の子が、丘を下っていく。	赤い首輪をした色とりどりの犬が、草の上にしゃがんでいる。
2匹の犬が草むらで遊んでいる。	雪の中で遊ぶ2匹の犬.
黒と茶の犬が森を駆け抜けていく。	森を駆け抜ける犬。
2匹の犬が草の上を走っている。	2匹の犬が草むらで遊んでいる。
2匹の犬が草原を走っている	草原を駆け抜ける2匹の犬。
水辺の芝生に座っているカップル。	少年は公園でピクニックテーブルを飛び跳ねる。
ユニオンジャックのペイントが施された建物の外で、3人がピクニックテーブルに座っている。	ユニオンジャックにペイントされた建物の前で、3人が屋外のテーブルに座っている。
ピースサインを掲げる少女。	街角の電柱につかまる少女。
水上の崖から一本の糸で吊るされている男。	桟橋で一人座って水筒を持っている男．
しゃがんでカメラを構える男性。	しゃがんでいる人は大きなカメラを持っています。
自転車で細道を行く男．	一輪車で舗装された道路を走る男
オレンジ色のコートを着た男が、雪の中を歩きながら他の人に話しかけている。	古いファッションに身を包んだ男女が、外のテーブルで座っている。
ジャーマンシェパード	犬が輪っかを飛び越える
犬が空中に飛び上がっておもちゃをキャッチしている。	黒い犬がおもちゃをキャッチするために空中にジャンプしています。
大きな太鼓の上で、若い女の子と男の子が笑っています。	ギターとドラムの横に女の子と男の子が立っています。
青いカバーの上に寝そべる茶色の犬。	青く澄んだ水の中に飛び込んでいく。
二人の少年は野原で遊ぶ。	二人は頭をスカーフで覆っている。
茶色の犬が白いボールをくわえて雪の上を走っている。	雪の中で遊ぶ4匹の犬と、その後ろに広がる街のスカイライン。
茶色い草の上を走る犬...。	濡れた犬がテニスボールを持って黄色い草原を駆けていく......。
2匹の犬が草むらを走っています。	雪の中を走る3匹の犬 .
トランポリンに飛び乗る男と二人の少年。	トランポリンに飛び乗る男と男2人。
人前でリンゴを食べている男。	公然と座ってリンゴを食べる男
腕の骨を折った少年がベッドで休んでいる。	腕が折れた少年が寝ている。
草むらで抱き合う2人の少女。	草むらで抱き合う少女たち
真っ白な雪の中を歩く2匹の白い犬。	二匹の白い犬が、山の雪の中を歩いている。
ビーチでバレーボールをする水着の4人の女の子。	ビキニ姿の4人の女性がビーチでバレーボールに興じている。
鳥が水面を飛び交う	鳥が水の上を飛んでいる。
池を駆ける犬	青白い犬が土の道を走っている。
雪の中で遊ぶ3匹の犬.	3匹の犬が水遊びをしている。
髪にリボンをつけた少女が鼻をほじっている。	紫のシャツとヘルメットをかぶった少女がスクーターに乗っています。
男と女が二匹の犬を見る。	湖の上でロープにぶら下がるマルーン色の水着の男。
桟橋に腰掛けて水面を眺める男。	某氏、岩から飛び降りる
チューブスライダーを滑る少女。	タイヤブランコ少女
多くの人が自転車レースに参加し、その中には3輪バイクの男性もいます。	三輪の車椅子に乗っている人。
うさぎの耳をつけた人たち。	人馬一体のレース
スーパーマンのシャツを着た犬が、毛布の上で寝ている。	スーパーマンのシャツを着た茶色の犬が、青い毛布の上で寝ている。
茶色と白の犬が雪の中を走っています。	茶色と白の犬が草の上を走っています。
白と茶の犬が草原を駆け抜ける。	茶色と白の犬が草原を走っている。
ビルの前に立っている男と女	橋の前の砂浜で、2人の少女がバイクに座っている。
ノートパソコンのキーボードの上で茶色の犬が休んでいる。	犬がノートパソコンの上に前脚を乗せて座っている。
眼鏡をかけた少女が座り、2本のアメリカ国旗を持っている。	眼鏡をかけた少女が、森林地帯の近くで2枚のアメリカ国旗を見つめている。
白と茶の小型犬が水平のポールを飛び越えています。	褐色と白の犬が赤と黄色のポールを飛び越える
2匹の犬が草原を走っています。	草原を駆け抜ける2匹の犬。
公園でボール遊びをする子供たち。	海岸で遊ぶ2匹の犬。
水の上でロープにぶら下がっている人。	夜、暖かい服を着た男が猿ぐつわの上で揺れている。
スーツを着た男がバイクで舗装された道路を走っている。	大きな棒を使って看板の文字を消している人。
黒いマッサージチェアに座った2人のアジア人男性とアジア人女性。	アジア系の男女2人がマッサージチェアでくつろいでいます。
白いフェンスに囲まれた芝生の庭を、黒と白の犬が走っています。	白と黒の犬がハードルを飛び越えている。
山の前で休憩するハイカーたち。	山の前で休憩するハイカーたち。
色とりどりのボールの山で遊ぶ少女。	色とりどりのボールの中で、少女が遊んでいる。
年配の男性がトラックの前に立っている。	緑色の服を着た女性がローラースケートをしています。
笑顔の男性にリフレクティングクラス.	反射サングラスを見せながら微笑む紳士。
青と緑色のドレスを着て、大きな帽子をかぶった2人の少女が大きな木の幹の横に立っています。	牛の像の前に、女性、男の子、赤ちゃんが立っています。
白い犬が雪の上を走っている。	白熊が雪上を歩き、雪上に影を落としている。
茶色のジャケットを着た少年が、雪と戯れている。	二匹の犬が雪の中で遊んでいます。
イルカが3頭、大勢の人の前でプールから飛び出している。	ある男が大勢の人の前でプレゼンをしている。
大きな岩を拾っている人。	大きな石を拾っている女性
白と茶の犬が草の上を走っています。	茶色と白の犬が草原を走っている。
犬が野原を走っている。	犬が野を駆ける
黒と白の犬が水に飛び込んでいる。	白い犬が水の上を走っている。
男が工具箱を持って歩道を歩いている。	公園で青い自転車に乗っている女性。
ジゴロと書かれたTシャツを着た男が、カウンターで誰かと話している。	ジゴロと書かれたシャツを着た男が、カメラに背を向けてフロントエリアに立っている。
太陽の光が降り注ぐ森の中で、テントとキャンプ場......。	浜辺で白い犬が棒をくわえている。
2匹の大きな犬が草むらを走っている。	草原を走る2匹のブリンドル犬。
棒をくわえて泳ぐ犬。	棒をくわえて走っている犬。
女性が座って寝ていて、頭を手の上に置いている。	手元に頭を置いている人
湖に飛び込む少年。	少年は湖に飛び込んでいる。
2匹の茶色い犬と遊ぶ男。	女性が茶色の犬と遊んでいる。
砂利道でボールを拾い上げる白と黒の犬。	大きな犬が森の中の砂利道を歩いている。
犬が棒をくわえて砂の上を走っている。	犬が棒を咥えて小川を走っている。
滝の近くで水中に立っている男性。	男は水の中を泳ぎ、滝を眺める......。
海辺で黒い犬が二羽の鳥を追っている。	海のそばの砂浜を犬が走っている。
ベンチに座る男女。	公園のベンチに座る男女。
テニスボールをキャッチしようと飛び上がる日焼けした犬。	赤い犬がテニスボールを口にくわえてジャンプしている。
男は水の中に飛び込んでいる。	この人は宙に浮いている。
フルーツスタンドでバナナの前に立つ黒いシャツを着た女性。	黒い服を着た女性が、ピックアップトラックの前に立っている。
子供がプールに飛び込んでいる。	プールに飛び込む犬
少女は湖の中で長い濡れた髪を揺らしている。	ダートバイクに乗る人。
海岸で遊ぶ2匹の犬。	雪の中で遊ぶ2匹の犬.
少女は青いドームを背景に遊歩道を歩く。	川を背景に自転車でジャンプを越える男
茶色と白の犬が雪の階段を上っている。	雪の中ではしゃぐ白と黒の犬。
茶色の犬が青いシーツの上に寝そべっている。	茂った草原に茶色い犬と黒い犬が2匹。
ベンチに座る2人の女性、顔は見えないが、1人は膨らませた虎を持ち、もう1人はディズニーの白雪姫のコスチュームを着た女性である。	少女は、カラフルな服を着た別の女の子の隣に膨張虎を保持してベンチに座っている.
男1人と女2人がカメラに向かって微笑んでいる。	白い犬と茶色の犬の3匹が草原を走っています。
棒をくわえて泳ぐ犬。	棒を咥えて泳ぐ犬．
黒いプードルが雪の中で遊んでいる。	雪の中で遊ぶ黒いプードル。
怖い映画のチラシを手にする二人の少女	袋を持った2人の少女が野原に立っている。
3人の少年がビーチを駆け回り、ゲームをしている。	2人の少年と1人の青年が、水のある浜辺を走っている。
女の子が紫の帯とおそろいのスカートをはいています。	ジーンズのスカートとスーパーマンのシャツを着た女の子たちが立っている。
雪の中で戦う2匹の犬．	雪の中に佇む2匹の犬。
トランポリンに飛び乗る男と二人の少年。	トランポリンで跳ねる男性と2人の男の子。
グレーのジャケットを着た男が道端に立っている。	青いライフジャケットを着た男の子が、緑のボートの側面につかまっている。
茶色と黒の犬が赤いボールをキャッチするためにジャンプしています。	茶色と黒の犬が赤いボールに向かってジャンプしている。
葉っぱの中を走る日焼けした犬。	白い犬は海を駆け抜ける
白と黒の犬がプールに飛び込んでいる。	黒いエプロンをした女性が鏡の前に立っている。
白と黒の犬が棒をくわえている。	白と黒の犬は前足に棒を持っています。
鹿が柵を飛び越える	フェンスを飛び越える鹿。
少女が木の棒を持っている。	プールで泳ぐ少女。
黒い犬が水面を飛び越える。	雪の中を歩く犬。
赤い消防車の前にいる人たち。	赤い消防車の周りに人が立っている。
少年は青いプールの水に飛び込んだ。	男の子が腹ばいでプールに飛び込んでいる。
金髪の犬が雪の中でボールを咥えてキャッチしています。	金髪の少女が緑の椅子に座っている。
3人の子供たちが床で遊び、笑っている。	床で遊ぶ3人の子供たち。
水辺で釣竿を持つ男。	岩の上に座った男が、折りたたみ式のデッキチェアと釣り竿を持っている......。
草むらにたたずむ女と犬。	雨の中、看板を持つ男。
青いシャツを着た男がスタジアムのフィールドを走っている。	青い帽子とシャツを着た男が白い馬に乗っている。
黒とオレンジのジャケットを着た女性が、茶色と黒の犬に棒を投げて取ってこさせる。	青いジャケットの男が人ごみの中に立っている。
水の中を走る黒い犬。	黒い犬が水の中を走っている。
トランポリンで飛び跳ねる子供たち。	オレンジの滑り台でそり遊びをする男。
大きな茶色の犬が草原でしゃがんでいる。	茶色の犬が野原を走っている。
犬が草むらを駆け抜ける	雪の中を駆け抜ける犬。
青いバケツを持った少女が、桟橋の下で水しぶきを上げる。	スキージャケットの少女がビルの近くを歩いている。
雪の中を駆け抜けるスキーヤー。	フリスビーを持った茶色の犬が雪の中を走っている。
ゴルフコースでゴルフをする二人。	二人はゴルフコースでゴルフをしています。
浜辺で遊ぶ少年と少女。	波打ち際でボール遊びをする犬。
雪玉を口にくわえて雪の上を走る犬。	褐色の犬が黄色のおもちゃをくわえて草むらを走っている。
赤いコートを着た子供が赤いマットに寝そべった。	幼児は、赤い遊具に登る準備ができています。
2匹の犬が草むらで遊んでいる。	2匹の犬が草むらで遊んでいる。
砂浜に立ち、水面を眺める一団。	浜辺でボートの前に立っている人たち。
青と白のユニフォームを着た子供が、サッカーボールを追いかけている。	青いサッカーユニフォームを着た少年が、ボールを追いかけている。
雪の中、黒い犬が白い犬を追いかけている。	黒犬が茶犬を追いかける雪道
カメラに向かってカイトサーフィンをする男性。	水上でスカイサーフィンをしている男。
小さな男の子が積み木をしています。	青いシャツを着た小さな男の子が、木のブロックを積み上げています。
黒い犬が草むらを走っている。	緑の草原を駆け抜ける少年。
小さな男の子と女の子が外で一緒に遊んでいます。	組み敷かれた少年少女
ドックの端に二人が座っている。	ドックに座っている二人。
庭の2匹の犬．	小川の中の二匹の犬
プレイエリアに入ろうとする犬を追いかける男。	白と黒の犬が障害物競走に挑む姿を追う男。
茶色と白の大きな犬が雪の中を走っています。	雪原を走るセントバーナード犬。
芝生の上を走る小さな白い犬。	走狗
白と茶の犬が草むらを素早く駆け抜けていく。	大きな白い犬が草むらを走っています。
血まみれの男女が写真に収まっている。	暖かい服装で写真撮影をする女性。
男女が鎖につながれた白い犬を連れて歩いている。	男、女、そして犬が舗装された道路を歩いている。
黄色い犬が花のそばの草むらで遊んでいます。	少女がブランコで遊んでいる。
プールサイドでヌードルで遊ぶ少年。	プールサイドで発泡スチロールのおもちゃで遊ぶ少年。
雪の中を走る2匹の大きな茶色の犬。	草原を走る茶色の犬。
少年は両手を広げてプールに飛び込む。	裏庭のプールに飛び込む犬。
女の子は黄色い風船を手に持っています。	黄色い風船を持つ子供。
草原でおもちゃを共有する2匹の犬。	二人のスノーボーダーが雪の上で空中にいる。
黒い犬が草むらを走っている。	黒い犬が草むらを走っている。
白衣を着た金髪の女性がカメラに向かってポーズをとっています。	黒と白の犬が口を開けて走っている。
犬がボールを追いかけて野原を駆け抜ける。	子供が草原を駆け抜ける
二人の少女が像の前に座っている。	ブロンドの二人の少女は、像の隣に座っています。
赤いコートを着た男の子が、キャンディーを食べています。	赤いコートを着た少年がチョコバーを食べている。
オレンジの服を着た少女がろうそくに火を灯す。	オレンジのシャツを着た少女がキャンドルを灯す。
黄色い花畑を白い犬が駆け抜けていく。	真冬の森に、赤い首輪をした犬が走っている。
ベビーベッドの上に座っている幼児が、年長の男の子の顔に手を伸ばそうとする。	病気のような男の子が、幼児に顔を触られている。
犬が水を振り払う	犬が水を振り落とす
歩道を走る少年たち。	海辺を走る黒い犬。
オレンジの滑り台を滑り降りる子供。	デニムのオーバーオールを着た男の子が、オレンジ色の滑り台を滑っていく。
紅白の電柱を駆け抜ける白黒の犬	リビングルームで後ろ足で立っている黒と白の犬.
スキー禁止」の看板の向こうで、3人がスキーでポーズをとっている。	スキーに乗った3人が、スキー禁止の標識の後ろに立っている。
白いスーツを着た男が新聞を手に通りを歩いている......。	白いスーツを着た男が新聞を持って外に出てくる。
澄んだ水の中を泳ぐ白と黒の犬。	黒と白の小さな犬が水の中を泳いでいます。
泥の中を走る2匹のレーシングドッグ。	男は水の中に入っていく。
飛び込み禁止」と書かれたプールに飛び込む少年。	ライフガードが見守る中、プールに飛び込む少年。
青い首輪をした黒い犬が、雪の中を走っている。	青い首輪をした黒い犬が、雪の中を走っている。
水の中を走る黒と白の犬.	白と黒の犬が草むらを走っています。
犬がカメラに向かって走ってくる。	草の上を走る茶色と白の犬。
土の中を走る3匹の犬．	黄色い犬が未舗装の道路を走っている。
ブランコに乗っている男の子。	少女はブランコに乗っている。
青春群像	多くの子供たちが水遊びや水泳をしています。
青と白のサッカーチームが対戦している。	顔にペイントを施した上半身裸の女性が泥まみれになっている......。
雪の中を走る二匹の犬	雪の中で寝そべる犬
黄金の犬が雪の中を走っている。	そり犬の群れがそりを引いて町を抜けていく。
緑色のフリスビーをキャッチしようとする茶色の犬。	茶色の犬は、フリスビーが落ちてくるのを待ってからキャッチしています。
街中を走るスケートボーダー。	屋外の大きなランプで空中を滑るスケートボーダー。
食堂のスツールに座る4人の子供たち．	黄色とグレーのバーで背の高いバースツールに座る4人の子供たち。
草原を走る少年と白い犬	狗子啼鳥
大きな緑の湖で泳ぐ白と黒の犬。	黒い犬が浅瀬を疾走する。
2匹の大きな黒い犬が草原で遊んでいる。	2匹の白い犬が一緒に走っています。
フラッグフットボールに興じる2人の少年。	二人の少年がフラッグフットボールに興じている。
茶色と黒の犬が雪の上を駆け抜けていく。	黒い犬が地面すれすれを走っている。
バックパックの男は左を見る。	リュックを背負った成人男性が歩きながら左を向いている。
青いシャツを着た老人が、キャンバスアートを掲げています。	大都会のビルの横を歩く黒人。
水中で砂遊びをするやせっぽちの少年2人。	2匹の犬が水を振り払っている。
白と黒の犬は口を大きく開けている。	雪の中でジャンプする白黒の犬。
小型犬が障害物競走をする。	小さな犬が障害物を飛び越える。
バウンスハウスで弾む少女。	女の子がコスプレで男らしく踊る
森を走る茶色の犬。	茶色の犬が草むらを走っている。
アジリティ競技のバリアーを飛び越える犬。	フェンスを飛び越える犬。
アイススケートで疾走する3人.	3人のアイススケーターが角を曲がる。
白人の少年と黒人の少年が腕を組んで立っている。	白人と黒人の2人の少年が、腕を組んで立っている。
ドッグショーで犬を散歩させる女性2人組。	ドッグショーで犬を散歩させる二人の女性。
舷側二人	長い髪と髭を生やした男が草原に横たわっている。
茶色と白の犬が後ろ足で立ってテニスボールをキャッチしています。	茶色と白の犬が棒をくわえている。
草原を走る茶色の犬。	茶色の犬が草むらを走っている。
赤い首輪をした濡れた黒い犬が川に入っている	赤い首輪をした黒い犬が、水の中をかき分けている。
森に隣接した小道を自転車で走っている人。	黄色いシャツを着た小さな子供が両手を広げている。
シルバーのトラックの前で、黒いドレスを着た女性が微笑んでいる。	シルバーのトラックを背景に、黒のトップスを着た少女が微笑んでいる。
裸足で水たまりで遊ぶ少女。	子供が白と黒の2羽のガチョウと遊んでいます。
海辺を歩く二人。	フリースと帽子をかぶった2人の男がカメラを見ている。
ピンクの服を着た2人の少女が踊っています。	水辺の小径をジョギングする2人の女性。
水しぶきを上げる2人の子供たち。	イルカが2頭、海に飛び込んでいる。
浜辺でボールの近くにいる犬。	バスケットボールのコートでレイアップをする人。
犬が茶色の草原を駆け抜けていく。	2匹の犬が草むらを飛び交う．
公園で二人の少年と遊ぶ女性	女性と3人の子供が公園で遊んでいる。
犬が棒をくわえて水面から顔を出す。	犬が棒を咥えてカメラに向かって走ってくる。
雪の中で遊ぶ3匹の犬.	少年は砂遊びをしている。
ジーンズの女性が大きなスクリーンの前でビデオゲームをしている。	黄色い花壇の前で写真撮影をする男女。
夕暮れの海岸を歩く二人。	夕暮れ時のビーチを歩く2人の姿と、それを見守る人々。
スーツ姿の男が観客の前で若い娘と踊る。	木につながった青い布から、女性がぶら下がっている。
おもちゃで遊ぶ3人の子供たち。	床に座っておもちゃで遊んでいる3人の子供たち。
犬が咥えているのはリードです。	ふわふわの犬が、黒いリードをくわえている。
ジーンズ姿の男性がボールで遊んでいるそばで、ジーンズ姿の女性が遠くを見ながら立っている。	ある男が、路上で他の男の腕に赤い腕輪を巻いている。
黒い犬が雪の中を走っている。	黒と茶の犬が雪の中を走っています。
ピンクのビキニを着た女性が、ピンクのタオルで覆われたデッキラウンジチェアに横たわっています。	テニスコートで白いシャツと黒いスカートを着た女性......。
スキーヤーが雪に落ちている。	スキーヤーが雪に顔から落ちている。
赤いおもちゃをくわえた犬。	茶色の犬が棒をくわえている。
氷上で戦う2人のアイスホッケー選手．	アイスホッケーの二人が氷上で格闘している。
3人が屋外のガラス構造物の中に立っている。	障害物競走の台の上に立つ少女。
2匹のテリアが自宅のフローリングの床で遊んでいます。	2匹の子犬が野原で赤い噛むおもちゃで遊んでいる。
大会会場でアメリカの国旗を振っている人たちがいる。	人出
野原を走る2匹の犬。	野原で遊ぶ2匹の犬。
グレーのスーツの男が自転車をロックする	街角にたたずむ男女。
2匹の犬が庭で遊んでいる。	2匹の犬が芝生の上で遊んでいる。
落書きされた階段の手すりをスケートボードで降りていく少年。	ホワイトハウスの前で障害物を飛び越えるスケートボーダー。
白い犬が海辺を走っている。	白い犬が水面を走っている。
地下鉄の車内で黒い革ジャンを着た男が寝ている。	黒い革のジャケットを着た男が、公共交通機関で居眠りをしている。
犬が飛び越える	犬がハードルを飛び越える。
電子機器をセットアップしている二人。	雪が降る中、2匹の犬が地面で格闘している。
黒い犬が棒をくわえて草の上を歩いている。	少年は蛇の入った網を地面に近づけている。
男女がシャボン玉を吹く	メガネをかけた男女がシャボン玉を吹く。
少女は乾いた野原で犬と一緒に走る。	灰色の犬と日焼けした犬が草原で遊んでいる。
雪の中で遊ぶ2匹の犬.	雪の中の2匹の黒い犬.
犬がドックから水中に飛び込む。	黒い犬はドックから水中に飛び込む。
街道をゆく老人の群れ	街を歩くカップル
青いフェンスの横で雪の中に立つ3匹の犬。	岩場の横の浅瀬で遊ぶ3匹の犬。
黒と白の犬が野原を走っている。	白と黒の犬が草むらを走っている。
黒装束の少年が腕を振り、その後ろには他の人々がいる。	黒いシャツを着た男が、街のベンチの前をローラーブレードで通過している。
自転車で街を走る老女。	坂道を歩いている老女が横断歩道を渡っている。
少年は黄色いボールをパンチしています。	小さな犬が黄色い梁を飛び越える。
ダンススタジオにいる若いバレリーナの一団。	ビキニの若い女性のグループ。
白いシャツを着た少年が、草原で遊んでいる。	美容院で髪をセットしてもらう女性。
ヘッドホンで楽しむ女と男。	運動して休んでいる男女
グレイハウンドの2番犬がトラックを走っています。	グレイハウンドの犬が走っている。
人と犬が綱引きをしている。	色とりどりの壁の上で踊る男。
プールで濡れた子供がタオルの下で震えている。	プールの前で濡れた子供がタオルを巻いて震えている。
白い犬が浜辺を走っている。	白い犬が浜辺を走っている。
砂浜を走る6匹の犬たち。	6匹の犬がビーチの横を歩いている。
水中でハンドルにつかまっている人。	空中でハンドルにつかまっている人。
4人の子供たちがトランポリンで遊んでいます。	4人の子供たちがトランポリンでジャンプしています。
雪の中を歩く白い犬。	雪の中を歩く黒と褐色の犬。
白と茶の犬が草原を駆け抜ける。	3匹の犬が草の上を走っています。
少年は、インフレータブルスライドを滑る。	赤い服の男の子がインフレータブルな乗り物を滑り降りる。
水たまりの中でボールで遊ぶ2匹の犬 .	2匹の犬が水たまりの中に立っていて、1匹が黄色いテニスボールを持っています。
3匹の犬が水遊びをしている。	雪の中を走る3匹の犬 .
雪の中で遊ぶ2匹の犬.	犬と遊ぶ二人の子供.
ビーチでバックベンドをする女の子。	ビーチでバックベンドをする女の子。
荒波の中でボートが帆走する。	荒波の中でカヤックを漕いでいる男。
2匹の犬が雪の中でキャッチボールをしている。	2匹の犬が草むらで遊んでいる。
野に佇む黒と白の犬	白い犬が川辺に立ち、体を揺すって乾かしている。
小さな波に乗っている2人のサーファー。	2人のサーファーが波の上でトリックを披露する。
夕暮れ時のビーチを歩く二人。	夕暮れの海岸を歩く二人。
白い雪の中で3匹の犬が遊んでいる。	2匹の犬が草むらで遊んでいる。
草むらで遊ぶ2匹の子犬	2匹の犬が草むらで相撲をとっている。
少女がサンタの膝の上に座っている。	少女がサンタの膝の上に座っています。
黒と白の犬が口を開けて走っている。	青い水の中を泳ぐ黒と白の犬。
黒い犬が水の中に入っていく。	水の中を走る黒い犬。
海辺で空中に飛び出す少年。	ビーチで空中にジャンプする少年。
タキシードを着た5人の男が階段を下りている。	タキシード5人組が階段を下りる
赤いショートパンツと白いシャツの男がサッカーボールを蹴っている。	波打ち際に立つ黒い犬が赤いゴムボールを抱えている。
岩場の男と犬。	水辺の岩に佇む男と犬
水しぶきを上げる茶色い犬 .	4匹の犬が水しぶきをあげている
海辺で微笑む女性は、海藻に埋もれている。	カウボーイハットをかぶった少女と、鎖につながれた羊。
大きな耳の犬が、小さな棒をくわえている。	大きな耳の子犬が棒を噛んでいる。
大きな茶色の犬は、高い草の中を飛び跳ねています。	青いシャツを着た少女が科学館を走っている。
雪の中で戦う2匹の犬．	雪の中で遊ぶ2匹の犬。
茶色の犬が、土の上で汚れたテニスボールを追いかけている犬の列の真ん中にいる。	白い犬2匹と茶色の犬1匹がボールを追いかけています。
草原で活躍するグレイハウンド。	バイクの群れがサーキットを走る。
サイドカーで泥まみれのレースをする2人。	長い棒をくわえている犬。
バレーボールをする赤い水着の男。	バイクに座る男女。
レコード屋の前を通り過ぎる男と女	大勢の人の前でキスをしている男女。
男は岩山の頂上に座っている。	山頂のテントから頭を出す人
スノーエンジェルを作るスノースーツ姿の2人	雪に寝そべる二人の子供
金髪の少女が噴水の前に立っている。	噴水の前に立つ少女
舟の上に立っている人が、竹の棒で近くの舟を引っ張っている。	レンガの壁と看板の前に立つ黒い帽子をかぶった男性。
白いギターを弾く男。	白いギターを弾きながら歌う男
犬と一緒に山でスキーをしている人。	茶色の犬が水の中でボールで遊んでいる。
シャツのない2人の若者が水遊びをしている。	ビーチではたくさんの人が水遊びをしています。
ハチドリのクローズアップ。	ハチドリの飛行をクローズアップ。
2匹の犬が草むらで遊んでいる。	雪の中で遊ぶ2匹の日焼けした犬。
街を歩く黒いドレスの女性。	犬が階段を飛び降りるのを見る女性。
花柄のカーペットの上で相撲を取る3人の子供たち。	床で遊ぶ3人の子供たち。
砂場に飛び込む赤い服の少年。	池に泳ぐ犬
カメラを見ている男と女。	男と女の笑い話
犬が水に飛び込む	犬が水に飛び込んでいる。
褐色の犬が泥まみれの草原を駆け抜ける	大きな茶色の犬は、外の土の中を走っています。
雪の中を自転車に乗った男を引っ張る3匹の犬．	犬たちは、雪の中を、自転車に乗った人を引っ張っています。
ブランコに乗っている男の子。	ブランコに乗っている少年。
雪の中を走る黒い犬。	黒い犬が水の中を走っている。
ベビーカーに座った赤い帽子の赤ちゃんが、人形を抱いている。	花畑に座る灰色のシャツの男。
3人の子供が屋外で干し草で遊んで、カメラのレンズでいくつかを投げる。	3人の子供たちが干し草の中で遊び、カメラに向かっていくつか投げている。
プールの横を歩く黒い犬。	黒い犬がプールサイドを歩いている。
ピンクのロープの横の岩肌に、クライマーが立っている。	雪の中を走る子供たちと、その背景にあるフェンス。
黒いシャツと帽子を身につけ、微笑んでいる男。	男が少女を頭上に持ち上げている。
オレンジ色の首輪をした黒い犬が、釣り糸に絡めとられている。	赤い首輪をした黒い犬は、水を振り払う。
濡れた金髪の犬が、海岸で棒を運んでいる。	濡れた茶色の犬が棒をくわえて、砂浜を走っている。
ある男女が自転車で通りを走っている。	男女が自転車で交差点を渡っている。
浜辺の岩の上にいる男と犬。	岩場の男と犬。
2匹の犬が土の中で遊んでいる。	赤と白のドレスを着たダンサーがカメラに向かってポーズをとっています。
金色の犬が草の上を走っている。	大きなベージュの犬が草むらを走っています。
犬が草むらを駆け抜ける	犬が草むらを走っている
赤いショートパンツの男が、棒を持って川沿いの岩を歩いている。	水の流れる岩の上を歩く男。
レース場を走る3匹の犬．	三匹がワラジを履く
黒と茶の犬が雪の中をビルの近くを歩いている。	板張りの古い建物の外に、年配の男性が立っている。
犬がアヒルを追いかけてプールに飛び込んでいる。	プールに飛び込む犬
冬の森を駆ける犬	たくさんの小枝の間を走り抜ける犬。
大きなスクリーンに映し出される映像に合わせて、少女が遊んでいる。	カメラに背を向けて傘を差す3人の少女。
多くの人が道路を走っている。	通りを走る子犬。
雪の中の二匹の犬	2匹の犬が草むらで遊んでいる。
海水パンツ姿の男が、岩を背にして立っている。	灰色のシャツを着た男が、大きな岩壁を登っていく。
雪の中を歩く2匹の白い犬。	雪の中で吠える黒い首輪をした褐色の犬......。
ピンクのシャツを着た女性が、両手両足を広げて空中でジャンプしています。	サスペンダーとサングラスをかけた男が、両手両足を広げて空中に飛び上がる。
犬が草むらを駆け抜ける	2匹の犬が茂みの中を走り抜ける。
雪の中で遊ぶ3匹の犬.	雪の中を走る3匹の犬 .
砂を駆ける犬	水の中を走る犬。
オレンジのシャツを着た男の子がボールを投げています。	黒と白の口輪の犬が草の上を飛び跳ねている。
小さな波に乗ろうとしている女性。	男女が背中合わせに座り、日向ぼっこをしている。
黒と白の犬が川を泳いでいる。	海岸にいる黒人とその犬。
海の近くのギザギザの岩の上に立つ男。	海を見下ろす岩の上に立っている男......。
黒と青のウェットスーツを着た少女がサーフィンをしている。	黒と青のストライプのスーツを着た女性が、波の上でサーフィンをしています。
女性が犬を連れて障害物競走をしています。	小型犬を連れて障害物競走をする女性。
夜、数人で焚き火を囲んでいる。	焚き火を囲む人々
2匹の犬が野原を走っている。	野原を走る2匹の犬．
二人がベッドで寝ている。	二人のボクサーはリングの上にいる。
ビーチにいる2匹の犬。	浜辺を歩く犬。
灰色のタイルの上に少年が立っている。	体育館で空手の練習をする少年。
雪の中で戦う2匹の犬．	雪の中で遊ぶ2匹の犬.
水中にいる一団。	人馬一体のレース
犬が食べ物を口にくわえて走っている。	犬が黄色いボールをくわえて走っています。
浜辺を走る2匹の犬。	浜辺を走る二匹の犬
プールで泳ぐ白と黒の犬	口に何かをくわえて走っている白黒の犬。
2匹の犬が岩の中で何かを嗅いでいます。	森の中の小道を走る2匹の犬。
赤と緑のギフトバッグの中に、犬が頭を入れています。	ペットが福袋の中身を調べて遊んでいる。
金色の太陽の仮面をかぶった黄色いシャツの男。	黄色いシャツを着た男が、金色の太陽の形をしたマスクをつけている。
ロープで支えながら、切り立った岩壁を登っていく男。	紫色の板でスキージャンプをする青年。
頭に手を当てている子供。	あたまのうえのたんこぶ
オレンジ色のベストを着た男が、青い水の中をカヌーで進んでいる。	オレンジ色のジャケットを着た男が、砂の上で空に向かって両手を挙げている。
黒い犬が砂の中に横たわっている。	子供たちが水遊びをする
薄茶色の犬が楽しそうに小径を走っている。	青白い犬が小道を走っていく......。
黒いトレンチコートを着た老人が、市場に立っている......。	赤いシャツを着た赤ちゃんが広場を歩いています。
赤い壁の前で帽子をかぶり眼鏡をかけた黒い服の男。	レンガの壁の前に立っている白いシャツを着た女性。
男の子が自転車に乗るのを手伝う男性。	男は少年が自転車に乗るのを助ける。
黒い服を着た赤い髪の女性が、木の上で休んでいる男性にポーズをとっています。	黒いシャツを着た男が、サングラスをかけた子供を抱いている。
崖っぷちを登る男	断崖絶壁を登る男。
2匹の犬が雪の中でキャッチボールをしている。	犬たちが雪の中で遊んでいる。
パジャマ姿の2人の少女が踊っているように見える。	野球帽をかぶった2人の女の子が、外でおやつを食べています。
黒いおもちゃで遊ぶ白と茶の犬。	白と茶の犬が綱引きをしています。
雪の中、2匹の黒い犬が黄色いテニスボールでジャンプして遊んでいます。	黄色いサッカーボールで遊んでいる茶色い犬と黒い犬。
2匹の犬が一緒にビーチで遊んでいます。	2匹の黒い犬が草原で遊んでいる。
野球をする少年.	野球をやっている人。
白と黒の犬がハードルを飛び越えている。	橋の上を走る白い犬。
赤いシャツを着た男の子が、毛深い犬を連れて草むらを走っている。	スポーツファンがスタンドでフェイスペイントをしている。
雪の中を走る黒い犬。	スケートボーダーがストリートでジャンプしている。
笑顔の男性と記念撮影をする女の子。	ピンクと赤の服を着た小さな子供を抱く笑顔の男性。
2匹のタンと白の犬、1匹のタンの犬が水辺で競争している。	ピンクのティンカーベルのジャケットを着た女性が手すりの横に立って、水面を眺めている。
雪の中でフリスビーに飛びつく犬。	雪の中で犬がジャンプしている。
土の道を自転車で走る男。	土の道を走る2匹の犬 .
ピンクの首輪をした茶色と白の犬が、雪の中で青い首輪をした茶色い犬に吠えている......。	赤い首輪をした犬が青い首輪をした犬に向かって歯を立てている。
茶色の犬が2匹、水の中を走っている。	水の中を走る2匹の茶色い犬 .
喫茶店で、帽子をかぶった若い女性が座って本を読んでいる。	カフェで読書を楽しむ女性
白と黒の犬が草むらを走っている。	白と黒の犬が草の上を走っている。
2匹の茶色い犬がお互いに噛み合っている。	砂の上で噛み合う2匹の茶色い犬。
スケートボーダーが低い壁の側でトリックに挑戦している。	手すりの上でスケボーの技をする少年。
水中でバックフリップをする少女。	紫の少女が水の中を走る
スノーボーダーがスノーボードで階段の横の手すりを滑っている。	コンクリートの壁をスケートボードで滑っている少年。
黒い犬が水から飛び出している。	黒い犬が、水を振り払っている。
帽子をかぶった2人の男性と女性が外で社交している。	ニット帽をかぶった若い女性がドミノピザの壁に立っている。
バスローブを着た小さな男の子が、金属製の椅子に座っています。	ローブを着た少年が椅子に腰掛けている。
黒い犬が雪の中を走っている。	黒いピットブル犬が土の中を走っている。
ティーンエイジャーのグループが、木の床で踊っている。	暗い色の服を着た人々が、木の床でラインダンスをしています。
両手を広げて立っている女性を、他の人が撮影しているところ。	群衆の中に、白い物体を持った男が立っている。
少年は自転車に乗っています。	青い膨らませたおもちゃに寝そべる少女
雪の中を走る黒い犬。	浜辺を走る黒い犬。
雪の中の3匹の犬、フェンスのそばで。	湖で水を飲む2匹の犬 .
少女が2匹の黒い犬を連れて川岸を走っている。	寝そべっている虎を撫でている少年。
岩肌を登る男	岩壁を登っている男。
叫んでビーチを走る10代の少女と、彼女の後ろを歩く年配の男性。	浜辺を駆ける幼子
テニスをする女性、ボールを打つ女性 .	バレーボールをする女性。
髪を逆立てた少年が、青い滑り台を滑っている。	オレンジ色のシャツを着た子供が、青緑色の滑り台を滑っている。
多くの人がビーチにいる、旗を掲げた建物の近くにいる。	賑やかな浜辺に人が散らばり、空を見ている。
水の中に立つ犬。	パラシュートで遊ぶ少女。
茶色と白の犬がスケートボードに乗った男の隣を歩いている。	緑の野原で、金髪の子供が木の枝に横たわっている。
サーフボードに乗って波に乗る男性。	サーフボードに乗った黒服の男が波に乗っている。
赤いシャツの男が山の斜面を登っている。	某氏が山の斜面を登っている。
水の中を走る黒と白の犬.	水の中を走る白と黒の犬。
黒い制服を着てバイクに乗った男。	白いバイクがサーキットを走っている。
色とりどりの鮮やかな衣装をまとった3人のピエロ。	色鮮やかなドレスを着た3人の女性.
川を泳ぐ黒い犬。	雪を掘る黒い犬。
2匹のベージュの犬が草むらで遊んでいる。	芝生で遊ぶ二匹の日焼けした犬
2匹の犬が家と木の近くの草むらを走っています。	緑の庭を駆け抜ける2匹の犬
男女が微笑んでいる。	男と女の笑い話
男は岩や山の上に立って夕日を見ている。	山で夕日を見ている男。
トランポリンで遊ぶ2人の女の子。	二人の少年が遊び場で遊んでいる。
二人の少女が空高くジャンプしている。	湖のそばの草むらで、2匹の犬がじゃれあっている。
黒い財布を持った女性がタバコを吸っている。	黒いバッグを持った女性がタバコを吸っています。
犬が草原を走っている。	茶色の犬が草むらを走っています。
長い髪の男がカメラを通して見ている。	ビデオカメラのそばの壁に立つ女性。
犬と赤いボールが空中を舞う。	犬が庭で穴を掘っている。
茶色と白の犬が茶色の野原を走っています。	崖にぶら下がる人。
草の上を走る茶色の犬.	犬が草の上を走っている。
犬が草原を駆け抜けていく......。	犬が草むらを駆け抜けていく
帽子をかぶった2人が座ってカメラを見ている。	青いシャツの男が不機嫌そうな顔をする。
バレーボールのそばの芝生に立つ黒い犬。	草原でサッカーボールの近くにいる青い首輪をした茶色と黒のダウン。
人と遊ぶ2人の少女と、その背後にある花々。	スカートをはいた2人の少女が、庭で遊んでいる。
ピンクのシャツを着た女の子が手足を宙に浮かせている。	サンタクロースの服を着た男が、大きなコンクリートのビルを登っている。
赤いシャツを着た少女が凧を揚げる。	赤いシャツを着た女の子が携帯電話で写真を撮っている。
雪で滑る子供	路上で寝ている男．
3匹の犬が水遊びをしている。	3匹の犬が水の中を泳ぐ .
砂の上を走る白い犬。	白い犬が砂の上を走っている。
両手を上げた少女が、毛布の上に寝ている男の背中に座っている。	子供がゲームをしている人の反対方向に走っていく。
ダートレース場を走る赤と白のレーシングカー。	ダートトラックでダートバイクを走らせている人。
黒と白の犬が牛舎を駆け抜けていく。	海の中を走る白と黒の大型犬
白地に薄茶の模様のある犬が、棒を咥え、前足を雪につけている。	白い犬が棒を咥えて雪の中を走っている。
麦わら帽子をかぶった男が、人通りの多い歩道で歩きながら携帯電話をシェードしている。	路上で、ジャッキアップされた車の下に頭と肩を落として横たわる男。
グレーのタイルの壁の前にメッセンジャーバッグを持った男性。	灯台の前に立つ赤いジャケットの男。
犬は水の中を泳ぐ......	3匹の犬が水の中を泳ぐ .
道に立っている小さな女の子と犬のグループ。	青いラフトでラフティングをする一団。
白い巻き毛の小さな犬が、棒を咥えて歩道を走っている。	白い巻き毛の犬が棒をくわえて走っている。
ウェットスーツを着た男が、ウェットスーツを着た赤ん坊を空中に放り投げている。	白いプリントシャツを着た男性と黒いドレスを着た女性が踊っています。
グレーのスーツを着た男性が、白いドレスを着た女性の前にひざまずいている。	ビールを持った赤い服の女性と、白い服の男性......。
金髪の女性は黒いアメリカ国旗のタータンチェック柄の帽子をかぶっている。	赤い髪の女性は、アメリカ国旗をあしらった黒いベレー帽をかぶっています。
網を持った人が水中に立っている。	黒人の女性と二人の黒人の子供が藁葺き屋根のテントに座っています。
赤いトラックスーツを着た女性が、プレス機でレモンを絞っているところ。	ピンクのパーカーを着た若い女性が写真を撮っている。
白と黒の犬が草むらを走っている。	雪の中を歩く日焼けした犬。
男が鎖でつながれた2匹の犬を連れて通りを歩く	ある男が2匹の犬を散歩させている。
ピンクのフリスビーをくわえた茶色と白の犬が、男の背中に乗っている。	フリスビーをくわえた犬が、人を飛び越える。
雪の中を犬が走っている。	土の中を走る二匹の犬
雪の中で遊ぶ小さな男の子。	茶色と白の犬が雪の中で遊んでいます。
馬具をつけた犬が丸太を飛び越え、その後ろを別の犬がついてくる。	茶色と白の犬が野原にある丸太を飛び越えて、もう一匹の犬がその後ろを追いかけています。
犬と猫が一緒に寝そべっている。	2匹の灰色の犬が水の中で棒を運んでいます。
青いシャツに日焼けしたショートパンツの女性がテーブルに座っている。	ツアーコイズシャツとバンダナを身にまとい、屋外のテーブルでポーズをとる笑顔の若い女性。
浜辺で犬と遊ぶ一家。	裸の少女が空中に投げ出されている。
雪の中を走る白い犬	雪の中を走る犬たち。
長い草原を駆け抜ける犬。	緑の芝生に寝そべる犬。
黒い犬が雪の中を走っている。	レースカーのドライバーが泥の中を走っている。
緑のセーターとリュックを背負った犬が雪の上を歩いている。	緑のセーターとリュックを背負った小さな犬が、雪の中を歩いている。
机を囲んでいる人たち	海辺の少女たち
3匹の犬が野原を走っている。	2匹の犬が草原を走っている
あごに手を置いた男女がクリスマスツリーの横に立っています。	白い髭と青い帽子の男は、工房の入り口に立っている。
白と黒の犬は前足に棒を持っています。	黒い犬と白い犬が雪の上に立っている。
雪の中を駆ける白い犬	黒と白の犬が草むらを駆け抜ける。
山々を背景に雪山を滑るスキーヤーの男	山や砂を背景に水遊びを楽しむ犬。
岩の上でキャンプをしている人たちがいる。	消防車の横に立っている人たち。
自転車に乗った男が、川の中に巣を作る。	自転車に乗った男が、とても高いジャンプをする。
草を駆ける犬	2匹の犬が芝生の上を走っている。
黒い犬がプールに飛び込んでいる。	黒い犬がプールに飛び込んでいる。
雪山を滑るスキーヤー。	茶色の犬が雪の中で寝そべっている。
2匹の犬が芝生の上を走っている。	土の中を走る二匹の犬
ビーチで長いホースから液体を噴射している男性。	片方の車輪を空中に浮かせたまま、自転車の上に座っている人がいる。
雪の中で遊ぶ3匹の犬、1匹はジャケットを着ている。	雪の中で遊んでいる3匹の犬、背景の都市と。
グラウンドに座っている多くのサッカー選手たち。	犬が地面を転がる
岸に向かうボートに乗った一群の人々。	家の前で立ちポーズをとる人たち。
小さな男の子と女の子が外で一緒に遊んでいます。	白いシャツを着た女性が路上に立っている。
赤いベストを着た人が、他の人の青いアイススケートに触れている。	雪の中で女性がアイススケートの靴をとめる。
トランポリンの上で逆さまに跳ねる少女。	トランポリンの上で、女の子が頭の上で跳ねている。
サーファーが波からフリップする。	サーファーが波の上でフリップをする。
マイケル・ジャクソンのアルバムを手にする女性DJ。	マイケル・ジャクソンの写真を持ち、微笑む少女。
木々の前に立ち、微笑む女性。	都会のスカイラインを前に、木々の間を歩く一人の男性。
プールの中でバックフリップをする少年。	赤と青の水泳パンツをはいた少年が、プールに頭から飛び込んでいる。
少年は少女を見上げているが、別の少女はそれを無視している。	夫婦が見守る中、男の子がプールに飛び込んでいる。
雪の中でおもちゃで遊ぶ2匹のホワイトスタンダードプードル	雪の中で戦う2匹の犬．
農村の道に立つ人々の群れ、その背後には畑、正面には森がある。	トランクを開けた車の横に大勢の人が立っている。
少年は草むらに腹ばいになっている。	草の上に腹ばいになっている少年。
青い首輪をした黒い犬が、雪の中を走っている。	赤い首輪をした黒い犬が雪の中で遊んでいる。
日本刀の剣士が空中に飛び出す。	女性が犬を空中に飛び上がらせている。
鳥は木の上に座っている	葉のない木に、鳥が座っている。
茶色の犬がオレンジ色のボールを噛んでいる。	犬がオレンジ色のボールをくわえている。
白い犬が岩場を走っている。	犬は金玉を飛び越える
茶色の犬がボールをキャッチするために空中にジャンプしています。	ボールをキャッチするために空中に飛び出す3人の若い女性。
子供がピクニックテーブルから別のテーブルへ歩いている。	少年は公園でピクニックテーブルを飛び跳ねる。
米国国旗のボクサーパンツをはいた男が階段に立っている。	白いシャツを着た女性が路上に立っている。
7人のグループが緑のボートに乗って急流を下っている。	夜、地面で立ち止まったり座ったりしている人たちがいる。
雪の中の犬	雪の中の2匹の犬.
長い髪の男がカメラを通して見ている。	サングラスをかけた男が、まっすぐ前を向いている。
ビーチを走るダルメーション。	ダルメーションが浜辺を走る。
胴上げ犬	庭でジャンプする黒と白の犬。
女性が持っているのは、茶色と白の犬がつけているハーネスです。	フェンスの壁に取り付けられたイーゼルに飾られた作品を見ている男女。
雪の中を走る犬。	雪の中を走る犬。
4匹の黒い犬が草むらを走っていく．	草原を駆け抜ける犬。
赤と黒の服を着た男が、頭でサッカーボールを叩いている。	赤いストライプのサッカーシャツを着た男が、ボールに向かっている。
茶色の犬が草の上を歩いている。	犬が木を追いかける
女の子がジャンプしている。	男の子がロッククライミングをしている。
ビーチでスケートボードに赤ん坊を乗せる女性。	ビーチでスケートボードに乗った赤ちゃんを抱く女性。
黒い犬が明るい茶色の犬の耳を噛んでいる。	リビングルームで遊ぶ黒犬。
ビーグルは海岸の水際を歩いています。	ビーグルは穏やかな海岸を歩いている。
若いピッチャーが投げています。	茶色の犬がフェンスの横の芝生を歩いている。
黒と白の犬が草むらを駆け抜ける。	白と黒の犬が草むらを走っています。
雪の中を走る2匹の犬、1匹はテニスボールを持っている。	少年は自転車で空中を飛ぶスタントをしています。
黒い犬が棒をくわえて草の上を歩いている。	黒い犬がおもちゃをくわえて、草の上を走っています。
雪遊びをする3人の子供たち。	干し草で遊ぶ3人の子供
街中の横断歩道に立っている警察官に向かって歩いてくる男......。	都会の横断歩道で警察官が立っている。
二人が未舗装の道路をバイクで走る。	坂道を自転車で走る二人。
黒と茶の犬が庭で遊んでいます。	黒と褐色の犬は、彼が見つけた何かを追いかけています。
黒い犬と白い犬が道で遊んでいる。	黒い犬と白い犬が一緒に道で遊んでいる。
白と黒の大きな犬が水の中を泳いでいます。	棒を持った白黒の犬が、泥水の中にいます。
笊を頭に乗せた少年がピエロになる。	金属製のザルを頭に乗せた少年。
茶色の犬が野原を走っている。	褐色の犬が舌を巻いて野を駆ける
男の子がボールを持って水の中に飛び込んでいる。	おもちゃを手に水中を泳ぐ少年。
スキューバダイビングの道具を身につけた人が水中を泳いでいる。	青く澄んだ水の中でスキューバダイビングをしている人。
この犬は水の中をジャンプしている。	浜辺で水面を走る2匹の犬。
梁の上に座って休憩している2人の建設作業員。	エレベーターのそばでシャツを着ている男。
男と女の笑い話	男と女のキス
野原を走る黒、茶、白の犬。	白と茶の犬が野原を走っている。
子供たちがプールで遊び、それを2人の大人の男性が見ている。	大人たちが見守る中、子供たちがプールで遊んでいる。
犬が砂の中に立っている。	日焼けした犬が植物の前に立っている。
ビーチでバレーボールをする水着の4人の女の子。	ビーチでサンドバレーボールをする水着の女性4人。
水しぶきを上げる2人の子供たち。	2匹の犬がベッドの上で一緒に遊んでいる。
タイヤのブランコで揺れる金髪の幼児。	金髪の子供がタイヤのブランコに乗っている。
茶色と白の犬は浅瀬を歩いています。	白と茶の犬が水面を歩いているように見える。
公共交通機関で読書する女性。	公共交通機関で居眠りした人
ブルドッグが芝生の公園を走り、その背景には人々が立っている......。	犬が大きな水の中を走っていて、水しぶきを上げている。
レンガの道を自転車で走る少年	木々に囲まれたスロープで、自転車に乗った人がトリックをする。
スケートパークでスケートボードをする青年。	青いTシャツを着た少年がスケートパークでスケートボードに乗って空中を飛んでいる。
駐車場近くの歩道で縄跳びをする少女。	左側に駐車場がある歩道で縄跳びをする少女。
夕日が沈む頃、浜辺で水に浸かっている人。	水上のサーフボードの上にいる人。
犬がフリスビーをキャッチするために空中でジャンプしている。	ピンクのフリスビーに飛びつく茶色の犬。
青と白のショートパンツをはいた子供が、波打ち際でジャンプしている。	緑色の服を着た少女が、両手で何かをひねっている。
犬は主人におもちゃを返します。	3匹の犬が一緒に雪の中を競争する.
女性2人がブランコから飛び降りる。	ブランコから飛び降りる2人の少女。
店の前で熊の像とポーズをとる女性と少女。	ジャージ姿の男が大勢の観衆の前に立っている。
海岸を走る2匹の犬．	浜辺を走る白い犬。
芝生の上でサッカーをするシャツ一枚の男。	シャツのない男がサッカーボールをキャッチする
緑色の服を着た少女が、両手で何かをひねっている。	レンガを背景に、グリーンのショートパンツを履いた少年がぎこちなくポーズをとっています。
逆さ笑い少女	少女が逆さになってポーズをとっている。
オレンジの車のそばでチェッカーフラッグを持つ2人の女性。	古めかしい車の横で、スケスケの服を着た2人の女性がポーズをとっている。
赤いジャケットを着た男性がバイクを持って撮影しています。	赤いジャケットを着た女性が、自然の風景をビデオに撮っている。
少年は混雑していない公共プールに飛び込む．	スノーボードでジャンプする男。
ピエロがカメラに向かってポーズをとっています。	オレンジの服を着た子供がブギーボードで波打ち際にいる。
手をつないでプールに飛び込む4人の子供たち。	雪の中で遊ぶ4匹の犬 .
雪原を疾走する黄色い車。	雪の中、黄色い車が疾走する。
男の子が2つのカボチャを積んだワゴンを押しています。	カボチャを2つ乗せたワゴンの後ろに、子供がしゃがんでいる。
2人のサッカー選手が激しい試合の中でボールを奪い合う。	オレンジと白の2匹の小さな犬が雪の中にいます。
黒い犬は高い草の中を歩いている。	黒い犬が草むらを走っている。
雪の中で遊ぶ2匹の犬.	草原で遊ぶ2匹の犬 .
ある男の子が別の男の子を押してブランコに乗っています。	男の子がブランコで他の男の子を押しています。
マウンドに上がったピッチャーが野球を投げる。	野球の試合中、投球中の少年。
雪の中で遊ぶ2匹の黒い犬。	黒い犬が雪を掘っている。
犬は鎖を飛び越える	鎖を飛び越える犬
木のベンチに座っている黒い財布を持った少女。	黒い財布を持った若い女性が、木のベンチに座っている。
黒と黄の犬	黒犬と白黒犬が野原で遊んでいる。
ボールピットで3人の子供たち。	ボールピットで遊ぶ数人の子供たち。
白とグレーの大きな犬が、障害物コースの黄色いトンネルを走っています。	白と黒の犬が、黄色とオレンジのチューブから飛び出しています。
湖畔の岩場で自転車にまたがる男。	女性は白いヘッドバンド、紫のタンクトップ、黒い手袋をしています。
茶色の犬が緑の草原を走っている。	茶色の犬が川を走っている。
小さな白い犬と大きな茶色の犬が草の上で遊んでいる。	小さな日焼けした犬が、草むらに立っている大きな茶色の犬の横を走っています。
女性が犬を抱いて、もう一匹の犬が近くに立っている野原。	一匹の犬を抱いた女性が、もう一匹の犬を庭で遊ばせている。
小さな女の子がおもちゃの三輪車に乗って、バネの上を走っています。	少女は屋外でおもちゃで遊んでいる。
黒い犬が水の中を歩いている。	雪の中を歩く2匹の黒い犬。
黒い犬が雪の中を走っている。	黒い犬がボールをくわえて泳いでいる。
緑色の服を着た女性が、日焼けした犬と遊んでいる。	寝そべっている女の子の手を舐める日焼けした犬。
ホームレスが2人、段ボールの看板を持って外に立っている。	段ボールの看板を持ったホームレスの若者2人。
女性が水の中に座っている。	公園でスケートをする女性。
茶色の犬は水の中を歩いている．	濁った水の中で、犬が水しぶきを上げる。
花柄のビキニを着た日焼けした少女が、ダークブルーの海で泳いでいます。	花柄の水着を着た少女が砂浜を駆け抜ける
白いヘルメットをかぶったオレンジ色のシャツを着た男が、自転車に乗っている。	青いヘルメットをかぶった男は、ポラリスに乗っている。
ホッケーの選手が下を向いている。	試合中のホッケー選手．
雪の中で追いかけっこをする2匹の茶色い犬。	2匹の茶色い犬が雪の中で遊んでいます。
スノーモービルに乗っている人.	スノーモービルに乗った人がジャンプしているところ。
雪の中、トランポリンで遊ぶ子どもたち。	雪の中、数人の子供たちとトランポリンでジャンプ。
海岸に立ち、パドルでボールを打っている男。	10代の女の子2人がビーチのそばでiPodを聴いている。
このオーバー・ザ・トップの写真は、休憩中の二人の男性を撮影したものです。	水泳帽とゴーグルで息継ぎをしている人。
砂上の楼閣	茶色の犬が2匹、砂の上を走っている。
黒い犬が赤いフリスビーを追いかけています。	黒いプードルが雪の中を走っています。
ポニーテールをした2人の少女が遊園地の乗り物に乗っている。	少女は遊園地の乗り物に乗っています。
砂を掘る犬	茶色の犬が砂を掘っている。
青い水着を着た女性が、桟橋から湖に飛び込んでいる。	青いシャツに青いジーンズの少年が運動場を走る
店先の歩道に座る二人の男。	水着の女性がビーチで犬の散歩をしている。
白黒の犬が小川を飛び越える。	白黒の犬が小川を飛び越えている。
BMXバイクに乗る人。	宙に浮いた自転車に乗った男
高い草の中を走る2匹の犬 .	2匹の犬が草原を走っています。
赤いボールを追いかけるリードをつけた小さな白い犬.	雪の中で棒を返す白と黒の犬。
外野席の人々	外には大勢の人が列を作っている。
棒を持った犬が、水の中で他の犬の後をついていく......。	四輪駆動車が泥まみれで走っている。
裏庭で踊っている4人の子供たち。	カラーマットの上でストレッチをする子どもたち。
2匹の黒い犬が草の上で遊んでいます。	2匹の黒い犬が草原で遊んでいる。
ティーンエイジャーのグループがビーチで空中にジャンプしています。	海辺で、空中に飛び上がる若者たち。
黒と茶の犬が大きな棒をかじっている。	砂浜で遊ぶ白と黒の犬。
少年が線香花火を振り回す	少年が線香花火を空中で回している。
草むらで遊ぶ2匹の黒い犬。	2匹の犬が草むらで遊んでいる。
夜、数人で焚き火を囲んでいる。	夜、地面で立ち止まったり座ったりしている人たちがいる。
二人の少年がプールに飛び込んでいる。	プールに飛び込む2人の少年が宙に浮いている。
ビーチで遊ぶ茶色と白の2種類の犬。	ビーチで砂遊びをする2匹の犬。
二人の少年、一人は帽子をかぶっている、遊び場にて。	遊具の近くに座りながら笑う、日焼けした帽子の少年。
雪の中で遊ぶ2匹の犬.	雪の中で遊ぶ2匹の犬.
女性が赤ちゃんを抱いて、男性がそれを見ている間、子供を抱いた別の男性が見ている。	店内で両手を広げて立つ女性、カメラを構える女性......。
真っ白な雪の中を、白いふわふわの犬が走っている。	雪の中を走るふわふわの白い犬。
新聞を手にする女性	金属製のバーの上をローラーブレードする男。
金管楽器を演奏する男性陣。	外で楽器を演奏する男たち。
岸辺にいる2人の少女が、ボートで釣りをする人たちを眺めている。	二人の男性、一人は赤、一人は白の服を着てバスケットボールの試合をしている。
スノーボーダーが空中に飛び出す。	スノーボーダーが宙を舞う。
赤い耳の白い犬が雪の中を走っています。	赤い首輪をした濡れた黒い犬が川に入っている
小さな女の子と小さな男の子が手をつないで、ピカピカの滑り台に乗っています。	ペイズリー柄のワンピースを着た少女が、砂浜の遊び場を駆け抜けていく......。
フィールドでサッカーをする子供たち。	グラウンドでサッカーをする3人の少年
ロープにぶら下がって歩く男たち。	男たちが大学のフットボールの試合をする。
男が屋上から別の屋上へ飛び降りる。	バルコニーからバルコニーへ飛び移る青年。
黒と赤の服を着た黒人が、黒い傘を開いてベンチで寝ている。	公園のベンチで座って昼寝をしている人、開いた傘が彼を日差しから守っている。
赤いワゴンに座った子供を引っ張って、砂浜を歩く。	少年は、ラジオフライヤーワゴンで、おかしな帽子をかぶった別の少年を引っ張っている。
ビニール袋で遊ぶ2匹の子犬.	庭で遊ぶ2匹の犬。
フクロウは日中、翼を広げています。	鳥は翼を広げて飛んでいます。
青い帽子をかぶった男が、木の下でスツールに座っている。	浜辺に立つ犬と、その近くにあるボール。
ギターを弾く男がマイクを向けて歌う女性......。	ギタリストをバックに女性がマイクで歌っている。
草原で草を食む3頭の羊と、その後ろを歩く1匹の犬......。	草原にいるヤギの小集団と、その後ろにいる白黒の犬。
自転車が岩の間に飛び込んでいる。	2つの岩の間を空中でジャンプする男。
白髭の男が海辺を自転車で走っている。	ビーチでボールをキャッチするために後ろ足で立っている犬。
黒いスーツに身を包んだ男が、打ち寄せる波に沿ってサーフィンをしている。	黒いウェットスーツを着たサーファーが白い波に乗っている。
黄色い建物を背景にピンクの帽子をかぶった少女。	ピンクのドレスを着た少女が、手に何かを持っている。
ピンクのドレスを着た女の子が、白いピケットフェンスに沿って自転車に乗っている。	白いフェンスの前を赤いドレスを着た少女が自転車で走っている。
茶色の毛皮の動物が植物の後ろに立っている。	森に立つと、犬がパンツをはく。
赤いシャツを着た子供が、黒いウェイクボードを使って波打ち際で水しぶきを上げている。	手漕ぎボートに乗った男が、青い海を漕いでいく......。
白と黒の犬が野原を走っている。	茶色と白の犬が野原を駆け抜けていく。
3人の少女が芝生の上に座っている。	2匹のプードルが雪の中を走っています。
山々を背景に未舗装の道を走る茶色の犬。	山々を背景に、岩だらけの小道をカメラに向かって走り出す茶色の犬。
ウッドポーチから飛び降りるゴールデンレトリバー。	ゴールデンレトリバーが木のポーチから飛び降りている。
犬がスロープを飛び降りている。	女の子が砂に飛び込んでいる。
犬が公園で遊んでいる。	公園で犬が柵を飛び越える。
10代の女の子二人、一人は微笑んでいる。	子供用ブランコに乗った少女。
草の中の二鳥	2匹の犬が屋外で遊んでいる。
4匹の犬が雪の中に立っている。	雪の中で遊ぶ4匹の犬 .
雪の上の茶色と黒の犬、歯を見せ、お互いに吠える。	雪の中、黒い犬と茶色の犬が喧嘩をしている。
雪山の頂上に立つ二人のハイカー。	山頂に立ち、周囲を見渡す2人の登山家。
軌跡の上を走る男	徒競走の人
赤い花畑の中の二人の子供たち。	赤い花畑で遊ぶ二人の子供。
岩から湖に飛び込む青年。	赤い水着を着た青年が、大きな岩から水中に飛び込んだ。
小さな黒い犬が草むらにいる。	黒い犬が草むらを走っている。
着物を着た女性がカメラに向かっている。	黒い服を着た2人の少女が部屋に座り、カメラに向かって思わせぶりなポーズをとっている......。
熱気球に火を入れる一団。	茶色と白の馬に乗った大勢の人々。
子供たちが剣で戦う遊び。	子供と親が馬を撫でる。
人は大海原を渡る風である。	犬が海を走っている。
男が階段を滑り降りている。	男は雪の丘をスキーで滑っている。
手をつないで野原を歩く二人。	車の壁画の前を歩く二人の男．
茶色い犬がフリスビーを追いかける	草の上にしゃがんでいる茶色の犬。
黄色い部屋のベッドの上で、黄色い服を着た女性が宙に浮いている。	赤いリードをつけたままの犬が、芝生の上をテニスボールに向かって追いかけていく......。
赤いオーバーオールを着た女性が歩道に立っている。	赤いオーバーオールを着た女性が歩道に立っている。
裏庭の落ち葉の中を犬が走っている。	3匹の犬が野原を駆け抜ける .
草むらで遊ぶ2匹の子犬	二匹の子犬が草原で遊んでいる
明るい色の犬が草むらを駆け抜けていく......。	犬が草むらを駆け抜ける
白と黒の2匹の犬が外で一緒に遊んでいます。	二人の子供と一匹の黒い犬が雪の中で遊んでいる。
水の中を走る3匹の犬．	水の中を走る黒い犬。
レンガの壁に一人座る女	赤いバッグを持った女性が歩いている。
山脈の近くの雪原で、スキーヤーが空中でジャンプしている。	トンネルを見下ろす花壇のそばに座っている女性......。
茶色の犬が棒をくわえている。	棒を咥えて泳ぐ犬。
若い女性が食事で皿にもたれかかる。	若い女性で、ペンキや泥を除いた上半身裸の女性。
犬たちは雪の中で遊んでいます。	海岸で遊ぶ2匹の犬。
赤い水着を着た少年がプールに飛び込んでいる。	プールに飛び込んだ犬がホースで水をかけられている。
雪山を登る人と、それを追う犬。	雪の丘を登る人と、それを追う黒い犬。
茶色の犬が浜辺に座っている。	浜辺を走る犬
スクーバダイバーが水中に沈んでいる。	スキューバダイバーは水中にいる。
男は自転車に乗って未舗装の丘を下っている。	手すりをすり減らす自転車乗り。
大きな灰色の犬が雪の中で遊んでいる。	雪の中で遊ぶ4匹の犬 .
海辺で自転車に乗る男性。	道端で牛を散歩させる男。
2匹の犬が木の前の芝生を走っています。	茶色の犬が木々の前の芝生を走っている。
犬を車に乗せると...	犬がモップに噛み付いている
火のついたものを持つ子供	ピンクの服を着た子供が、燃えているように見える物を持っています。
森の中、カメラに向かって歩いてくる耳のはだけた犬......。	自分の姿を前にした子供が、カメラの方を向いて微笑んでいる。
茶色い犬が、自分で水を振って、水をまき散らしている。	白い犬が川辺に立ち、体を揺すって乾かしている。
岩登り少年	5匹のグレイハウンドが砂のトラックでレースをしています。
白と黒の犬が砂浜を走っている。	黒と茶の犬が雪の中を走っています。
青いトラックの荷台にたくさんの中東系の人たちが座っている。	トラックの荷台に人が乗っている。
雪山を滑走する2本のスキーポールを持った人。	雪山を滑っている人。
ある女性がレストランで魚を食べている。	レストランで大きな魚を食べている女性。
子供と2匹の犬が水遊びをしている。	赤と青の浮き輪をつけた子供が水面を見下ろしている。
石垣の上でトリックをするスケートボーダー。	スケートボーダーが斜面に乗り上げる。
エスカレーターの上に立っている人たち。	エスカレーターに乗る人
アジリティー・コースで犬を走らせている女性。	緑のパイプで愛犬を訓練するトレーナー
白と茶の犬は耳を振っている。	茶色の犬が砂の上を走っている。
スケートボーダーが階段から飛び降りる。	犬が階段から飛び降りる
手を挙げて拍手している子もいます。	3人の子供たちが砂浜でサッカーをしている。
大きな泡を吹く男	大きな黒い馬を歩かせる男。
水辺の桟橋に座る二人。	静かな水の中にある桟橋の端に二人が座っている．
2匹の犬が一緒に走っていて、1匹はアヒルのおもちゃをくわえている。	長い棒をくわえて草むらを歩く白と黒の犬。
白と黒の犬が草の上を走っている。	青い水の中を泳ぐ黒と白の犬。
ホッケーゴールキーパー	ホッケー選手がゴール前の氷の上に横たわっている。
青いスノーパンツをはいたスキーヤーが、ジャンプ台付近で宙を舞っている。	スキーヤーがカメラの前で雪の上に両手をついて立っている。
茶色の犬が草の道を走っています。	茶色の犬が、紐で区切られた草原を走っています。
青いストライプのシャツを着て、ローラーブレードを履いている女の子。	犬に飛び乗る白黒シャツ男
黒い服を着た刺青の男が白いギターを弾きながら歌っている。	黒と白のコートに耳当てをした女性.
浜辺を走る犬。	ビーチを走る少年と少女。
外のベンチに座っている若い男女がキスをしている。	ベンチに座っている男女がキスをしている。
茶色の犬が緑の紐を咥えて飛び上がっている。	灰色の犬が緑色のリードに飛びつき、噛みつく。
黒い犬が草むらを走っている。	草原を走る黒と茶の犬。
歩道に座りながら、携帯電話を耳に当てている女性。	女性が自転車に乗っています。
3匹の犬が草原で遊んでいる.	野原で遊ぶ子供たち。
小さな白い犬が丸太を乗り越えていく。	小犬が丸太の上に乗っている。
赤い玉入れで遊ぶ少年。	青い玉の上に、笑う少年が横たわっている。
波に乗るサーファー。	サーファーが波に乗っている。
雪の中で後ろ足で遊ぶ犬たち。	雪の中で遊ぶ2匹の犬.
スケートボーダーがスロープの頂上に着くと......。	スケーターパークでパイプウォールに乗るスケートボーダー。
落書きされた階段の手すりをスケートボードで降りていく少年。	スケートボーダーが足で手すりを滑り降りる。
黒と白の犬が水の中を走っている。	黒と茶の犬が野原を駆け抜ける。
二人の子供が森の中の道を歩いています。	森の中の道を歩く二人の子供たち。
茶色と白の犬が草の上を走っています。	褐色と黒色の犬が草原を走っている。
浜辺を走る女......。	犬が大地を駆ける
2匹の犬が芝生の上を並んで走る。	草の上を走る2匹の犬 .
二匹の犬が赤い消火栓でおしっこをしている。	2匹の犬が赤い消火栓の上で排尿している。
暗い色の服を着たラグビー選手が、明るい色のラグビーボールを持ち、腕を広げている。	茶色の犬がボールを咥えて水しぶきを上げている。
金色の犬が棒を咥えて草むらを飛び回っている。	黒い犬が赤いものを口にくわえて草むらを走っている。
二人が水の中を歩いている。	レンガ造りの建物の前にある木のそばを、2人の女の子が歩いています。
少女は砂漠の道を走っている。	少女が携帯電話で話している。
白い犬が砂浜でボールで遊んでいる。	黒と白の犬が日焼けした犬と遊んでいる。
水しぶきを上げる犬。	濁った水の中で、犬が水しぶきを上げる。
男は青いボートを操縦し、色鮮やかな家々を通り過ぎる。	青いボートに乗った男が、カラフルな家々の横を通り過ぎる。
大都会の歩道を歩く一群の人々。	トラックの荷台に人が乗っている。
犬は草むらの上の空中にいる。	犬は青いシーツのベッドの上で寝ています。
黒いドレスに赤いアクセサリーをつけた女性が、通りを歩いている。	街を歩く黒いドレスの女性。
黒い犬が水の中を走っている。	サッカーのユニフォームを着た男性が、試合中にサッカーボールを持って走っている。
地下鉄で何かを待っている少女。	薄暗い場所にたたずむ少女。
2匹の犬が草むらで互いに接近する.	芝生の上で2匹の犬が向かい合っている。
男は公園で小さな女の子と一緒に座っている。	男は、毛むくじゃらの小犬と遊んでいる。
大きな日焼けした犬が、緑色のものをくわえて走っています。	褐色の犬が緑色のおもちゃをくわえている。
岸に向かうボートに乗った一群の人々。	教室でプレゼンを見ている生徒たち。
スケートボードで空中を滑走している人。	森に囲まれたトラックエレメントを走るバイカー。
夜、鉄の手すりをスケートボードで滑る少年。	茶色の犬が棒を持って砂の上を走っている。
岩盤の隙間から人が入っている。	中型の茶色い犬が、白っぽい森の中を走っている。
ボールを咥えてカメラに向かって走ってくる犬.	白黒の犬が茶色いものをくわえて泳いでいる。
浜辺を走る少女。	浜辺を走る少女。
球児が投げる	バスケットボールの選手がボールを持っている。
水の上でロープにぶらさがっている人。	湖の上でロープにぶら下がるマルーン色の水着の男。
大きなサングラスをかけた女性が、両手に新聞を持っている。	淡いブルーのトップスを着た太った女性が、シャボン玉を吹いています。
鹿が柵を飛び越える	鹿が柵を飛び越えている。
ミニーマウスの服を着た若い女の子と、歩道を歩く年配の女性。	白いスーツを着た男が新聞を持って街を歩いている。
