ハリウッドは、時折、英国人俳優を善人として起用することを要求されるでしょう。	ハリウッドは、英語のキャラクターを演じるために、英語の俳優を起用することも要求されるでしょう。
彼の「友人」が支配していない州に建設したいからと、ボーイング社のような企業を訴えることは、雇用の増加を妨げることにはならないのですか？	| そのため、彼の「友人」が支配していない州に建設したいからと、ボーイング社のような企業を訴えることは、雇用の拡大を阻害していないのでしょうか？
あなたにとって重要なのは、もしかしたら......。	週に20ドルなんて、取るに足らないじゃないですか。
申し訳ありませんが、agwは証明されています。	agwは証明されていない。
そして、この失業対策法案？	失業保険は？
マイケル・ヴィックが犬を愛するように、我々は軍隊を愛している。	Maher : アメリカは軍隊を愛している ' マイケル・ヴィックが犬を愛するように ' ｜ Newsbusters.org
この「筋書き」はネズミの臭いがする。	この "筋書き "はネズミの臭いがする。
しかし、私が自分に言い聞かせたのは、「私は一生このままで良いのか、それとももっと良いものがあるのか」ということでした。"	だから、「私は一生このままで良いのか、それとももっと良いものがあるのか」と自分に問いかけてみてください。" ... i
そして、そのような経験をした人々にとって、人生は安いものであり、殻に閉じこもった精神は、自分自身や他の人々にとって非常に危険である。	そして、そのような経験をした人々にとって、人生は安く、殻に閉じこもった心で自分自身や他人にとって非常に危険である：しばしば、彼らはマシンが望む目的を達成するための手段として使用されてきた後は、そのどれも問題ではないようです。
過去のプロテスト・アドベンチャーの切ない回想が、自分たちが反対する「反動」勢力の風刺画のようなスタイルとフォームに包まれていることの皮肉。「それでも私はベトナムで戦ったのだ。	過去のプロテスト・アドベンチャーの切ない回想が、彼らが反対する「反動」勢力の風刺画のようなスタイルとフォームをまとっているという皮肉は、私にとってあまりに多すぎた。
誰が利益を得ているか知っていますか？	株主をご存知ですか？
2 ) 私がこう言ったとき--「人種差別の言い訳をすることは、危険な人種差別の一形態だと思う。	5）ドローワンがこれを個人攻撃と見なすのは、あまりに薄情だ--「人種差別の言い訳をするのは、危険な人種差別の一形態だと思うんだ。
それは意味がありません。	それはちょうど意味をなさない。
このメッセージは、2012年1月4日06:06に、ishallriseagainが、彼が撃った子供が黒人だったという理由だけでジマーマンを刑務所に入れるべきだと仮定しているすべての人の周りにめちゃくちゃにしました。	ジマーマンが撃った子供が黒人だったという理由だけで、ジマーマンを刑務所に入れるべきだと決めつける人たちは皆、そうだ。
だから、私はもう彼らをサポートすることはできません。	もうサポートできない。
主張 : パウエルは、イラクが生物兵器を運ぶために特別に設計された長距離遠隔無人偵察機を製造していると主張した。	パウエルは、「無名の情報源」が、サダムが現場指揮官に生物兵器の使用を許可していたことを確認したと主張した。
と、ボランティアの機会とのつながりを支援するものでした。	そして、その人たちとボランティアの機会を結びつけていくのです。
2. 決断にまつわる自分の考えを入れていいのかどうか。	3.決定事項に対して、その時に出した反対意見や懸念事項を含めることができるかどうかわからない。
OK、説明ありがとうございます。	ご忠告ありがとうございます。
を使用した場合、それは大きな主張であるtbhのいずれかの核兵器は、それは非常に驚くべきエスカレーションだろうイスラエルはイランに核爆弾を使用した場合、ショックはありません。	イスラエルがイランに核爆弾を使用すれば、驚くほどエスカレートします。
竹に囲まれ、腹ばいになり、怖い思いをする夢を見た。	それから1年余り、私は竹に囲まれ、腹ばいになり、怯えていた。
流出事故について彼が語ったインタビューへのリンクはこちら。	それが自由というものです。
私はちょうどこのことを得ることはありません。	それはちょうど意味をなさない。
「仝岑っているのは、ケニアで育ったこと、イギリスに対する見方、たとえば平均的なアメリカ人とはまったく違うということです々と、ハッカビーはホストのスティーブ・マルツバーグに語ったと、ワシントンポストが報じている。	そして、ひとつだけわかっているのは、彼がケニアで育ったということです。
このようなお知らせをするのは申し訳ないのですが、これは......その......ずっと前からです。	[ quote = trajan ; 4550118 ] 私はあなたにこのニュースについては申し訳ありませんが、これは以来... ...まあ。
ネオコン/ティーバガーのレトリックを鸚鵡返しするリバタリアンの愚か者・・・そして	それとも、ネオコンやティーバガーの従兄弟のバカさ加減をオウム返しにする、ただのリバタリアンのバカなのか？
それは、あなたが無視することを選択した実質的な低下です。	それがラファーの言っていたことであり、あなたが無視しようとしていることなのです。
Jooz mushyが一番人気でしょう。	mushyが一番人気だろう。
石油会社が抜けていますね、ブラニックス。	opecは石油会社ではない、ブラニアック。
オバマの支持率は50％を下回っているが、4年連続でリスト入りしている。	4年連続で首位に立った。
いずれは、「FBIでフルタイムの仕事をする」ことで良いのではないでしょうか。"	私はもう大丈夫だ、FBIでフルタイムの仕事を得た。
大恐慌以来最悪の経済回復 - フォーブス もしリードとペロシがあなたの主張と私の願い通り実際にGWBを調査していたら、彼と彼の政権や他の戦争犯罪者の多くは今刑務所にいることだろう。	もしリードとペロシが、あなたが主張し私が願ったように、実際にGWBを調査していたら、彼と彼の政権や他の戦争犯罪者の多くは、今頃刑務所にいることだろう。
一方がコンセンサスがあると言って議論を打ち切ろうとするのは、嘘だとわかっている。	何をしようとしているかは分かるが、餌になる人に狙いをつけるべきだろう。
オバマ大統領はそれを倍増させるだろう。	オバマ大統領はその流れを引き継ぐだろう。
GOPは選択の自由のために戦っているのです。	だから、今は選択の自由のための戦いなのです。
だから、今は選択の自由のための戦いなのです。	GOPは宗教の自由のために戦っている。
ゲイは不愉快だし、ロブスターは美味しいし、桃は忙しいんだろうな。	ゲイが不愉快で、ロブスターが美味しく飲めるから？
日本は無条件降伏した。	ドイツは4月に降伏した。
" なぜブッシュ政権の時に赤字について聞かなかったのだろう？"	ブッシュ政権時代に国の借金が2倍以上になったのに、なぜそのことを聞かなかったのだろう？
オバマ政権の誰か、あるいは大統領自身が発した無害なコメントを取り上げ、それについて番組全体を作り上げるリムボーやベックの「意図」は何なのだろうか。	続けて...「オバマ政権の誰かが発した無害なコメントを取り上げるとき、リムボーやベックの「意図」は何なのだろうか？"
私はこのことについて真剣です。	そのどれもがよくわからない。
イスラエルのメンタリティを考えると、イランを攻撃するのは目に見えている。	イスラエル人のメンタリティを考えると、イランに核兵器が打ち込まれるのは間違いないだろう。
今年のことではないんだ、マギー。	時事問題の話じゃないんだから．
すでに学校では、同性愛について教えられています。	現実には、学校を実際に改善することは、誰の目にも明らかではありません。
ブラウン氏は、英国で最も上級の公務員である内閣官房長官に、将来の連立政権の可能性をめぐる協議に関与する可能性のあるすべての政党への支援を手配するよう依頼したと述べた。	「私は内閣官房長官に、政府樹立の議論に従事している政党の要請に応じて、公務員が支援を提供できるように手配するよう要請した。"
- ビデオでは、白人農家への「全面的な支援」を行わなかったと言うUSDA職員が映し出されている 日付は7/20。	- ビデオは、彼女が白人農家にヘルプの "全力を与えなかった "と言って、USDAの職員を示している それはあなたがより少なく愚かな表示されるように、投稿する前に、スレッド全体を読んでみてください。
wikipediaの記事をもう少し詳しく読むと......。	この分野の他の専門家が言っていることを読む必要がありますね。
私は悪いと言わざるを得ないし、以前、本当は病気ではないのに病欠の電話をしたことがあります。	私は猫でないときに病気で呼ばれた...ではない。
カリブ海全体が汚染されているのです。	カリブ海全体が毒されている？
その記事全体を読む人は、投稿者の6％しかいない。	もしRdeanが知的なオペレーションの組み立て方を知っていたら、その記事全体を読むのは投稿者の6％だけだと想像してください。
この件に関する陪審員の指示は、明らかに修正第一条の保護に関する問題を彼らの膝元に置いた。	陪審は法律に基づいて請求され、この場合の重要な事実は、言論の自由と憲法修正第1条の保護でした。
ところで、超委員会の交渉の真実は、民主党が1つのプランも出さなかったということだ。	民主党がクリントンに宣誓下で嘘をつくことを許したとき、その前例ができたと言えるでしょう。
この事故はまだ調査中であるため、関係者は匿名を条件に話した。	匿名を条件に語った関係者は、カブールのアフガニスタン人将校から情報を得たと述べた。
アポロのようなプログラムを維持するビジョンも勇気もない。	アポロを「維持」するビジョンがないのか？
人々はクリントンの嘘を許したが、それはその質問がそもそもされるべきではなかったからだ。	そもそも起訴されないように糸を引いているのだから、弁護士など必要ない。
お気に入りのマグカップの取っ手を使い果たした。	コーヒーテーブルの仕上げが剥がれてしまった。
彼らは、フォックスニュースがニュース価値のあるイベントを報告するため、フォックスを持っている"。	必要だと思ったから、お金を貯めたんだ。
バブルとは、何らかの理由で人為的に高騰した市場のことである。	私の理解では、「バブル」とは、人為的に支えられているセクターのことです......にもかかわらず。
それは、右派、その「道徳」の党は、「低い」基準を持っていないためです。	なぜなら、彼らは亡くなった人たちの墓に小便をかけているようなものだからです。
つまり、あなたのようなハッカーが言うことの10％でも真実であれば、この素晴らしい国は1777年に崩壊していたということですね？	先ほども言ったように、もし右翼の女たちが言った出鱈目の10％でも本当だったら、我々の素晴らしい国は1777年頃に安いスーツのように折り畳まれていただろう。
私は、唯一の解決策が、最小限の、証明されていない利益のために何兆も費やすことであるとき、私は嘘つきが左翼であることを知っています。	イラン問題は、アメリカや西側世界の問題ではなく、イスラエルの問題だと思います。
アメリカンフットボールをやめることになる。	さらに、野球をやめることになる。
しかし、私は、当時私が提起した反対意見と懸念事項、そして反対した理由を記載しました。	3.決定事項に対して、その時に出した反対意見や懸念事項を含めることができるかどうかわからない。
ありがとうございました。	ご心配ありがとうございます。
だから、彼は「自作自演」なのだ、そのことをとやかく言うのは結構なことだ。	もし、それがセルフメイドマンでないなら、私はそんな人を聞いたことがありません。
There goes troubleに賛成です。	私はこのスレッドを終了します。
不況は隣人が職を失うことである。	うつ病は、自分を見失ったときに起こる。
何を言っているんだ？	いったい何なんだ？
オウは、教育も努力もしないで高い給料を欲しがる甘ったれたガキどもだ。	彼らは皆、甘やかされた子供たちか、他人に自分の面倒をみてもらいたい泣き虫の大人たちだ。
観察可能な現象である限り、人種が有効な生物学的現象でないことは関係ない。	アメリカ人であることは、生物学的な現象としても有効ではありませんが、それでも、皆さんは自分のことをアメリカ人だと考えています。
オバマ大統領はその流れを引き継ぐだろう。	オバマ大統領は素晴らしい仕事をしている。
言い訳したっけ？	どこにそんなことが書いてあるんだ？
社会主義者/進歩的な人たちを悩ませていることは知っていますが、それが現実なのです。	社会主義者/進歩主義者は、本当に迷っている。
イスラエル人のメンタリティを考えると、イランに核兵器が打ち込まれるのは間違いないだろう。	を使用した場合、それは大きな主張であるtbhのいずれかの核兵器は、それは非常に驚くべきエスカレーションだろうイスラエルはイランに核爆弾を使用した場合、ショックはありません。
悲しいことに、そのときすでに、私たちはアメリカの街頭やキャンパスでの政治戦争に敗れていたのです。	政治的なレトリックが、人々に暴力を振るわせることができるかどうかということです。
08年末の「ティーパーティー」はどこへ行ったのか？!!!?????	しかし、一般市民のお茶会はどこにあったのでしょうか!!!!!!!!!??????
反ユダヤ主義者とナチス、私たちはすでによく知っている。	陰謀を利用するキャリアと彼らが利用する狂人、我々はすでに精通している。
犯罪者が危険な状態になった後、長い間拘束されている有名な犯罪がいくつもあると思うのですが。	私はまだ、彼ではなくメディアが単独で悪いという理由で、ローナーの犯罪を免責する人を聞いたことがありません。
彼は今、コンタクト・オーダーのために裁判所に行きたいと言っています。	この件に関しては、誰かが刑務所に行く必要があります。
あなたは時事問題にも関心があるのですか？	時事問題の話じゃないんだから．
視聴率のために憎悪を煽るようなことはしないのでしょうか。	レースベイトが嫌いなのかな？
6ヶ月はファイナンシャルプランナーが推奨する最低ラインです。	それに加えて、彼らの経済的なコネクションの崩壊もある。
rslw : なぜなら、彼らは恐ろしい、ファシストのスキンヘッドの野蛮人だからです。	VOR : あなたは、彼らが恐ろしい、ファシストの野蛮人だとは思わないのですか？
政府 - 過去の債務残高 - 2000年から2009年まで、そして今、あなたのオシアはその2倍になろうとしています。	政府 - 過去の債務残高 - 2000年から2009年までの年次 2009年の債務残高は、ブッシュ政権の会計年度からのものです。
つまり、歴史学の学生として...	大学在学中
あなたのバカな質問の99.99％のように、それはその致命的な欠陥の前提のために答えに値しない。	それは愚かな質問で、答えるに値しないものでした。
私たちの国は法治国家であり、人間国家ではないはずです。	アメリカは法治国家であり、人治国家ではないと？
凍った道路を運転して大破することは、何千人もの人々に影響を与えるまでは、連邦政府の問題ではありません。	毎冬、凍結した道路を運転することで、何千人もの人々が影響を受けています。
私の理解では、「バブル」とは、人為的に支えられているセクターのことです......にもかかわらず。	バブルとは、何らかの理由で人為的に高騰した市場のことである。
長崎と広島については、適切な処置がとられた。	問題は、私たちです。
私はこのままではいけない、だから彼の長期的な意図を知る必要がある。	私は鈍感なつもりはないが、なぜあなたは彼の長期的な意図を見つける必要があるのですか？
スナイダー事件では成功した。	というのが、全体のケースです。
もし、あなたの問題が銀行にあるのなら、銀行を訴え、彼らからいくらかのお金を引き出すようにしましょう。	訴えて、金を巻き上げよう。
朝5時半に電話をかけて、どこにいるのか確認しましたが、返事はありませんでした。	というメールを送ったが、返事がない。
幸運を祈る 社会保障制度は結婚とは関係ありません。	実は、社会保障制度は、その管理方法において、結婚と関係があるのです。
ハンマーで殴られるようなものです。	彼は軍隊に対して暴言を吐いているわけではありません。
権利獲得のための豪華列車は、線路から外れて豪華なものがなくなっている。	この列車は、肉汁を使い果たした。
そして結局、ブッシュの世論調査の数字は、彼の支出のためにドレインを循環していた......	を、ブッシュの赤字支出について叫んでいたティーバッグの人たちを教えてください。
という気持ちを抑えられない。	このような考え方をやめたいものです。
興味深いことに、双方は、残りの「眠っている」抗議者たちを建物から追い出すという申し出を拒否した。	なぜウォーカーの取り巻きは「眠っている抗議者」の退去命令を拒否したのだろう？
寝室から政府を追い出す時だ。	訴えて、金を巻き上げよう。
憲法修正第1条が適用されるかどうかは、彼らの判断にゆだねられていた。	陪審は法律に基づいて請求され、この場合の重要な事実は、言論の自由と憲法修正第1条の保護でした。
犯罪捜査が行われたことはあるのでしょうか？	調査すらされていない。
パッと消える : 見せないというだけで。	読みたくないし、走りたくないけど、何を言っていいかわからない。
が可能かどうか、どなたかご存知ですか？?	どうやったらそんなことができるんだ？
もし、宇宙船の重量を減らすために使われなければ、このような技術は存在しないでしょう。	と思うかもしれませんが、そうではありません。
民主主義国家であり、定期的に政権が変わるが、その多くはクーデターによるものである。	私は、彼らをこのように扱う政府の側が本当に恥ずべきことだと思います。
には、「先生」になるための行列ができています。	あなたは、このネオコン/ティーバガーのbsで愚かな変人であるのですか？
申し訳ありませんが、あなただけではありません。	お悔やみ申し上げます、これは便利かもしれません。
自分も友人に何を求めるか自問自答してみる。	私は外に出て、新しい友達を見つけた。
それが、私たちが直面していることであり、世界規模で競争しなければならないことなのです。	これが、私たちが恐れていたことだったのです。
そのグラフのもう一つの部分は嘘です。	この研究の他の部分には、方法論に欠陥がある。
私は、ほとんどのイギリス人が怠け者で働けないとは思っていませんが、仕事に対して非現実的な期待を持っていると思います。	ほとんどの英国人は、キャリアアップのための経験を積む前に、底辺で退屈な低賃金の仕事をしたがらないと思うんだ。
それはあなたの仲間の責任ではありません。	しかし、あなた自身のミスや銀行との問題のために、あなたの仲間の市民が支払うことを要求しないでください。
どうなるんでしょうね。	そして、彼は自分の大切なものにお金を使った。
国営放送のティーザーでは、明日（水）の朝刊で最低賃金の話があると言っている。	また、ブッシュ政権は最低賃金の引き上げに賛成していないことにも触れている。
それが私の支えです。	現在は解除されています。
あなたは、1945年に日本が原爆投下前に何度も降伏を申し出たと主張しています。	日本が降伏する準備ができていたという嘘は、歴史修正主義者です。
それは、彼が愚かだからではなく、彼の暴言には信仰が多く、批判的思考が少ないからです。	私は自伝のファンではありません、彼らは私が気にしない多くの情報を含んでいるので。
政府 - 過去の債務残高 - 2000年から2009年までの年次 2009年の債務残高は、ブッシュ政権の会計年度からのものです。	ブッシュ政権初期の「住宅」バブルのように。
彼らは、脂肪、怠惰、無学、低スキル、依存の労働組合員を運ぶことなく、独自の契約を交渉することができます。	他の人はいつものように自分の意見を持つ権利がある、我々は同意する必要はない、そして我々が今まで同意する可能性はほとんどない。
として私を識別しない、本物のプリソン。	政府は理由があって存在する。
債務奴隷制度は、階級闘争のようなものです。	債務奴隷のヒントです。
伝える必要は全くありません。	誰も他のことについては話したがらない。
最近、こんなゴミを真に受ける人がいるのでしょうか？	が可能かどうか、どなたかご存知ですか？?
自分のミスを他の人のせいにしているようにしか聞こえない。	失敗から学べばいいのに...。
しかし、地政学的に大きな影響を与えることなく、ただ核爆弾をばらまくことはできません。	イランへの通常攻撃は、大規模な地政学的結果をもたらすだろう。
そして、哀れなシャーリーが辞任に追い込まれたとき、FOXはちょうど今夜、オバマが「無実の」女性をバスの下に放り投げたというレポートを発表したのです。	USDAとNACPは、シェロッドさんを投げ飛ばす前に、その話を検証するべきだったのです。
しかし、アメリカの警察は、基本的にこのシナリオをすべて作り上げ、彼をそこに導き、彼を養ってきたのでしょうか？	しかし、悪夢のシナリオは、彼が生きていて、裁判を待っている勾留されていることです。
私は何度か心配事を紙に書きましたが、大部分は対面か電話で済ませました。	電話では苦情を受け付けないが、書面か電子メールでなければならないとのことでした。
そして、彼女が言ったことに反論する他の人たちを見つけたのです。	は、父親が死亡したときにそれを継承しています。
人生、うまくいくことを祈るしかない。	学生時代からずっと仲良くしていた友達とも付き合わなくなったし。
私はあなたに同意します、その皮肉な物語も。	それなら、鳥は心配することはありません。
してもいないことで逮捕はできない．	そして、彼らは何か他のものからお金を話しているのです。
この抗議は、アビシット・ベジャジバ首相に、和解委員会が来月に憲法改正を提案する準備をしているので、憲法改正の計画を急ぐよう圧力をかけるかもしれない。	しかし、タイのアビシット・ベジャジバ首相が、彼の辞任を求める反対派の赤シャツによる暴力的な抗議行動を鎮圧するために非常事態を宣言してから1週間が経ち、衝撃の波は、分極化し、揺らいだ国民にまだ波紋を広げています。
rslw : いいえ、なぜ彼らを嫌いになるのでしょうか？	なぜそんなにアメリカが嫌いなんだ？
私は電話をかけ直したのですが、その女性は、あなたが電話に出なかったので、申し訳ありませんが、電話に出たリストの次の人に仕事を提供しました、と言ったのですが、私には何の意味もありませんでした。	私は彼の目を見て、この若い私は彼らがしなければならなかったことをした、彼らは後悔したり、悪いと感じることはありませんし、それはもっと早く行う必要がありましたと言いました。
そして、デトロイトのある郡も彼に投票したのですか？	そして、どうでしょう、レシートはほぼ同じままでした。
この国には「正義」の格差があり、それは深刻なものです。	この件に関しては、裁判所が判断するのは難しいでしょう。
1959年春、サウスカロライナ州グリーンヴィルのスターリング高校を卒業。	1963年4月、5月、6月、ノースカロライナ州グリーンズボロで公民権運動の指導者となる。
私は学校を出て大学に行ったとき、私の友人はすべて学校の6年生に残っていたことを覚えています。	この9月、私は家を出て、大学に入学しました。
オバマはロシアが軍事的に追いつくのを許しただけでなく、衛星を修理できるようにするためにロシアに依存するように仕向けている。	ロシアが宇宙ステーションにヒッチハイクをさせたり、通信衛星を修理させたりするのを信用できると思うか？
政府が独占（ケーブル）を解消しないなら、独占を強要していると言うのですか？	我々の政府が金によって運営されていないと考える人は、愚か者である。
組合が通常行うように、彼らは職場で警官を維持するよりも、彼らがいるレベルで彼らの利点を維持することを選択し、レイオフが起こった。	労働組合は、5年生の教育を受けた労働者がハンマーを手にする以外の技術を持たない人々のためのものである。
これは法律を守っているのか、それとも単なる武装強盗なのか？	彼の死によって「テロとの戦い」の規模が縮小されるとは思えません。
もし政府が医療を提供すれば、この法案に明記されているかどうかにかかわらず、医療は制限されるでしょう。	そして、新政府はしばしば、少なくともしばらくの間は、国民の生活を向上させることに注意を払うのです。
非常に屈辱的で、誰にでも起こることです。	法律はみんなのものであるべきです。
彼が選ばれたことにショックを受けている・・・。	スナイダー事件では成功した。
今、数人を養っても、この現実は何一つ解決しない。	今、この人たちを養って、将来、その10倍の人たちが苦しむようにすることが、より親切で人道的なことなのでしょうか？
低姿勢に腹が立つが、その後の散文がとてもいい。	そして、彼女が言ったことに反論する他の人たちを見つけたのです。
そして、それはオバマの経済的抑圧の下で労働力を逃れてきたすべての労働者を含んでいない。	そして、それが私のキャリアアップの原動力となったことは確かです。
あなたがしたことは、あなたの完全な無知を証明することです。	もし私があなただったら、人前であなたの無知を表明するのは恥ずかしいと思うでしょう。
私は喜んで、私が実際に言っていることを説明したのですが、あなたはそれを聞かず、単に非難を始めたのです。	これは囮捜査なのでしょうか？ 彼は実際には何もしていません。
補助金という概念そのものではなく、補助金そのものの性質が問題なのです。	この研究の詳細が明らかになれば、ぜひ読んでみたいものです。
それは「大幅な低下」ではない！？	これは絶対に許せません。
しかし、あなたは、あなたのクライアントが緩んできて、再び雇用を開始したと言いました。	もしそうなら、過去の鉱業の規制緩和を記事にすることはないでしょう。
このような小さな学区では意味がありません。	彼は2年連続で、地元の科学専門学校のワークショップに選ばれました。
ウィリアム・ヒルは、今年首相が退陣する確率を5/1から9/4に引き下げた。	ラドブロークスは、ジョン・プレスコットが次期首相になる確率を、賭けが殺到したため、100/1から25/1に引き下げました。
そうなんです、彼らはそれに乗っているんです。	ハッタリだと思う？
具体的に何を求めているのかわからない、だから私は情報の総ダンプを行うでしょう。	時間があれば（明日）、これらの情報の出典をお知らせします。
もし「犯罪はそれを犯した犯罪者に始まり、犯罪者に終わる」のであれば、なぜ19人の行動に対して宗教全体の責任を問うのでしょうか。	いつ口座に振り込まれるか教えてほしいと頼んだら、それは無理だと言われました。
だから、臓器移植のために自国民を切り刻む中国のような国との自由貿易を主張したのだ。	歴史的な記録に基づいて、その回復は2ヶ月ほどで、差し迫っていた。
ああ、きっとできるだろう......そうでないことを、心から願っている。	私はあなたが良い人だと感じています、私は本当にあなたが好きです。
そう、アメリカは地球温暖化防止のためにできることをすべてやっているわけではない、では誰がやるのか？	そして、温室効果ガスに対して経済的にできることは何もない、と。
私と2人の妹は彼女の家を探しましたが、どこにも見つかりませんでした。	キャンプして帰ってきてから、あちこち探しましたが見つかりませんでした。
「スマートなものは、彼にとってはちょっと手が届かない。	私は、ニュートが最も正確で率直だと思う。
もしRdeanが知的なオペレーションの組み立て方を知っていたら、その記事全体を読むのは投稿者の6％だけだと想像してください。	彼女の話を聞いている間、人種差別主義者たちが拍手をしているのを聞かなかったのだろうか、彼女が最後に何を言ったのか知らないまま。
そして、彼らは間違いなく他の誰かの避妊と中絶のために支払うために誰かを強制するべきではない。	そして、そのお金が中絶を幇助していることに何の汚点もないでしょう。
人々が言っている「効果」は、票を動かすための単純な政治的レトリックではありません。	政治的なレトリックが、人々に暴力を振るわせることができるかどうかということです。
ステレオタイプに固執することは、LGBTコミュニティに対して否定的な、あるいは改まらない見方をすることになる。	人々は、キャンペーンを続け、可視性を保ち、LGBTコミュニティの肯定的なイメージを描く必要があります。
国民は知る権利がある"	それは正しい方法ではありません。
それが、いわゆる「自由貿易」の本当の目的です。"	それが「起業家精神」の糧となるのです。
誤解しないでください、私は受け取るために与えることはしませんが、もしこれが他の方法で起こったとしたら、私は愕然とするでしょう、彼女はただ、あーありがとう、私はあなたのカードにお金を入れるのを忘れたに違いない、そしてそれはそれでした。	しかし、彼は決して私に迷惑をかけることなく、ただそれを期待しているのです。
そして、ほとんどのアメリカ人もそのように見ていると思います。	政治家の中には、人間の弱さを利用する者もいる。
そして、労働組合をつぶす「労働権法」を主張した。	私は自分のビジネスを持っていますが、仕事はほとんどありません...。
次の大統領、ジョージ・H・Wの歪んだ傾向。	彼の拒否権行使は、我々の歴史の中で最も強力な大統領のカンフーであった。
と心配するのはやめましょう．	うまくいくといいんだけど．
この国では、政府による強制でない独占は一度もなかったのです。	NBAは、政府が強制する独占の典型的な例である。
これが一般的なことなのかどうかは分かりませんが、私の場合はそうでした。	社会主義者/進歩的な人たちを悩ませていることは知っていますが、それが現実なのです。
クリスチャンとして、私はこれらの憎むべき批評家たちに同情し、彼らのために祈ります。"	レビ記の上の節は、不道徳な行為とそれに対する罰則を列挙した聖書の一節です。
その陰惨な独裁体制は、かつてソビエトが支援していたようなものです。	一人当たりのGDPははるかに低く、弱者は政府から無視されている。
配偶者」が存在しないため、従業員は健康保険の雇用者負担分を負担することになります。なぜなら、配偶者のために雇用者が提供する健康保険に対する税のペナルティが免除されないからです。	そのような利点は、配偶者を持つ軍人は、その配偶者のために住む場所を提供するために、ベースハウジングまたは追加の給与のいずれかを受ける資格があることです。
これは、退役軍人を雇用する企業や法人への減税措置です。	ここでは、12〜14週で受診することも珍しくありません。
この攻撃で連合軍の乗組員2名が負傷した。	南アフガニスタンでは、NATOは2人の連合軍兵士が金曜日に1人、土曜日にもう1人殺されたと発表した。
いいえ、その前兆は、FBIに嘘をついて有罪になった後、ビル・クリントンがヘンリー・シスネロスを恩赦したときに設定されました。	当初は看板が立っていたのですが、目立ちすぎるということで撤去されたようです。
george0b1 このスレッドでは、誰も北ベトナムについて良い言葉を言っていません。	従来の見解では、アメリカとロシアはベトナムの体内で争ったということです。
だから、それは他のものなんでしょう？	ということで、これでおしまい。
共和党のチャールズ・パーシー上院議員の秘書が、私に興味を持ちました。	@ dlowan , " 何世紀もの間、中国人は古代の呪いを使っていた：「面白い時代に生きられますように！」。'
現在、保守党の得票率は37％、労働党は28％、自由民主党は23％である。	投票率はわずか1ポイント上昇しただけで、議席を減らしている。
そのような産業が再規制されることを許すはずがない。	規制機関はいかにして「規制緩和」されるのか？"
大人用でした。	彼らはフォックスとラッシュによって洗脳されている。
オバマの支持率は50％を下回っているが、4年連続でリスト入りしている。	2008年の状況を見ると、彼らは基本的にブッシュの4年後に投票したのです。
笑）。あなたは、トーキングポイントをよく勉強していますね。	なぜ、自分の都合のいいように話を進めないのか？
地球寒冷化を予測した論文は非常に少ない（合計7件）ことがわかった。	驚いたのは、1970年代でさえ、30年間の冷却を背景に、CO2による地球温暖化を予測する論文が、冷却よりも多いことです（合計42本）。
同胞の米国人を憎まないでください。	嫉妬や恨みを買わないでください。
共和党が犯した唯一の間違いは、オバマケアの廃止と、予算を4兆円削減するライアン予算を通過させることと引き換えに、債務上限を引き上げることに投票したことだ。	( 戯言その2。彼と民主党は、債務上限を引き上げる交渉をしたが、そのインクが乾く前に、その取引を破棄し、さらに1兆6000億ドルを赤字にする彼の「刺激策2」の希望リストにそれを結びつけようとした!)
この件に関して陪審員を信頼することの唯一の問題は、彼らが決定するために法律の問題を与えられたということです。	この件に関する陪審員の指示は、明らかに修正第一条の保護に関する問題を彼らの膝元に置いた。
OK、それは良いポイントです。	これは良いアイデアだと思います。
しかし、レイオフにもかかわらず、フリントでは殺人とレイプが11％減少しています。	ええ、幼児のために、最年少のティーンエイジャーはすでに喫煙や飲酒をしているので。
結局、朝の6時頃に連絡がつき、仲間の家にいると言っていました。	彼は「友人」のところに滞在していたのですが、帰ってこないと言われたのは、私の要求が高すぎたのでしょうか？
個人の責任と説明責任に何が起こったのか？	自分の行動に資金を提供するのは、個々の市民の責任である。
ありがたいことに、サイレントマジョリティーは圧倒的にこの計画に賛成しており、反対派は人口の大半とはかけ離れた、ごく少数のフリンジ圧力団体である。	そして、彼らがそこにいる唯一の理由は、非常識な住宅ローンの実践とあらゆる点で同じである非常識な学生ローンの実践のためである。
右翼の「バイナリ」世界では、すべて嘘か、すべて福音の真実かのどちらかです。	これが右翼の人たちが真実を扱う方法です。
しかし、何よりも、彼は政治家としてキャリアを積んでいるわけではなく、彼の職業は実は学術的なものであり、その一部は彼も学んだ米国である。	しかし、そうではなく、まるでマッケイリーのメモを受け取り、それを上司に転送したかのように振る舞っています。
私はオープンマインドで、他の人がするように個人的に物事を取ることはありません。	私はキャンペーンには賛成ですが、これは本当に行き過ぎた行為だと思います。
神、ゲイ、銃に絞りました。	私は読みたくないし、ハンも走らない。
彼らは、政府が保険会社にサービスを売ることを義務づける権利があるという考えと戦っているのです。	投票率はわずか1ポイント上昇しただけで、議席を減らしている。
そうでなければ、他の情報は与えられません。	シリアにもクルド人がいると思います。
私は、何事もありのままに受け流そうとはしない。	私は、お客様が誤解されたと感じることで、自分自身のための問題を作成する必要はありません。
とはいえ、携帯法の有効性と妥当性を証明するために、逸話による証明を使おうとしていることには注意したいですね。	私たちは何度も何度も、裕福なコネを持つ人々のための法律と、平民のための全く異なる法律が存在することを見てきました。
何十万人もの人々が即座に蒸発し、その国籍が理由で帳消しにされると信じているのでなければ、そんなことはないでしょう。	しかし、これらの人々が、彼らの国籍の国である英国に住む権利すら与えられていないというのは、まったく別の問題なのです。
まず、パニックになったり、焦ったりする必要はありません。	クリスティは糞デブだ。
< 肩すかしを食らったようなものだ。	うーん、どうしたらいいんだろう？
ジョージ......人が人生で学ぶべき最も重要なことの一つは、思い込みをしないこと、そしてもう一つは、ある状況下で起こったことについて、個人的な経験に基づいて自分自身の認識を深読みしないことです。	私たちはみんな違っていて、それぞれ違ったバックグラウンドを持っていて、あるものは事実に基づいて、あるものは個人的な経験によって曇らされた、異なる認識に基づいて物事を見ています。
あなたは賢く見せようと必死で、こんな作り話をしなければならないのでしょうか？	この件に関しては、まだ誰も投稿していないようです。
組合が自動車産業をいかに破壊したかを訴え続けてきた共和党を、本当に怒らせてしまったようだ(笑)。	これで、ブッシュの国家債務があと1兆円増えたことになる。
それは本当に簡単なことです：みんなの寝室から出て行って、経済の心配をし始めることです。	先生方の推薦でヘッドと話したかったのですが、彼は本当に忙しそうでした。
弱者を殺せば、残りはそれほど高くはないだろう。	私は怖いし、夫はあまり話さないが、彼も緊張している。
配偶者がいないとは、社会保障制度の下で家族関係がないことを意味し、生存している配偶者は、自分より高い場合、働いている配偶者の率で給付を受けることができます。	9. 「配偶者」がいないとは、配偶者が移民目的のために配偶者のスポンサーになれるような家族関係を確立していないことを意味します。
私は肥大化した支出が嫌いです。	読みたくなかったし、走りたかった。
私がお金に関する決断をするたびに、彼は友人に小さな「ビッチ」にならないようにと言われているようです。	しかし、モロッコは非常に多様な国であり、ある地域で正しいことが、他の地域では正しくないかもしれません。
1963年4月、5月、6月、ノースカロライナ州グリーンズボロで公民権運動の指導者となる。	1966年春、SCLCの「ブレッドバスケット作戦」シカゴ支部の責任者に就任。
そして、今日起きていることは、その「後方」で起きていることなのです。	彼の話を聞くのをやめたのは、彼がとんでもなくネガティブなナンシーだからだ。
あなたのいずれかが家を買うためにVAローンを使用し、その後、あなたが借り換えによって束を保存しますと言って合理化借り換えの手紙の多くを受け取ったことがありますか？	VAローンを利用し、その後、合理化プログラムを使って借り換えた場合、私はそれについて聞くために興奮しているだろう！？
以前は2:30pmとしか書いていなかったのが、この前変更され、他の人のイニシャルが入るようになりました。	司法制度は茶番であり、我々はそれを知っている。
私は私が言ったことを言いました、そして、あなたが理解力の問題を抱えている場合、私はあなたを助けることはできません。	私はこのサイトの向こうで彼女が何を言ったか読んでいませんし、彼女が何を言ったか気にもしていません。
完璧な国はありませんが、この国は地球上のどの国よりもはるかに優れています。	私たちの国は法治国家であり、人間国家ではないはずです。
今世紀半ばに予想される産業革命以前の水準より2℃高い気温になったとき、つまり今生きている多くの人々が生きている間に、深刻な影響がどんどん出てくることを、研究は示唆しているのである。	しかし、今世紀後半に予想される3℃台まで気温が上昇すると、これらの影響は致命的になります。
シラクは宗教的な暴力が始まる前にそれを防ぎたいと考えているのかもしれない。	これは、私が何か愚かなことをする前に、助けと指導を求める最後の嘆願だと思います。
残る問題は、「いつ」「どの程度」かということです。	もちろん、そうではないが、問題はイスラエルが攻撃するかどうかではなく、いつ、どのように攻撃するかということになりつつある。
月に向かってジャンプすることができます。	この事件については、以下の記事をご覧ください。
ということでしょうか？	これは賢明な選択だと思うのですが。
"私はあなたの宗教の自由を支持します" "彼らはやりたくないことをするようにあなたのメンバーに強制する。"	残酷に聞こえるかもしれませんが、私はこの事実とこれだけで、選択の自由が勝つと主張します。
これは、まさに、そうではないでしょうか？,	これはロケット科学ではありません。
同意 - この亡くなった馬を売り出す必要はない。	伝える必要は全くありません。
これはアメリカだけの問題ではなく、世界の問題なのです。	すべてアメリカのせいだと言うのは、正しいとは言えません。
これを聞いて、ちょっと信じられないと思う人はいませんか？	このような感覚をお持ちの方はいらっしゃいませんか？
しかし、私はGZモスクに反対しています。それは、REVEREが提唱したのと同じ理由です。	それが、私がこの幹細胞というものを奇妙に思う理由の一つなのでしょう。
マーシャルの時 - 8週間（でも一人目は未熟児だったので、通常より早く診てもらえました）今の妊娠の状況は、1回目の診察の時です。	私はデートのために9-10週でマーシャルと私たちを取得し、私はこの妊娠にもっと確信していたならば、我々は持っていなかっただろう。
それは、神やサタンが私にそうさせたと主張する人たちと同じように、かなり突飛な議論です。	これほどまでに事態が悪化しているのは、かなり悲しい時代の流れだと思います。
あなたが私と議論し、私を侮辱するのに苦労している間、私の他のポイントを証明するために、再びありがとうございます。	あなたが無知な糞野郎で、考えるのが面倒で噂と現実を区別できないという私の主張を証明してくれてありがとう。
あなたは、誰かがより良い気分になると言って、より良い気分にさせることはありません、あなたは、彼らが何が間違っているかを理解するのを助けることによって、より良い気分にさせる。	お子さんも心配されているでしょうし、ママが動揺しているのを見て心配するよりも、あなたが気持ちを伝えてくれた方がありがたいと思います。
って、みんな学習しないの？	大学の成績は？
というわけで、これでおしまい。	マジで、それは本当です。
プロテスタントの人たちは、指導的立場にある人たちをみんな反キリストだと思ってるんだ。	誰もがあなたのように感じることがあると思います。
そして、ジェシー・ジャクソンはアメリカ人の生活に何を貢献したのでしょうか？	私はこのスレッドや他のスレッドでジェシー・ジャクソンと議論することを拒否します。
また、彼に対する差止命令の取得についても尋ねると、差止命令の取得を支援するための女性援助の番号を教えてくれました。	私は「電話番号を教えてください」と言うと、彼女は「保留にします」と言いました。
彼はあなたと結婚し、あなたとの子供を持つことを選び、あなたを無条件に愛しています。	彼らは、追加費用なしで避妊を提供しなければならないことについて、道徳的な問題やいかなる種類の問題も提起していない。
彼らはウォール街に納税者の金をすべて渡した。	彼らは、政治的な力として自分自身を殺している。
そして、私たちの両方を失うことになる。	そしてもちろん、ポピー・プロパガンダも。
もし人々が助けを必要としているなら、慈善事業や地方政府では十分でないと仮定して、その費用を他の人に課税すればよいのです。	何百万人がガンのような悲惨な医療問題を抱え、何百、何千人が自然災害の問題を抱えたとして、その違いは何でしょうか？
米国での殺人は、米国での日常生活の一部に過ぎない。	ebayを利用しない理由と同じです。
ジマーマンが正当防衛をしたように見えれば見えるほど、この事件のことを耳にすることはなくなるでしょう。	この国の大多数は神を信じており、神が我々に敵対すると信じている。
私は、イラン問題に取り組むのは今だと言っています。	私は本当にこれを解決したい、私は他に何ができるのか分からない。
時間が経つにつれて、より真ん中に移動する可能性があります。	ボイコットするのは勝手ですが、CEOの死を求めるのはやりすぎです。
しかし、それが道徳的または宗教的な性質のものである場合、それは政府の仕事ではない。	彼らにとって、モラルがあるかないかは問題ではありませんでした。
もし自分が海外の軍隊にいたら、どのようにサポートされると思うか？	それが私の支えです。
彼らは、通常のゾンビタイムのクズ、大学生、ドングリのバスで運ばれたハッカーやSEUユニオンのチンピラ、共産党が資金提供した回答オタクで構成されているわけではないのです。	彼らは中国、韓国および他の所有物のすべてを保持し、我々は彼らのホーム島のキャプチャを返すだろう。
彼らは英国に住んでいるのだから、英語を話すべきだ。	イギリスを英語にするということは、どういうことなのでしょうか？
その時、彼女は電話番号を教えられないと言いました。	もし、それがセルフメイドマンでないなら、私はそんな人を聞いたことがありません。
なるほど、もう一方がダメだから議論の方向を変えたのか。	私は、至上主義が奴隷制の根源であるとは言っていません。
何かアドバイスがありましたら、よろしくお願いします。	私は、「誰も」気にしないよりも、「数人」が気にすることを提案します。
しかし、私のキャッシュフローは、賃貸料収入が住宅ローンをカバーする以上のものであるため、それらがない場合よりも良いのです。	そして、彼らがそこにいる唯一の理由は、非常識な住宅ローンの実践とあらゆる点で同じである非常識な学生ローンの実践のためである。
これは賢明な選択だと思うのですが。	で、ニュートと何の関係があるんだ？
ロボットをメンテナンスする技術者である。	rslw : なぜなら、彼らは恐ろしい、ファシストのスキンヘッドの野蛮人だからです。
彼らは民間の解決策、良いもの、誰にも増税しないものを提供した。	政府も国民も、自分の価値観を押し付けてはいけない。
軍事介入や政治的制裁には、もっと重要な政治的・経済的理由があるはずだ。	真の英雄は、40年にわたる政治的言説の重荷を背負うものである。
宗教の自由＝テロリストの支援とでも思っているのであれば話は別ですが...。	ティーパーティーは、政治における宗教の干渉をなくすことを促進しなかった。
qutermassは、最後の投稿で意見を言っていない、namvet 。	これは、2年近く続いた長い闘いでした。
国民は自分のポケットからあまり取り出されないが、政府はまだその収入を得ている。	私たちは、フラットで、公平で、広い基盤を望みます。そして最も重要なことは、政府がその手段の範囲内で生活することです。
明日は一般教書演説で、オバマ大統領は巨額の赤字について話すだろう。	オバマ政権の大赤字について話し続けている。
しかし、同じ理由で、一部のトラブルメーカーのために運動そのものを批判するのは不当です。	実際にうまくいかないのは、中央政府を作ってコミューンをコントロールする場合です。
派遣社員には、応募の際にそのことを説明し、常に連絡が取れる状態であることの重要性を理解してもらっています。	会場で唯一の白人である私は、なぜそのような質問をされたのか理解しました。
あなたが娘を愛し、最善を尽くしたいと思っていることは明らかです。	いいえ、それはあなたのような人々が正直になることができないだけです。
より大きな問題として、もしあなたがそのような道を選ぶのであれば、イスラム教は本質的に邪悪で暴力的な宗教なのでしょうか？	あなたは、イスラム教が殺人的な宗教であることを認める用意がありますか？
2.話は変わるが、金持ちだけが最高の医療を受ける資格があるのだろうか？	かわす、話題を変える、信じるように指示されたものを映すなど......。
彼女はこのサイトに登録していますが、レビ記のすべてに従うかどうか、そして、私たちの国の法律がレビ記のすべてに従うことを望んでいるかどうかについては、回答していません。	あなたはレビ記に従わないのですか、そして私たちの法律がレビ記のすべてに従うことを望んでいないのですか？
このほかにも様々な要因があることを理解している（例．	そして、すべてから少数が理解し、したがって、何もスライドを避けるために行われることはありません。
もし彼らが自分の給料と折り合いをつけているのなら、あなたが彼らの給料と折り合いをつけない理由はないでしょう。	その場所に新しいモスクを建てるべきかどうかという議論です。
戦争に行った人の中には、行きたくなかったが、逆らうことはできないと思った人もいた。	殺されるのが嫌で、行くのを拒んだ人もいた。
そして、40年後の地球温暖化の正統派のビジネスについて、彼らが何を言うのか、楽しみに待っていてください。	そして、私たちの子供たちの将来を心配する必要はないのです。
彼女は結婚生活がうまくいっていないことを告白しました。	あなたの定義では、住宅バブルは存在しなかった。
イランがイスラエルを脅かすほどの武器を開発するには何十年もかかるだろうし、どうせそんなことはしない。	どうせ仕事に行かずとも、本当に忙しい週末を過ごせそうですし・・・。
なぜなら、彼らは恥ずべきリベラルメディアの人種差別主義者ではないからだ。	なぜなら、彼はリーダーではなく、永遠の運動家であり、長であるからだ。
警察が少なくなっても、このままでいいと思う？	を回避する方法はないのでしょうか？
政府はそれとは何の関係もなかった。	政府は宗教の教義を尊重しなければならないか、そうでないか、どちらか一つを選んでください。
ビル・クリントンは大統領執務室でフェラチオをした。	というのは、もちろんフェラチオのことでもある。
政治的なレトリックが、人々に暴力を振るわせることができるかどうかということです。	人々が言っている「効果」は、票を動かすための単純な政治的レトリックではありません。
幸運を祈ります、彼女はこの段階を乗り越えられるでしょう。	また、すべてが見せかけであると仮定すると．
私は彼の嘘を引き裂くのが好きだが、私はラジオ番組でどのように良いのか分からない。	私のことを思ってくれてありがとう、でも彼の番組に出演する気はないんだ。
もちろん、現実はそうではない。	もちろん無料です。
黒人が貧しいのは外的要因によるものではないとするのは、黒人の不釣り合いな貧困が内的要因の結果であるとするものであり、それは黒人が劣っていることを意味するに過ぎない。	社会的・経済的格差が黒人の内部にあることを示唆することは、黒人を劣った存在にする遺伝的傾向があることを示唆することである。
私は、「人と違うことを叫ぶ」ことに同意しますが、何をもって「人と違うことを宣言する」とするのでしょうか？	私はあなたに同意する、量子風来坊、そして私が読んできたほとんどの法的コメンテーターもそうである。
国際開発長官ヒラリー・ベン、前保健長官アラン・ミルバーン、下院議長ジャック・ストローは、いずれも25/1である。	外相のマーガレット・ベケットは40/1、国防相のデス・ブラウンとウェールズ・北アイルランド担当のピーター・ヘインは50/1である。
あなたはレビ記に従わないのですか、そして私たちの法律がレビ記のすべてに従うことを望んでいないのですか？	彼女はこのサイトに登録していますが、レビ記のすべてに従うかどうか、そして、私たちの国の法律がレビ記のすべてに従うことを望んでいるかどうかについては、回答していません。
実際、FOXを見れば、あなたが主張していることと正反対のことがわかります。	あなたの希望的観測ではなく、事実と向き合ってみてください。
したがって、医療保険制度改革の必要性．	あなたの健康管理は大丈夫ですか？
そしてもちろん、それは今、フォックスニュース、右派、ブラブラブラとして、これまで彼らのせいではありません。	もちろん、自分以外のすべての人が悪いのですが。
あなたはそれが虚偽であると主張することができますすべてのあなたが望む、しかし、事実は事実です。	あなたはここで、事実であると主張するものを吐き出す。
ほとんどのキリスト教徒は同性愛者を嫌っているのではなく、その罪を嫌っているのです。	しかし、キリスト教徒として、私は神の言葉を信じています。
あるいは石油会社のように、カルテルを結んでいる。	本当のオイルは、四つ切サイズの缶にしか入っていません。
日記に「頭に革のマスクをしたような感じ」と書きました。	私は、誰かが私の後頭部にシャンパンの瓶をぶつけたような、それが出発する船であるような気がすると書きました。
私は、最低賃金が経済に対してどのような影響を与えるか、実際に2つの図に与えることはありません。	最低賃金の定期的な引き上げは、企業がそれに対応できるようにするための良いアイデアです。
ティーパーティーは、政治における宗教の干渉をなくすことを促進しなかった。	この場合、選択の自由と宗教の自由を比較することになります。
金持ちはコブラを必要としないし、いくらでも自分の個人保険を買うことができる。	貧しい人々は、保険に加入し続けるためにコブラを必要としません、彼らは雇用者によって保険に加入したことはありません、彼らはメディケイドを持っています。
保守派はこの問題にどう対応するのか？	しかし、保守派はこれらの問題に取り組もうとしない。
最近の例では、連邦裁判所が「国家安全保障」を理由とする訴訟を却下したことが挙げられます。"	釈放後、彼は上記の犯罪で米国を訴えたが、「国家安全保障上の理由」で却下された。"
私の母はその男性と結婚し、彼が死ぬまで一緒にいました。	私の父は素敵な女性と出会い、再婚しました。
私たちの司法制度は芯から腐っている。	ついこの間、子供が生まれたばかりだから、気にするなと言われただけだと思いませんか？
これは私たちにとってとても日常的なことで、娘を連れて帰ってきてから6時半か7時まで着替えさせずにいても、おむつはまだおしっこでいっぱいではありません。	一人の先生を除いて、娘を迎えに行くと、4時半におむつを替えたと書いてあり、6時半か7時にまた替えると、おむつは問題なくついています。
実際のところ、クリニックでは訴訟を恐れて胚を氷漬けにすることが多いようです。	彼らの見解では、胚と脳死した人間は違うのです。
通常兵器では、要塞化された施設を攻撃することさえできないかもしれません。	明らかに、あなたはデモに参加した人々の構成について全く無知です。
ですから、もし陪審員の指導が事実上間違っていた場合、正しい結論に達しない可能性があります。	陪審員は、彼らが決定する事実に適用される法律について教えられるべきであり、その逆ではありません。
でも、親は「そんなの事故だ」と言うんです。	それは私たちの日であり、私たちが望む方法であり、それは素晴らしいものでした。
そうですね、価格に影響を与える変数はたくさんありますし、一社で説明しようとすると現実的ではありません。	また、これらの懸念は、自分たちのペットのプロジェクトに資金を提供したいだけの科学者のものであるというヒントもある。
そして、彼らはプラットフォームを更新しています。	今年は娘と一緒にそうするつもりです．
それとも、どうしたらいいのでしょうか？	このことをご存知の方はいらっしゃいますか？
大統領の実父はケニア人であり、オバマはほとんど彼を知らない。	司法制度は茶番であり、我々はそれを知っている。
ebayを利用しない理由と同じです。	復讐は判決の根拠となるのか？
本当にどうしたらいいのかわからない・・・。	私は本当に何が起こっているのかわからないが、私はそれについて非常に怒っている。
ブッシュ政権はそれを元に戻した。	彼らはそれを得なかったが、彼らはそれを要求した。
一昨日まで、子供用の銃を作っていることを知らなかった（おもちゃの銃のことではない）。	ソース・トーマス 保険業界がGWに対してどのような準備をしているか、またどのような発言をしているか、データをお持ちですか？
実は、ロボットを作るのは人間なんですよ。	もちろん、病気の動物を扱う人たちは、意地悪な動物が意地悪をしなくなったとき、死がすぐそこまで来ていることを知っています。
私は彼らが保存されていないことを知っているし、私はちょうど理解できません!	物事はとても大きく、奇妙なものです。
このスレッドのシリーズを立ち上げるべきでしょう ; - ) .	彼のためのモニュメントを作るべきだ。
ブッシュ政権時代に国の借金が2倍以上になったのに、なぜそのことを聞かなかったのだろう？	しかし、彼らはブッシュ政権下で国家債務が倍増していることには触れなかった。
まったくもってナンセンスだ。	それは意味がありません。
よろしくお願いします、そうです、彼は浮気をしていました。	現実には、私は以前そこにいて、再び戻ってきたのです。
親のお金の使い道がわからない。	でも、予算は3〜4千円もないでしょうね。
彼はそれを理解していないだけです。	彼は今日に至るまで、まだそれを行っていない。
連邦政府が発表した失業率や住宅市場などの消費者市場の現状は、左派やホワイトハウス、CBOが発表した数字を裏切っている。	は、BPと連邦政府の二重の油流出対応に努力と協調が欠けていると非難し、クジラを清掃作業に参加させるよう政府に嘆願しました。
さらに、彼らはイスラム教のシーア派に属しているため、自動的にイランと結びついているのです。	この3人に加えて、ルーズベルトは19人の裁判官を連邦控訴院に、53人の裁判官を連邦地裁に任命した。
多くの問題があるのに、あなたは何が問題なのか理解していないようだ。	wryが伝えたかったことを理解しているのか？
メディアは共和党が受けたような詮索を彼にしなかったのが救いだ。	問題は、この男が暴力的で、私を殴るなどして虐待していたことです。
そうでもない、失われたSDPの票のほとんどは、グリーンズに流れた。	これらの地域には希望がないようです。
自然はとてもすばらしかった．	ああ、素晴らしい思い出がいっぱいだ......。
これは本当に良いもので、ところどころにかなり革新的なものがあります。	当時、彼らはかなり長い間スペインを支配していました。
とにかく、私はこのことをマネージャーに伝え、彼女はIさんに話をしました。	そして、マネージャーには、Iさんが一日の終わりにもう一度オムツをチェックするようお願いすることにしています。
この2011年のセンチネルの記事では、バウチャー・プログラムに参加した生徒が公立学校の生徒よりも成績が良くなかったというデータが引用されています。	従って、少なくとも利用可能なデータに基づいて、バウチャー・プログラムはプログラム参加者のパフォーマンスを向上させることも、公立学校システムの質を高めることもないようである。
また、いわゆるグラウンド・ゼロ・モスクの関係者が、9月11日の殺人犯と何らかの関連があるという証拠を見たこともない。	グラウンド・ゼロ・モスクの背後にいる人々が、9/11の責任を負うべきであると示唆した人は誰もいなかったと思います。
想像していたよりも過酷だったのでしょうか？	行方不明になった子供の行方について
私は昨夜、私に気があることを知っている別の男友達に会いに行きました。彼は私を口説き始め、私は彼にセックスをさせました。	しかし、今朝、楽しかったか、何をしたかなどを聞いているときに、なぜかオールヌードかトップレスかを聞いてしまい、それは聞くべきではありませんでした。
今週3足目のテニスシューズを履きつぶしてしまった。	お気に入りのマグカップの取っ手を使い果たした。
外廊下で待っていると、上司が誰かと話しているので、私は横に立っていた。	会場で唯一の白人である私は、なぜそのような質問をされたのか理解しました。
メディアの誰が、どのように「半狂乱」になっているのか？	なぜ、誰も真実を認めないのですか？
タイのタクシン支持者、4月の暴動以来最大の集会を計画 6月27日 ( ブルームバーグ ) -- タクシン・チナワット元首相を支持するタイの反政府デモ隊は、4月に軍が暴動を鎮めて以来最大の集会になると主催者は発表し、今日バンコクに集合する予定だ。	タクシン「赤シャツ」、バンコクで再び集結 バンコク 4月25日 ( ロイター ) - 亡命したタクシン・チナワット元首相の支持者約3000人が土曜日、バンコクで2週間前の激しい路上衝突以来、初めての集会を行った。
食器棚を開けたら、マグカップしかない。	お気に入りのマグカップの取っ手を使い果たした。
なぜアメリカ政府はそれをしないのか（もし不倫が捏造なら、だが）。	私は、彼らをこのように扱う政府の側が本当に恥ずべきことだと思います。
脅しや脅迫という言葉は、オバマは一度も口にしたことがない。	女性を見つける前に爆弾を見つけたのです。
司祭と身体の治療者の役割の分離は、比較的小さな地域文化圏で、最近になって始まった。	世界の指導者たちが集まって、地球温暖化を食い止めるための大規模な計画を立て始める必要があります。
ルパート・マードックは父親から英国（オーストラリア）の新聞社2社の所有権を受け継いだ。	マードックは、かなり成功した2つの新聞社を継承し、世界的なメディア帝国に変貌させた。
edgar 、あなたは正しいかもしれない - 少なくとも部分的に。	問題は、あなたが自分と同じような人を追いかけていることです。
水曜日の決定は、法案が制定されれば、トルコとフランスの関係に深刻な影響を与えると警告してきたトルコを喜ばせる可能性があります。	フランスの法律はトルコを激怒させ、トルコはフランスのサルコジ大統領がこの法案に署名すれば制裁すると脅している。
自殺率が非常に高く、自暴自棄と悲しみを示している。	あなたの言葉からは、絶望が伝わってきます。
あなたの健康管理は大丈夫ですか？	財産はあるのか？
私たちは、世界の「ショーン・ペン」だけが買えるテスラ・モーターの故郷なのです。	私たちが若い頃、夫がもっと楽な仕事に就く前、彼は肉体労働をしていました。
リベラルなメディアは、リベラルな人たちを追及しない!!	それが自由というものです。
アフガニスタンで行ったように、世界中を攻撃するためにキャンプを張ることを許可しているのでしょうか？	私たちはイラクとアフガニスタンで何千人もの命を流しましたが、何を達成したのでしょうか？
オバマ政権？	この決議にはオバマ政権が反対していた。
