" 端子の電気的状態がバッテリーの電気的状態と一致する "	端子1はバッテリーのマイナス端子に接続されています。
閉じた経路は電球に接続されています	電池と同じ閉じた経路の中に、まだ電球aが含まれていたのだ。
電球aは電池と同じ閉路に含まれるため	電池と同じ閉じた経路の中に、まだ電球aが含まれていたのだ。
電球が破損している	端子6は、バッテリ負端子と隙間を隔てて配置されています。
球根aと球根cは別々のパスにあります。	a、b、cはそれぞれ異なる経路にあります。
を選択すると、端子が接続されていない状態になります。	端子が接続されていない
バッテリーへの経路が閉ざされていた	電池と同じ閉じた経路の中に、まだ電球aが含まれていたのだ。
6番端子とプラス端子の間に隙間がない。	6番端子とプラス端子の間に隙間がないこと
バッテリー端子の電気的状態が異なる。	電池は化学反応を利用して、端子で異なる電気的状態を維持します。
スイッチが開いていると、ギャップが発生します。	オープンスイッチの場合、ギャップが生じる
電球Aと電球Cは互いに影響しあっています。	aとcは同じ閉路にある
端子とバッテリ端子を分離し	端子はギャップによって分離されている
スイッチyは、電球aの同じ経路にはありません。	電球aはまだバッテリーと閉じた経路にあります
というのも、正極の回路は電圧が1.5ボルトだからです。	端子1とプラス端子はギャップにより分離されています。
電球はマイナス側のみ接続されています。	バッテリーがオープンパスにある
バッテリーのプラス経路に接続されている端子がない	バッテリーがオープンパスにある
端子とバッテリー端子が接続されていない	端子が接続されていない
バッテリーのプラス端子と5番端子の間に隙間がないこと	5番端子とプラス端子の間に隙間がないこと
電球aと電球cは、電池と一緒に閉じた経路に収まったままでした。	aとcの電球は、まだバッテリーと閉じた経路に収まっています。
ギャップによって電気的な状態の違いが生じるため	電池は化学反応を利用して、端子で異なる電気的状態を維持します。
電池がいかなる装置もない閉じた経路に収まっていること。	電池が他の部品を含まない閉じた経路に収まっていること。
は同じ線上にある	aとcは同じ閉路にある
閉路がある	球根a、bは閉じた経路にある
端子間に隙間がある場合、電圧は異なります。	電圧測定は、2つの端子がギャップによって隔てられているかどうかを示します。
端子1は、1.5Vのバッテリーに接続されています。	端子1はバッテリーのマイナス端子に接続されています。
aとcはまだバッテリーに接続されているため	aとcの電球はまだバッテリーと閉じた経路にあります。
電池が閉路であること	電池は電球のない閉じた経路に収まっています。
電球と同じ経路にある場合。	スイッチと電球が同じ経路に含まれる場合
接続にギャップがあったため	端子1とプラス端子はギャップにより分離されています。
かくれみのある	端子4は、バッテリーのマイナス端子と隙間を隔てて配置されています。
電球がスイッチのある閉路に収まっている場合	スイッチと電球が同じ経路に含まれる場合
" スイッチzがバルブcにあるから " " sの閉じたパス "	は、zとcの両方を含むパスが存在します。
bulb aとbはまだ閉じたパスの中に含まれています。	球根a、bは閉じた経路にある
電池は壊れない限り常に電圧がある	電池は化学反応を利用して、端子で異なる電気的状態を維持します。
端子6は、バッテリーのプラス端子に接続されています。	端子1と端子6が接続されていない
というのは、端子1と端子6が接続されていないからです。	端子1と端子6が接続されていない
電気的な状態の差はありません。	端子1，2，3は，正電池端子と隙間なく並んでいる。
電球はバッテリーのマイナス端子に接続されているため	端子1，2，3はバッテリーのマイナス端子に接続されています。
電球bとcは両方ともまだバッテリーと閉じた経路にあります。	電球bとcはまだバッテリーと閉じた経路にあります。
端子が接続されていない	端子1と端子6が接続されていない
は、bulb a と同じパスにはありません。	電球aはまだバッテリーと閉じた経路にあります
ブラブはバッテリーと同じ閉経路には含まれません。	電球が電池を含む閉路にないこと
1番端子と4番端子を接続	端子1と端子4は接続されています
ギャップは電池の電圧に影響を与えないので	端子1，2，3は，正電池端子と隙間なく並んでいる。
プラス端子が電球に接続されている	端子1とプラス端子はギャップにより分離されています。
というのは、1.5Vから0Vを引くと1.5Vになるからです。	端子1とプラス端子はギャップにより分離されています。
スイッチは、電球やバッテリーと同じ経路に含まれている必要があります。	スイッチと電球は同じ経路になければならない。
電球cはまだ電池との閉路に含まれていなかったので	電球cは電池との閉路でなくなった。
閉路である電球に接続されているため	バッテリーがオープンパスにある
というのは、端子1と端子6の間に隙間があるからです。	端子1と端子6の間に隙間がある
球根aとcは同じ閉経路上にない。	aとcは同じパスにはない
電球aと電球bはまだ閉じた経路の中に入っており、電池に接続されています	cが燃え尽きれば、aとbはまだバッテリーと閉じた経路にあります。
電球aは電池とスイッチxで閉回路になっているため	は、電池とスイッチxとの閉路に含まれたままである。
電球はバッテリーと同じ経路にあります。	aとcは同じ経路にある
電球aは、電池との閉路に含まれる	電池と一緒に閉じた経路の中に、まだ電球aが含まれています。
端子4はバッテリーのプラス端子に接続されています。	端子4とプラス端子を接続
電球aと電球bが同じ経路にあるため	電球はそれぞれ独自の道を歩んでいる
同じ回路であったため	スイッチyと電球aは同じ閉路にはない
球根aと球根cは別々のパスにあります。	aとcは異なる経路にある
閉回路があった	電池と一緒に閉じた経路の中に、まだ電球aが含まれています。
回路に隙間があるため .	回路に隙間がある
それは、閉じた道ではなかった	電球cと電池を含む閉じた経路はもはや存在しない。
電池だけでは閉路になる	電池が他の部品を含まないパスの中に入っていること。
電球bとcは、電池と同じ経路に含まれています。	bとcはバッテリーと同じ経路にある
バッテリーの間の経路が閉じていた	電池と同じ閉じた経路の中に、まだ電球aが含まれていたのだ。
端子が同じ電気的状態を持つ	端子1と端子2が接続され，同じ電気的状態にあること。
電球aと電球b、電球cは異なる経路にあるため	電池と一緒に閉じた経路の中に、まだ電球aが含まれています。
バルブaは閉路にあった	電池と一緒に閉じた経路の中に、まだ電球aが含まれています。
teryは閉じたパスにあるわけではない	2の電池はクローズドパスになっていない。
というのも、隙間ができて、その結果、道が空いてしまったからです。	オープンスイッチの場合、ギャップが生じる
道草を食うと	スイッチと電球が同じ経路に含まれる場合
端子1が端子4に接続されている	端子1と端子4は接続されています
回路に隙間がない。	電池と一緒に閉じた経路の中に、まだ電球aが含まれています。
電球aと電球cは電池との閉路にある。	電球bと電球cは、電池と同じ閉回路に収まっていた。
電球aと電球bは、まだバッテリーと閉じた経路に含まれています	cが燃え尽きても、aとbはバッテリーと閉じた経路のままです。
バッテリーのプラス端子から隙間がなかったため	端子1とプラス端子はギャップにより分離されています。
両端子からの電流を受け止めたままなので	スイッチyと電球aは同じ閉路にはない
電流がバッテリーをショートさせたのです。	ショートサーキットがある
を使用すると、端子が接続されていない状態から、互いに接続された状態になります。	端子が接続されていない
端子1がバッテリーのプラス端子に接続されているため	端子1はバッテリーのマイナス端子に接続されています。
電池は、他の部品がない閉じた経路に配置されています。	電池が他の部品を含まないパスの中に入っていること。
電池と電球が近い経路に含まれていないこと	4のバッテリーはクローズドパスになっていない。
というのも、電球の端子の1つが悪く、他のものは良いのです。	端子 4 , 5 , 6 はバッテリーのプラス端子に接続されています。
バッテリー端子に接続されたままだったからです。	電池と一緒に閉じた経路の中に、まだ電球aが含まれています。
ギャップがないので電圧に差がない	端子間に隙間がない
電池内の電圧は同じまま	電池は化学反応を利用して、端子で異なる電気的状態を維持します。
というのも、パスの1つに電球があるのです。	電池を含む閉路は存在しない
スイッチと電球が閉路の中にあるとき	スイッチと電球が同じ経路に含まれる場合
循環器系に隙間がある。	回路に隙間がある
端子 1 は端子 4 に接続されています。	端子1と端子4は接続されています
電池のプラス端子は，3番端子と間隔をあけて配置されています。	端子3とプラス端子はギャップによって分離されています。
端子1はプラス端子に接続	端子1とプラス端子はギャップにより分離されています。
aとcの電球は、まだバッテリーと閉じた経路に収まっています。	cが燃え尽きれば、aとbはまだバッテリーと閉じた経路にあります。
電球cは他の電球の経路に含まれないため	aとbはそれぞれの道を歩む
端子を電池のプラス端子に接続します。	端子6とプラス端子を接続
電圧は変わりません。	電池は化学反応を利用して、端子で異なる電気的状態を維持します。
電池の2つの端子は、電池内部の化学反応により常に異なる電気的状態を示します。	電池は化学反応を利用して、端子で異なる電気的状態を維持します。
一路相通ず	aとcは同じ経路にある
スイッチ z は閉じた経路に含まれる	は、zとcの両方を含むパスが存在します。
電池は回路と異なる電気的状態になります。	電池は化学反応を利用して、端子で異なる電気的状態を維持します。
1つの電球を取り外すと、他の電球は作動しなくなります。	aとcは同じ閉路にある
端子4，5，6はバッテリーのプラス端子にのみ接続されています。	端子 4 , 5 , 6 はバッテリーのプラス端子に接続されています。
プラス電池は2番端子から隙間なく分離されている	端子2とプラス端子はギャップにより分離されています。
2つのマイナス接続があったため	端子1と端子2が接続されている
というのも、スイッチYは電球Aとバッテリーの閉じた経路には含まれないからです。	電球aはまだバッテリーと閉じた経路にあります
電球a、電球bと電池は閉じた経路にあります。	cが燃え尽きれば、aとbはまだバッテリーと閉じた経路にあります。
スイッチと電球が同じ経路にある場合	スイッチと電球が同じ経路に含まれる場合
電球が破損すると、経路に隙間ができます。	電球が傷つくと隙間ができる
電球が回路の経路に完全に入っていないこと	電池が他の部品を含まないパスの中に入っていること。
バッテリーのプラス端子は4番端子に接続されています。	端子4とプラス端子を接続
正極端子と第2端子は隙間によって隔てられており	端子2とプラス端子はギャップにより分離されています。
両コンポーネントが閉路である必要があります。	電球と電池は閉じた経路にあります。
なぜなら、電球bが破損しており、バッテリーのプラス電流が反対側に届かないからです。	端子1、2、3がバッテリーのプラス端子に接続されていない。
端子6をバッテリーのプラス端に接続し、電圧計で測定します。	端子6とプラス端子を接続
バッテリーのプラス端子に端子が接続されていない。	端子1と端子4は接続されています
プラス端子は2番端子から操作します。	端子2とプラス端子はギャップにより分離されています。
バッテリーがバルブにつながるオープンパスになっている。	バッテリーがオープンパスにある
バルブbとcは、バッテリーと閉じた経路のままです。	電球bとcはまだバッテリーと閉じた経路にあります。
電球aは独自の閉じた経路上にあり、電球bとcは同じ閉じた経路上にある	aを含むパスとbとcを含む別のパスが存在する。
電球aはスイッチzに接続されている	スイッチyと電球aの両方を含む経路は存在しない
端子6はバッテリーのプラス端子に接続されています。	端子6とプラス端子を接続
バッテリーは常に電圧を持っています。	電池は化学反応を利用して、端子で異なる電気的状態を維持します。
を押すと、すべての電球が消えます。	オープンスイッチの場合、ギャップが生じる
の場合、電球の端子がバッテリーの端子に接続されているため、電圧は1.5となります。	端子1はバッテリーのマイナス端子に接続されています。
aとcはまだ閉回路であるため	球根aと球根cは閉じた経路にある
端子はバッテリーのマイナス端子に接続されています。	端子1，2，3はバッテリーのマイナス端子に接続されています。
なぜなら、これらの端子はバッテリーのプラス端子に接続されているからです。	端子 4 , 5 , 6 はバッテリーのプラス端子に接続されています。
バルブaはまだ閉路にあった	は、電池とスイッチxとの閉路に含まれたままである。
接続に隙間がある .	端子間に隙間がない
閉じた道があり、その道には電球がない。	電池が電球のない経路に収まっている場合
球根aと球根cは、電池との閉じた経路の中にまだ含まれています。	aとcの電球はまだバッテリーと閉じた経路にあります。
端子1がバッテリーのプラス端子に接続されていない。	1端子とプラス端子が接続されていない
電池は回路に含まれ、電球は含まれません。	電池が電球のない経路に収まっている場合
電池は化学反応によって電圧を維持する。	電池は化学反応を利用して、端子で異なる電気的状態を維持します。
端子4，端子5，端子6がプラス端子に接続されています。	端子 4 , 5 , 6 はバッテリーのプラス端子に接続されています。
電球bとcは、電池と同じ経路に含まれています。	bとcはバッテリーと同じ経路にある
負極端子と端子4の間は隙間があります。	端子4は、バッテリーのマイナス端子と隙間を隔てて配置されています。
端子同士を接続しないこと。	端子が接続されていない
電池の端子が接続されていない	回路4は閉路をもたない
道が閉ざされたため	電池と一緒に閉じた経路の中に、まだ電球aが含まれています。
電池のプラス端子は隙間によって隔てられています。	端子1とプラス端子はギャップにより分離されています。
電球が電池とスイッチの閉回路にある場合、スイッチは電球に影響を及ぼします。	スイッチと電球が同じ経路に含まれる場合
というのは、電球cにはもう閉回路がないからです。	電球cは電池との閉路でなくなった。
5番端子はバッテリーのプラス端子に接続されています。	端子5とプラス端子を接続
電球の端子が片方のバッテリー端子にしか接続されていないこと	端子間に隙間がない
球根a,cはまだバテリーで閉じた道に収まっていました。	aとcの電球は、まだバッテリーと閉じた経路に収まっています。
5番端子はバッテリーのプラス端子に接続されています。	端子5とプラス端子を接続
端子1はバッテリーのマイナス端子に接続されています。	端子1はバッテリーのマイナス端子に接続されています。
スイッチがバルブで閉路のとき	スイッチと電球が同じ経路に含まれる場合
片方の電球を外すと、もう片方の電球が切れる。	aとcは同じ閉路にある
電球aは、バッテリーとの閉路にある	電球aはまだバッテリーと閉じた経路にあります
電球とスイッチが閉じた経路でつながっている場合、スイッチは電球に影響を及ぼします。	スイッチと電球が同じ経路に含まれる場合
電球が点灯しない	端子間に隙間がない
電球bが破損している場合、循環はもはや閉じていない。	一理も二理もない
電球が傷つくと、経路に隙間ができます。	電球が傷つくと隙間ができる
電球cとスイッチzは同じ閉路にある	zとcの両方を含むパスが存在する
スイッチを入れると、閉じた経路に切れ目ができます。	オープンスイッチの場合、ギャップが生じる
電池が電気を持ち、ギャップがないため	電池は化学反応を利用して、端子で異なる電気的状態を維持します。
閉路でなければならない。	電球と電池は閉じた経路にあります。
回路2は、バッテリーが接続されていないため、ショートしていません。	2の電池はクローズドパスになっていない。
電球aと電球bは、電池を含む閉回路に接続されたままです	cが燃え尽きても、aとbはバッテリーと閉じた経路のままです。
電球aと電球cは、電池との閉路に含まれたままです。	aとcの電球はまだバッテリーと閉じた経路にあります。
端子はバッテリーに接続されています	端子1，2，3はバッテリーのマイナス端子に接続されています。
赤い×印は、「危険だから、よっぽどのことがない限り、絶対にやってはいけない」という意味だと思います。	ショートサーキットがある
1番端子と4番端子を接続	端子1と端子4は接続されています
第一端子と第六端子が接続されていない	端子1と端子6が接続されていない
「スイッチが電球の閉路に含まれる場合、スイッチが開くと電球に影響を及ぼします。	電球とスイッチが同じ経路にある場合、スイッチは電球に影響を与えます。
電球が点灯するには、パスを閉じる必要があります。	電球とスイッチが同じ経路にある場合、スイッチは電球に影響を与えます。
バッテリーのプラスが1番端子に接続されていない。	1端子とプラス端子が接続されていない
バッテリーの周囲で回路が閉じられていない。	2の電池はクローズドパスになっていない。
スイッチzを通過することができるため	a, c, z, x を含むパスが存在する。
バッテリーでパスが閉じていれば、スイッチの影響はありません。	電球とスイッチが同じ経路にある場合、スイッチは電球に影響を与えます。
3端子とポジ端子は接続されていません。	3番端子とプラス端子が接続されていない
電球cは閉路に含まれないので	aとbを持つ閉じた経路で、cが入らないものがある。
1端子とプラス端子の電気的な状態が異なっていた。	端子1とプラス端子はギャップにより分離されています。
2番端子のギャップはポッシブ	端子2とプラス端子はギャップにより分離されています。
球根aと球根cは、電池と別々の閉路にある。	aとcはバッテリーで異なる経路にあります
電球、電池、スイッチが閉路にある。	スイッチと電球が同じ経路に含まれる場合
端子 4 , 5 , 6 はバッテリーのプラス端子に接続されています。	端子 4 , 5 , 6 はバッテリーのプラス端子に接続されています。
端子5とバッテリーのプラス端子が同じ状態であること。	端子5とプラス端子を接続
電球aと電球cは、バッテリーの異なるパスに含まれている	aとcはバッテリーで異なる経路にあります
バッテリーが閉じた経路にないため .	4のバッテリーはクローズドパスになっていない。
バルブAは隙間を作る	電球はそれぞれ独自の道を歩んでいる
端子6はバッテリーのプラス端子に接続されています。	端子6とプラス端子を接続
異なる端子間の電圧を測定することで、切れた電球を見つけることができます。	電圧測定は、電球の破損により電気的状態が変化する箇所を示します。
は、バッテリーのマイナス側と同じ側にあります。	端子1，2，3はバッテリーのマイナス端子に接続されています。
正極のバッテリ端子は、端子4から間隔を空けて配置され	端子4と正電池端子が同じ電気的状態であること。
電流の隙間ができてしまう。	オープンスイッチの場合、ギャップが生じる
バッテリーのプラス端子に接続される端子と	端子6とプラス端子を接続
電球と電池の両方が閉じた経路にあること。	電球と電池は閉じた経路にあります。
2つの端子が接続されている	端子6とプラス端子を接続
というのは、電球aはまだ電池と閉じた経路を辿っていたからです。	電池と同じ閉じた経路の中に、まだ電球aが含まれていたのだ。
というのは、他に使える閉じたパスがあるからです。	電球aはまだバッテリーと閉じた経路にあります
aとbは直列、aとcは並列であるため	cが燃え尽きれば、aとbはまだ閉じた経路の中にある。
は、スイッチzから電流を受け取ります。	a, c, z および x を含むパスが存在する。
正極端子と4番端子の間に隙間がないこと。	端子4とプラス端子はギャップによって分離されていません。
球体aと球体cは閉じた経路に含まれない	aとcは同じパスにはない
電球bとcは、電池と同じ経路に含まれています。	bとcはバッテリーと同じ経路にある
x と z が閉じていれば、閉じたパスを作成します。	a, c, z および x を含むパスが存在する。
はマイナス端子に接続されています。	端子間に隙間がない
b と c は a と同じ回路にはない .	電球はそれぞれ独自の道を歩んでいる
バルブBがギャップを生んだ	端子4と正電池端子が同じ電気的状態であること。
球根bとcは道の隙間を作る	バルブbは別経路
バルブやバッテリーと同じ経路にはありません。	電球aはまだバッテリーと閉じた経路にあります
bとcはそれぞれバッテリーと閉じた経路を通ることになります。	電球bとcはまだバッテリーと閉じた経路にあります。
スイッチが入っていて、電球とバッテリーの間に隙間ができている場合。	スイッチと電球が同じ経路に含まれる場合
y は、a の電球の点灯に必要ありません	電球aはまだバッテリーと閉じた経路にあります
" なぜならスイッチyはバルブaに " " 含まれていないから " " sのクローズドパス "	スイッチyと電球aは同じ閉路にはない
スイッチが電球の経路にあるとき。	スイッチと電球が同じ経路に含まれる場合
正電池の端子と端子4の間は隙間になっています。	端子4と正電池端子が同じ電気的状態であること。
は、zが閉じていることでパスを完成させることができます	a, c, z, x を含むパスが存在する。
循環に隙間ができる。	オープンスイッチの場合、ギャップが生じる
電球bとcは、電池と閉じた経路に含まれていました。	電球bと電球cは、電池と同じ閉回路に収まっていた。
異なる電流で動作する	cが燃え尽きれば、aとbはまだバッテリーと閉じた経路にあります。
閉回路	球と電池を含む閉路がある
電球が正しく接続されているからです。	バッテリーがオープンパスにある
電球bとcは、まだ電池とのパスに含まれています。	電球bとcはまだバッテリーと閉じた経路にあります。
" 電球 a " " s パスのみ含まれるスイッチ z "	スイッチyと電球aは同じ閉路にはない
バッテリーのプラス端子と2番端子を隔てる隙間	端子2とプラス端子はギャップにより分離されています。
各回路に接続する必要があります。	一回路あり
正極	端子 4 , 5 , 6 はバッテリーのプラス端子に接続されています。
というのは、閉じたパスに含まれていなかったからです。	スイッチyと電球aの両方を含む経路は存在しない
電球bとcは閉回路の中で別々の経路を持つ	電球aが燃え尽きると、bとcは電池との閉路でなくなります。
パスが閉じていない場合、スイッチは電球に影響を与えません。	電球とスイッチが同じ経路にある場合、スイッチは電球に影響を与えます。
バッテリーのプラス端子と4番端子の間に隙間がある。	端子4と正電池端子が同じ電気的状態であること。
電圧とは、バッテリーのプラスとマイナスの端子間の差のことです。	端子1とプラス端子はギャップにより分離されています。
端子6は、バッテリーのプラス端子に接続されています。	端子6とプラス端子を接続
3番端子とプラス端子の間に隙間がある。	端子3とプラス端子はギャップによって分離されています。
の電球は、バッテリーに接続されていませんでした。	電球cは電池との閉路でなくなった。
端子4がプラス端子に接続され、マイナス端子には接続されていないため	端子4とプラス端子を接続
電池のプラス端子と1番端子を隔てる隙間	端子1とプラス端子はギャップにより分離されています。
回路2は、電池が自分自身と閉回路になっていないため、短絡していません。	2の電池はクローズドパスになっていない。
1番端子がプラス端子に接続されていた	端子1とプラス端子はギャップにより分離されています。
" なしで、閉じた道はない "	電球aが燃え尽きれば、bもcも閉路にはならない
バッテリーが閉回路でないため	2の電池はクローズドパスになっていない。
電池と電球のある閉じた道	球と電池を含む閉路がある
電球端子と電池のマイナス端子を隙間なく分離し	端子間に隙間がない
バルブaは、パスのギャップを生じさせる	電球aが燃え尽きると、bとcは電池との閉路でなくなります。
電球が破損すると、経路に隙間ができる	電球が傷つくと隙間ができる
電池と電球は一緒に閉じた経路にある必要があります。	電球と電池は閉じた経路にあります。
まだ水槽に接続されているため	電池を含む閉路は存在しない
電球は1つの端子しか接続されていません。	電池が他の部品を含まないパスの中に入っていること。
電気的な状態に違いがあります。	端子が接続されていない
なぜなら、2つの端子は常に異なる電気的状態を持つからです。	電池は化学反応を利用して、端子で異なる電気的状態を維持します。
電池は自分自身と閉じた経路をたどっています。	電池が他の部品を含まない閉じた経路に収まっていること。
電球aは自分の閉じた経路の中にあり、bやcとは無関係である。	aを含むパスとbとcを含む別のパスが存在する。
電球bと電球cはまだ閉じた経路の中にあります。	電球bとcはまだバッテリーと閉じた経路にあります。
電球aは、電球bとcと同じ経路にはありません。	電球aが燃え尽きると、bとcは電池との閉路でなくなります。
端子1、端子2、端子3はバッテリーのマイナスに接続されています。	端子1，2，3はバッテリーのマイナス端子に接続されています。
電池がマイナス電荷のみを含んでいる	スイッチyと電球aは同じ閉路にはない
電球aと電球cは、まだバッテリーと閉じた経路にありました。	aとcの電球は、まだバッテリーと閉じた経路に収まっています。
もし、電球Aが燃え尽きたら、電球BとCはもう閉じた経路にはならない。	電球aが燃え尽きれば、bもcも閉路にはならない
端子5は、バッテリーのプラス端子にのみ接続されています。	端子5とプラス端子を接続
正電池に接続されていない	2番端子とプラス端子が接続されていない
端子1はバッテリーのマイナス端子に接続されています。	端子1はバッテリーのマイナス端子に接続されています。
電球aと電球cは、電池と異なる経路に含まれています。	aとcはバッテリーで異なる経路にあります
電球があるため	2の電池はクローズドパスになっていない。
電球bとcは電池と同じ経路でつながっています。	aとcはバッテリーと同じ経路にはない
プラス端子と1番端子は隙間によって隔てられている。	端子1とプラス端子はギャップにより分離されています。
bとcは共にバッテリーへの完全な回路の一部である	電球bとcはまだバッテリーと閉じた経路にあります。
電球と電池を含む回路の一部である場合。	スイッチと電球が同じ経路に含まれる場合
なぜなら、電球aはまだバッテリーへの閉じた経路に収まっているからです。	電球aはまだバッテリーと閉じた経路にあります
バルとバッテリー端子の間に隙間がある。	端子間に隙間がない
というのも、電球bとcはまだバッテリーと閉じた経路を辿っていたからです。	電球bと電球cは、電池と同じ閉回路に収まっていた。
電球bとcはバッテリーと閉じた経路のままです	電球bとcはまだバッテリーと閉じた経路にあります。
電気的状態がゼロでなければ、回路のギャップを見つけることができます。	電圧が0でない場合は、ギャップがあることを意味します。
前記バッテリ正極端子に接続される端子と	端子が接続されていない
接続されている端末が動作していない	端子間に隙間がない
端子を入れ替えました。	端子1とプラス端子はギャップにより分離されています。
バルブ・アット・ザ・ギャップ	電球aが燃え尽きれば、bもcも閉路にはならない
スイッチzを閉じたとき、電球aはバッテリーと完全な回路を形成しています。	電球aは、電池とスイッチzで閉じた経路の中にまだ含まれています。
を、「球根の道」ではなく、「球根の道」にしたのです。	スイッチyと電球aの両方を含む経路は存在しない
が開いているため、バルブがもはや閉路でない場合、それが開いているため	スイッチと電球が同じ経路に含まれる場合
電池が閉じた経路で閉じていない。	回路4は閉路をもたない
電球 a と b は、電球 c と同じ経路にはありません。	bulb cは別のパスにあります
バッテリーと電球の間の回路の流れを断ちます。	電球が傷つくと隙間ができる
バルブbが破損しているため、ギャップがあるため	端子1，2，3は，正電池端子と隙間なく並んでいる。
バッテリーのマイナス端子は、端子6と隙間を隔てて配置されています。	端子6は、バッテリ負端子と隙間を隔てて配置されています。
バッテリーがショートすることはありません。	電池は化学反応を利用して、端子で異なる電気的状態を維持します。
バッテリーのプラス端子から1、2番端子の間に隙間がある。	端子1と端子2が接続され，同じ電気的状態にあること。
電球bとcはまだバッテリーと閉じた経路にあったため	電球bと電球cは、電池と同じ閉回路に収まっていた。
電球aとスイッチzは閉じた経路にある	電球aは、電池とスイッチzで閉じた経路の中にまだ含まれています。
パスが途切れる	端子1と端子2が同じ電気的状態であること
電球とバッテリーの間の接続を閉じます。	球と電池を含む閉路がある
オープンパスを作成すると	スイッチと電球が同じ経路に含まれる場合
端子が外れている隙間を見つけることができるので助かります。	電圧測定は、2つの端子がギャップによって隔てられているかどうかを示します。
電球aと電球cはバッテリーと閉じた経路上にあり	aとcの電球はまだバッテリーと閉じた経路にあります。
マイナス端子に接続された	端子1と端子2が接続されている
端子1、2とバッテリープラス端子の間に隙間がある。	端子1と端子2が同じ電気的状態であること
c が破損している場合、電球 a と b は閉じたパスに含まれます。	cが破損しても、aとbは閉じた経路の中にある
空白が生じる	電球aが燃え尽きれば、bもcも閉路にはならない
電球a,b,cはバッテリーとの経路上にあり	aとcは同じ経路にある
電球a、電球b、電球cはそれぞれ異なる閉路にあります。	aとcは異なる経路にある
バッテリーのプラス端子は4番端子から隙間なく並んでいる	端子4とプラス端子はギャップによって分離されていません。
回路2は電球に接続されているため、短絡ではありません。	2の電池はクローズドパスになっていない。
閉じた経路とバッテリーがあるはずです。	球と電池を含む閉路がある
というのも、スイッチが開いていると、隙間ができてしまうからです。	オープンスイッチの場合、ギャップが生じる
aとcはバッテリーと同じ閉路上にある	aとcは同じ閉路にある
電球aと電球bは、電池を含む閉路に接続されたままです	cが燃え尽きても、aとbはバッテリーと閉じた経路のままです。
電球cとaは電池と同じ経路に含まれています。	aとcは異なる経路にある
電球はそれぞれ独自の経路を持つため	電球はそれぞれ独自の道を歩んでいる
スイッチがバルブと閉路になっているとき	スイッチと電球が同じ経路に含まれる場合
端子4,5,6がバッテリーのプラス端子に接続されているので	端子 4 , 5 , 6 はバッテリーのプラス端子に接続されています。
バルブbとcはバッテリーと密閉されたパティにありました。	電球bと電球cは、電池と同じ閉回路に収まっていた。
バルブaは閉路にある	電球aが燃え尽きれば、bもcも閉路にはならない
と同じ理由で、3	端子5は、バッテリーのマイナス端子と隙間を隔てて配置されています。
スイッチzは閉じているので、バッテリーへの完全な経路を形成しています。	スイッチz、スイッチx、電球a、c、電池を含む閉じた経路が残っています。
0から1.5へジャンプするとき、両端はギャップによって分離されます。	端子はギャップによって分離されている
電球は閉じた経路にあるわけではない	電池が電球のない経路に収まっている場合
閉回路が切れる	オープンスイッチの場合、ギャップが生じる
バッテリーマイナス端子は、端子1と端子2の間に隙間がある。	端子1と端子2が同じ電気的状態であること
電球aと電球cは、バッテリーの異なる経路に含まれています。	aとcはバッテリーで異なる経路にあります
スイッチは電球とバッテリーの閉じた経路の中になければなりません。	スイッチと電球は同じ経路になければならない。
電池が密閉された風呂に単独で入っていないこと	2の電池はクローズドパスになっていない。
blub a と bulb c は、同じ電池で異なる経路に含まれています。	aとcはバッテリーで異なる経路にあります
端子1、4接続	端子1と端子4は接続されています
端子1と端子2は同じ側にあります。	端子1と端子2が接続されている
ショートサーキットが発生した	ショートサーキットがある
はギャップがあることを教えてくれる	端子間に隙間がない
電球がパスに含まれていない	電球が電池を含む閉路にないこと
バッテリーのプラス端子に接続される端子と	端子4とプラス端子を接続
プラス端子は端子 4 に接続されています。	端子4とプラス端子を接続
球根aと球根cはまだ電池で閉路していました。	aとcの電球は、まだバッテリーと閉じた経路に収まっています。
スイッチYは別のパスにありました。	スイッチyと電球aは同じ閉路にはない
は、スイッチxと同じ経路にあった。	は、電池とスイッチxとの閉路に含まれたままである。
パスが開いているか閉じているか	電球とスイッチが同じ経路にある場合、スイッチは電球に影響を与えます。
電池が閉じた経路に収まっていない	4のバッテリーはクローズドパスになっていない。
というのは、スイッチyとzも電球aに接続されているからです。	a, c, z, x を含むパスが存在する。
両方の電球が閉じた経路に含まれる場合	破損した電球ともう一つの電球は同じ経路に含まれていなければなりません。
電球aは電球cと一緒に焼き切れる	cが燃え尽きれば、aとbはまだバッテリーと閉じた経路にあります。
端子1と端子2が同じ電圧であるのは、バッテリーマイナス端子に接続された電球が機能しているからです。	端子1と端子2が接続され，同じ電気的状態にあること。
プラス端子と4番端子の間に隙間がないこと	端子4とプラス端子はギャップによって分離されていません。
2つの端子の電気的な状態に差がないこと	が同じ状態であること。
を含む閉じた経路が存在します。	電球bとcはまだバッテリーと閉じた経路にあります。
プラス端子を持つため	電池は化学反応を利用して、端子で異なる電気的状態を維持します。
端子1は、バッテリーのプラス端子に接続されています。	端子1とプラス端子はギャップにより分離されています。
1番端子がバッテリーのプラス端子に接続されていない。	1番端子とプラス端子が接続されていない
0ボルトの電圧測定は、回路にギャップがあることを示します。	端子間に隙間がない
電球aと電球cは、電池と同じ経路に含まれています。	aとcはバッテリーと同じ経路にはない
電池は閉じた経路にあるが、他には何も接続されていない。	電池が他の部品を含まない閉じた経路に収まっていること。
端子には、電気的な状態の違いがなければ、電圧は発生しません。	電池は化学反応を利用して、端子で異なる電気的状態を維持します。
2つのコンポーネントが分離されます。	端子1とプラス端子はギャップにより分離されています。
正電荷がギャップより前にあるため	端子1とプラス端子はギャップにより分離されています。
スイッチyは電球aの経路上にない。	スイッチyと電球aの両方を含む経路は存在しない
2つのバルブ端子の間に隙間がある	端子はギャップによって分離されている
プラス端子と端子6が接続されている	端子6とプラス端子を接続
電球は閉回路に収容されている	電球とスイッチが同じ経路にある場合、スイッチは電球に影響を与えます。
電池は閉じた経路に収まっています	電池が他の部品を含まない閉じた経路に収まっていること。
内部で化学反応を起こすため、常に同じ電圧になります。	電池は化学反応を利用して、端子で異なる電気的状態を維持します。
電池のプラス端子とマイナス端子の間にゲージを挟みます。	端子1と端子2が同じ電気的状態であること
端子1と端子2がバッテリーのマイナス端子に接続されています。	端子1と端子2が接続され，同じ電気的状態にあること。
回路に関係なく持っているため	電池は化学反応を利用して、端子で異なる電気的状態を維持します。
バルブbにギャップがあるため	端子4,5,6は，バッテリ負端子と隙間をもって分離されている。
の場合、端子間の電気的状態は同じになり、0になります。	が同じ状態であること。
プラス端子は端子6に接続されています。	端子6とプラス端子を接続
隙間ができてしまうため	電球aが燃え尽きれば、bもcも閉路にはならない
バッテリーのクローズドパス	電球と電池は閉じた経路にあります。
スイッチYはバルブAに影響を与えなかった	スイッチyと電球aは同じ閉路にはない
球根aと球根bは、電池までの閉じた経路に収まったままです。	電球aと電球bはまだバッテリーと閉じた経路にあります。
バッテリーは閉じた経路に含まれません。	4のバッテリーはクローズドパスになっていない。
電圧とは、電池のプラスとマイナスの差のことです。	端子1とプラス端子はギャップにより分離されています。
スイッチYはバルブAに影響を与えない	スイッチyと電球aは同じ閉路にはない
球根bとcは閉じた経路にある	bとcは同じ経路にある
電池はバルブに内蔵されています。	電池が他の部品を含まないパスの中に入っていること。
というのも、経路にギャップがあったのです。	は、zとcの両方を含むパスが存在します。
電球bと電球cは、バッテリーの異なる経路に含まれています。	bとcはバッテリーと同じ経路にある
プラス端子とギャップが分離していない。	端子4とプラス端子はギャップによって分離されていません。
" なぜなら、電球はそれ " 自体の道を歩んでいるからです。"	bulb cは別のパスにあります
バッテリーへの接続	一回路あり
バッテリーとブラブの両方が同じ経路で必要で、経路は閉じている必要があります。	球と電池を含む閉路がある
一端と二端の間にギャップがある	隔たりなく
接続に隙間がない	端子が隙間で隔てられていないこと
スイッチは、経路が開いているか閉じているかを決定します。	電球とスイッチが同じ経路にある場合、スイッチは電球に影響を与えます。
電球とスイッチがバッテリーの経路上にある場合、スイッチは電球に影響を与える。	スイッチと電球が同じ経路に含まれる場合
回路に隙間がある	端子1と端子4は接続されています
電球は閉回路にあり、電池はその回路に存在する。	2の電池はクローズドパスになっていない。
電池のプラス端子が端子4と隙間なく離れていないこと。	端子4とプラス端子はギャップによって分離されていません。
もう一方の電球は点灯しません。	破損した電球ともう一つの電球は同じ経路に含まれていなければなりません。
電球bとcはバッテリーと閉回路になっているため	電球bと電球cは、電池と同じ閉回路に収まっていた。
端子間に隙間がない	端子1はバッテリーのマイナス端子に接続されています。
というのも、プラスとマイナスの接続があるため	端子1と端子6が接続されていない
端子と端子の間に隙間がないため	電池と一緒に閉じた経路の中に、まだ電球aが含まれています。
電池が閉まっていない 電球が.	2の電池はクローズドパスになっていない。
端子 1 はプラス端子に接続されていません。	1端子とプラス端子が接続されていない
バッテリ負端子に接続される端子と	端子が接続されていない
バッテリーのプラス側端子と端子1が接続されていない。	1番端子とプラス端子が接続されていない
電気的な状態の違いがあります	端子はギャップによって分離されている
閉回路のままなので	電池と同じ閉じた経路の中に、まだ電球aが含まれていたのだ。
電池は化学反応を利用して電圧を発生させます。	電池は化学反応を利用して、端子で異なる電気的状態を維持します。
端子6を差動に接続	端子6とプラス端子を接続
正電池端子は、端子4から間隙を隔てて配置され	端子4と正電池端子が同じ電気的状態であること。
電球と電池の閉じた経路にあるスイッチは、電球に影響を与えます。	電球とスイッチが同じ経路にある場合、スイッチは電球に影響を与えます。
プラス端子が3番端子とギャップで隔てられているため	端子3とプラス端子はギャップによって分離されています。
同じパスにはないのです。	電球aはまだバッテリーと閉じた経路にあります
電球が傷つくと、隙間ができる。	電球が傷つくと隙間ができる
電圧は切れた電球の近くにあります。	電圧測定は、電球の破損により電気的状態が変化する箇所を示します。
端子間の電気的な状態を測定することができます。	電圧の測定は、ギャップによって電気的状態が変化する場所を示す。
回路5が閉路であること .	電池は電球のない閉じた経路に収まっています。
bとcはまだバッテリーの閉回路に収まっていました。	電球bと電球cは、電池と同じ閉回路に収まっていた。
回路の隙間がどこにあるのかを見つけるのに役立ちます。	電圧測定は、2つの端子がギャップによって隔てられているかどうかを示します。
" バッテリー端子が何の装置もなしに接続されない "	バッテリーがオープンパスにある
端子をバッテリーのプラス端に接続します。	端子 4 , 5 , 6 はバッテリーのプラス端子に接続されています。
電池が閉路にあるため .	電池は電球のない閉じた経路に収まっています。
というのも、どちらの成分も閉じた経路をとらないからです。	回路4は閉路をもたない
スイッチXはバルブBとCに影響を与えません。	xを含まないbとcのパスが存在する。
bulb aは、今後サーカットを完成させることはありません。	電球aが燃え尽きれば、bもcも閉路にはならない
スイッチyは電球aとは別の経路にある	スイッチyと電球aは同じ閉路にはない
バッテリに接続されたまま	cが燃え尽きれば、aとbはまだバッテリーと閉じた経路にあります。
それは、閉じた道だった	電池と同じ閉じた経路の中に、まだ電球aが含まれていたのだ。
バルブCは隙間を作る	cが燃え尽きれば、aとbはまだバッテリーと閉じた経路にあります。
端子4，端子5，端子6が電池のプラス端子に接続されている。	端子 4 , 5 , 6 はバッテリーのプラス端子に接続されています。
電球cと電池は，閉じた経路に含まれない	電球cは電池との閉路でなくなった。
端末に隙間があったため	スイッチyと電球aの両方を含む経路は存在しない
電球cは、電球bとaのパスにギャップを生じさせません	cが破損しても、aとbは閉じた経路の中にある
もう一方の電球が電池との閉路に含まれなくなった場合	破損した電球ともう一つの電球は同じ経路に含まれていなければなりません。
両方が同じ側の回路	端子1，2，3はバッテリーのマイナス端子に接続されています。
バッテリーのプラス端子と6番端子の間に隙間がないこと	端子6とプラス端子はギャップによって分離されていません。
というのも、端子1には隙間がなかったからです。	端子1とプラス端子はギャップにより分離されています。
端子1とネーティブ端子が分離しているからです。	端子1とプラス端子はギャップにより分離されています。
端子 1 はマイナス端子に接続されています。	端子1はバッテリーのマイナス端子に接続されています。
電圧はどの2つの端子間でも同じ電気的状態である。	端子1，2，3は，正電池端子と隙間なく並んでいる。
端子1にギャップがないため	端子1はバッテリーのマイナス端子に接続されています。
球根aと球根bは、まだ含まれるパスになります。	cが燃え尽きれば、aとbはまだ閉じた経路の中にある。
第1端子と第6端子はギャップによって隔てられている	端子1と端子6がギャップによって分離されている
スイッチと電球が同じパスに含まれている場合、スイッチは電球に影響を与えます。	スイッチと電球が同じ経路に含まれる場合
aとcの電球は、バッテリーの異なる経路に含まれているため	aとcはバッテリーで異なる経路にあります
電球aが点灯していた	電池と同じ閉じた経路の中に、まだ電球aが含まれていたのだ。
電球aと電球cは、バッテリーで異なる経路に含まれています。	aとcはバッテリーで異なる経路にあります
というのも、打者端子が端子からギャップによって隔てられていなかったからです。	端子4とプラス端子はギャップによって分離されていません。
パスが開いている場合、電球は消灯します。	電球とスイッチが同じ経路にある場合、スイッチは電球に影響を与えます。
を選択すると、隙間の位置がわかります。	電圧が0でない場合は、端子が接続されていないことを意味します。
バルブ端子3、4	端子1とプラス端子はギャップにより分離されています。
球根aは閉じた経路に含まれる	電池と同じ閉じた経路の中に、まだ電球aが含まれていたのだ。
というのは、電球aは閉じた経路の中にあり、電球cは閉じた経路の中にあるからです。	aとcの球根はまだ閉路にある
電球aと電球cは、電池と異なる経路に含まれています。	aとcはバッテリーで異なる経路にあります
スイッチxとzが閉じていれば、電球aの閉回路が完成します。	スイッチz、スイッチx、電球a、c、電池を含む閉じた経路が残っています。
電池のある閉路に電球aがあった。	電池と一緒に閉じた経路の中に、まだ電球aが含まれています。
球根bと球根cは電池と閉じた経路に収まっていた。	電球bと電球cは、電池と同じ閉回路に収まっていた。
球根 a と c は互いに影響し合っています。	aとcは同じ経路にある
バッテリーへのクローズドパスがある	aとcの電球は、まだバッテリーと閉じた経路に収まっています。
2つの端子間の電気的状態をチェックするものです。	電圧の測定は、ギャップによって電気的状態が変化する場所を示します。
プラス側に接続されていたため	端子1とプラス端子はギャップにより分離されています。
でんきせいぎょう	電圧の測定は、ギャップによって電気的状態が変化する場所を示します。
スイッチと電球は同じ経路に含まれる	電球aが燃え尽きても、電球bとcは閉じた経路にある
スイッチの影響を受けない閉じた経路がありました。	スイッチyと電球aの両方を含む経路は存在しない
というのも、2つのバッテリー端子間の電気的な状態は、どのようなものであっても異なるからです。	電池は化学反応を利用して、端子で異なる電気的状態を維持します。
バッテリー端子からバルブ端子が外れている場合	端子が接続されていない
端子1はプラス端子と分離されています	端子1とプラス端子はギャップにより分離されています。
バッテリーの端子とパスが閉回路になったままだったため	aとcの電球は、まだバッテリーと閉じた経路に収まっています。
というのは、電球aはバッテリーと閉じた経路をとっているからです。	電球aはまだバッテリーと閉じた経路にあります
端子1にギャップがある	端子1と端子2が同じ電気的状態であること
バルブbにギャップがあるため	端子1，2，3は，正電池端子と隙間なく並んでいる。
バッテリーのプラス端子は6番端子に接続されています。	端子6とプラス端子を接続
バルブbに隙間があるため	端子4，5，6がバッテリーのマイナス端子に接続されていないこと。
電球a、電球b、電球cは、それぞれ異なる閉路に含まれる。	aとcはバッテリーで異なる経路にあります
パスには電球が含まれており、パスは閉じられていない。	一理も二理もない
電球bと電球cは閉じた経路の中に含まれている	bとcはバッテリーと同じ経路にある
電池と電球が閉じた経路になっていないからです。	4のバッテリーはクローズドパスになっていない。
破損した電球が閉回路に含まれる場合	破損した電球ともう一つの電球は同じ経路に含まれていなければなりません。
端子と6番端子を接続	端子1と端子6が接続されていない
球体aと球体cは同じ閉路に含まれない．	aとcは同じパスにはない
端子4がマイナス端子に接続されているため	端子4と正電池端子が同じ電気的状態であること。
電球とバッテリーが接続されている	バッテリーがオープンパスにある
不完全な回路は、端子間の電気的状態に影響を与えません。	電池は化学反応を利用して、端子で異なる電気的状態を維持します。
スイッチが閉回路に接続されていたため	スイッチyと電球aの両方を含む経路は存在しない
電球aと電球cは同じ閉路に含まれない	aとcは同じパスにはない
プラス側バッテリ端子とマイナス側バッテリ端子が分離されており	端子間に隙間がない
回路に隙間ができる	電球が傷つくと隙間ができる
端子1とバッテリーのプラス端子が閉路上にあるため	端子1はバッテリーのマイナス端子に接続されています。
電圧は端子の電気的状態の差です。	端子1とプラス端子はギャップにより分離されています。
4番端子とプラス端子の間に隙間がないため	4端子とプラス端子の間に隙間がないこと
スイッチzで、電球aと電池を含む閉じた経路があります。	a , c , z を含むパスが存在し、バッテリ
回路4は、電池が閉路に収まっていないため、短絡していない。	4のバッテリーはクローズドパスになっていない。
と同じ理由で、1	3番端子とプラス端子が接続されていない
バッテリーのプラス端子が6番端子と隙間なく離れていなかった。	端子6とプラス端子はギャップによって分離されていません。
バルブbの回路にギャップがあると、電圧の測定値が0になります。	端子4は、バッテリーのマイナス端子と隙間を隔てて配置されています。
回路に隙間があっても、バッテリーの電圧には影響しません。	電池は化学反応を利用して、端子で異なる電気的状態を維持します。
電池は0でも必ず電圧があるので	電池は化学反応を利用して、端子で異なる電気的状態を維持します。
プラス端子とマイナス端子が接続されていない	電池は化学反応を利用して、端子で異なる電気的状態を維持します。
端子6はバッテリーのプラス端子に接続されています。	端子6とプラス端子を接続
電球は、経路上にあるスイッチの影響を受けます。	電球とスイッチが同じ経路にある場合、スイッチは電球に影響を与えます。
そして、サーカットは閉じられる	aとcは同じ閉路にある
パスがスイッチに接続されている場合、電球は消灯します。	電球とスイッチが同じ経路にある場合、スイッチは電球に影響を与えます。
すべての電球は平行に配置されています。	aとcは異なる経路にある
端子6をプラス端子に接続	端子6とプラス端子を接続
電圧があれば、ギャップがあることを意味するので	電圧の測定は、ギャップによって電気的状態が変化する場所を示します。
端子4はバッテリーのプラス端子に接続され，端子4はギャップによって隔てられていない。	端子4とプラス端子を接続
端子5はポストバッテリー端子に接続されています。	端子5とプラス端子を接続
電球aはバッテリーと閉回路になっていたため	電池と一緒に閉じた経路の中に、まだ電球aが含まれています。
回路2がバッテリーに接続されている	電池を含む閉路は存在しない
バッテリーに接続された別々のパス	電球aが燃え尽きると、bとcは電池との閉路でなくなります。
パスが閉じない	バッテリーがオープンパスにある
aとcの球根は、それぞれの完成された円周上にあります。	球根aと球根cは閉じた経路にある
電球bと電球cは、バッテリーと閉じた経路のままです。	電球aと電球bはまだバッテリーと閉じた経路にあります。
バッテリーのプラス端子に端子が接続されていない。	端子1と端子2が接続されている
「なぜなら、電圧を測定することによって、電気的な状態の違いがあるギャップを見つけることができるからです。"	電圧の測定は、ギャップによって電気的状態が変化する場所を示します。
電球bは、電球a、cと同じ経路にはありません。	バルブbは別経路
電球は閉じた経路に含まれません。	電池が他の部品を含まないパスの中に入っていること。
電池、電球a、電球cを含む閉じた経路がまだ存在する	aとcの電球は、まだバッテリーと閉じた経路に収まっています。
隙間ができると．	スイッチと電球が同じ経路に含まれる場合
端子6はバッテリーのプラス端子に接続されています。	端子1と端子6が接続されていない
パスがバッテリーに直接接続されている場合、スイッチは電球に影響を与えます。	電球とスイッチが同じ経路にある場合、スイッチは電球に影響を与えます。
1端子と2端子の違いはありません。	端子1と端子2が接続され，同じ電気的状態にあること。
は、バルブbのない他の閉路が存在します。	球根aと球根cは閉じた経路にある
バッテリープラス端子と6番端子を接続したため。	端子6とプラス端子を接続
電球bとcはバッテリーと同じ経路にあります	bとcはバッテリーと同じ経路にある
端子1と端子6が接続されている	端子1と端子6がギャップによって分離されている
端子が接続されていないため	電池は化学反応を利用して、端子で異なる電気的状態を維持します。
他の端子はバッテリーのプラス端子に接続されているため	端子 4 , 5 , 6 はバッテリーのプラス端子に接続されています。
バルブcは、パスのギャップを生じさせる	電球はそれぞれ独自の道を歩んでいる
バッテリーと他の経路の間に隙間ができてしまうからです。	電球aが燃え尽きても、電球bとcは閉じた経路にある
スイッチxは、バルブaの閉路にある。	は、電池とスイッチxとの閉路に含まれたままである。
ある時点でギャップが発生し、電圧が低下するため、.	ゼロでない電圧は、端子がギャップによって分離されていることを意味します。
電球の破損による隙間があるため。	端子1，2，3は，正電池端子と隙間なく並んでいる。
電池内部の化学反応により、正極と負極の電気的な状態が常に異なる。	電池は化学反応を利用して、端子で異なる電気的状態を維持します。
バッテリーとの経路が異なる	bとcはバッテリーと同じ経路にある
端子6はプラス端子に直接接続されています。	端子6とプラス端子を接続
電球と電池の間にスイッチを接続した場合	スイッチと電球が同じ経路に含まれる場合
隙間ができてしまうので、回路が不完全になるため	電球が傷つくと隙間ができる
電球bは独立した経路にある	バルブbは別経路
電池のプラス端子は端子6に接続されています。	端子6とプラス端子を接続
バッテリーのプラス側端子と電球側端子の間に隙間ができる。	電圧が0でない場合は、端子が接続されていないことを意味します。
電球bに隙間ができ、他の回路に影響を与える。	バルブbはギャップを作る
端子1と端子2が接続されている	端子1と端子4は接続されています
端子には電球が接続されています。	端子1，2，3は，正電池端子と隙間なく並んでいる。
「電池の2つの端子間の電気的な状態の違い	電池は化学反応を利用して、端子で異なる電気的状態を維持します。
は、1つの端子だけが回路に関与しています。	2の電池はクローズドパスになっていない。
あいだがあく	端子2とプラス端子はギャップにより分離されています。
電池に含まれる化学物質によるもので	電池は化学反応を利用して、端子で異なる電気的状態を維持します。
また、球根aと球根bは閉じた経路に含まれます。	cが燃え尽きれば、aとbはまだ閉じた経路の中にある。
電池と電球を含む完全な経路	球と電池を含む閉路がある
バッテリーで閉じた経路で膨らんだからです。	電池と一緒に閉じた経路の中に、まだ電球aが含まれています。
電球が含まれており、バッテリーへの回路が完全ではない	2の電池はクローズドパスになっていない。
というのも、同じ道を歩んでいるわけではなく	電球aが燃え尽きても、電球bとcは閉じた経路にある
電池と電球は、閉じた経路で接続する必要があります。	電球と電池は閉じた経路にあります。
1端子とプラス端子を接続します。	端子1とプラス端子はギャップにより分離されています。
端子間に隙間がないため	端子1がバッテリーのマイナス端子から分離されていないこと。
端子1と端子2がバッテリーのマイナス端子に接続されています。	端子1と端子2が接続されている
2つのバッテリー端子間には、常に電圧の差があります。	電池は化学反応を利用して、端子で異なる電気的状態を維持します。
電池は化学反応によって電圧を発生させる	電池は化学反応を利用して、端子で異なる電気的状態を維持します。
cが乗っていた回路には隙間があった。	バルブcは閉じた経路になかった
端子 5 はバッテリーのポスティブ端子に接続されています。	端子5とプラス端子を接続
スイッチが電球と同じ位置にあるとき。	スイッチと電球が同じ経路に含まれる場合
電球の端子とバッテリーの端子が同じ側にあること。	が同じ状態であること。
バッテリーのプラス端子に接続されていることがわかります。	端子間に隙間がない
この図には、2つのパスがあります。	aを含むパスとbとcを含む別のパスが存在する。
電池と一緒に閉じた経路の中に、まだ電球aが含まれていたのです。	電池と同じ閉じた経路の中に、まだ電球aが含まれていたのだ。
閉回路のバッテリーが必要です。	電球と電池は閉じた経路にあります。
なぜなら、電球は閉じた経路を持っていないからです。	電球が電池を含む閉路にないこと
なぜなら、1つの電球が壊れると、他の電球の点灯にも影響が出るからです。	aとcは同じ閉路にある
端子1と端子4が直接接続されているため	端子1と端子4は接続されています
aとcの両方の球根はまだ閉じた経路を持っています。	aとcの球根はまだ閉路にある
電圧とは、電池のプラス端とマイナス端の差です。	端子1はバッテリーのマイナス端子に接続されています。
電球aと電球cは、電球bと同じ経路にはない	a、b、cはそれぞれ異なる経路にあります。
バッテリーのプラス端子と端子5が接続されている	端子5とプラス端子を接続
マイナス端子、プラス端子のどちらからも受信できない。	端子間に隙間がない
端子4はバッテリーのプラス端子に接続されています。	端子4とプラス端子を接続
電球とスイッチが同じ閉路にある場合、スイッチは電球に影響を及ぼします。	スイッチと電球が同じ経路に含まれる場合
bulb cは独自の経路で	bulb cは別のパスにあります
aとcはまだ電池と閉じた経路を持っていた。	aとcの電球は、まだバッテリーと閉じた経路に収まっています。
バッテリーにはプラスとマイナスの端子があり、常に電圧がかかっています。	電池は化学反応を利用して、端子で異なる電気的状態を維持します。
プラス端子は1.5V	端子1とプラス端子はギャップにより分離されています。
隙間があるのがわかると思います	電圧の測定は、ギャップによって電気的状態が変化する場所を示す。
電球は閉回路にあります	バッテリーがオープンパスにある
バッテリーのマイナス端子に端子が接続されていない。	端子1と端子6が接続されていない
球根a,b,cはすべて同じ経路にある．	aとcは同じ経路にある
電圧は2点間の差を測定するため	端子1とプラス端子はギャップにより分離されています。
電球aはバッテリーと閉じた経路にある	aを含むパスとbとcを含む別のパスが存在する。
電池と電球は一緒に閉じた経路になければなりません。	電球と電池は閉じた経路にあります。
電気的状態の差は1.5ボルトです	端子1とプラス端子はギャップにより分離されています。
バルブCは、オープンパスになっていました。	バルブcは閉じた経路になかった
電球bとcの両方が電球aと同じ経路にあること	電球aが燃え尽きれば、bもcも閉路にはならない
2つの端子に違いはありません。	が同じ状態であること。
電球aとスイッチyは同じ経路にはない。	スイッチyと電球aは同じ閉路にはない
電球aは、電球bと電球cと同じ経路にはありません。	aを含むパスとbとcを含む別のパスが存在する。
赤い×印は、バッテリーがショートしていることを意味します。	ショートサーキットがある
バッテリーと電球の経路でスイッチが開いている場合、.	スイッチと電球が同じ経路に含まれる場合
電球Aと電球Bは、電池との閉路のままです。	電球aと電球bはまだバッテリーと閉じた経路にあります。
電球aとcは電球bと同じ閉経路にない	バルブbは別経路
どの電球が切れても、それはシステム全体に影響し、すべてがバッテリーから遮断されます。	電球はそれぞれ独自の道を歩んでいる
端末が同じ状態であるため	端子1はバッテリーのマイナス端子に接続されています。
4 , 5 , 6 はプラス側に接続されています	端子 4 , 5 , 6 はバッテリーのプラス端子に接続されています。
それは、開かれた道です。	ショートサーキットがある
と同じ理由で、3	端子6とプラス端子はギャップによって分離されていません。
には隙間がある	電球はそれぞれ独自の道を歩んでいる
1番端子と4番端子が同じ	端子1と端子4が接続され，同じ電気的状態にあること。
赤い×印は、回路が安全でないことを意味します。	ショートサーキットがある
を含む閉じた経路がまだ存在します。	電球bとcはまだバッテリーと閉じた経路にあります。
4 5と6がバッテリーのマイナス端子に接続されていない。	端子4，5，6がバッテリーのマイナス端子に接続されていないこと。
を使うと、閉じたパスが壊れます。	オープンスイッチの場合、ギャップが生じる
電球BとCはバッテリーと同じ閉回路にあるが、電球Aとは別である。	aを含むパスとbとcを含む別のパスが存在する。
" "ギャップを生じさせなかったからである。"	電球はそれぞれ独自の道を歩んでいる
端子がバッテリーに接続されている	端子1はバッテリーのマイナス端子に接続されています。
端子5はバッテリーのポスティブ端子に接続されています。	端子5とプラス端子を接続
スイッチが電球と同じ経路に含まれる場合	スイッチと電球が同じ経路に含まれる場合
正電池の端子は端子4と間隔をあけて配置されています。	端子1と端子4の間に隙間がないこと
他の端子はプラス端子に接続されています。	端子 4 , 5 , 6 はバッテリーのプラス端子に接続されています。
回路に隙間ができてしまうからです。	電球が傷つくと隙間ができる
aはクローズドバッテリに	電池と一緒に閉じた経路の中に、まだ電球aが含まれています。
電球はバッテリーの両端に接続され、閉回路でなければなりません。	一回路あり
端子 5 はバッテリーのプラス端子に接続されています。	端子5とプラス端子を接続
電球bとcはまだバッテリーと閉じた経路にあります。	電球bとcはまだバッテリーと閉じた経路にあります。
バッテリーのプラス端子に接続されていない。	1番端子とプラス端子が接続されていない
電球bは電球aとcの経路にギャップを生じさせず	aとcの球根はまだ閉路にある
バッテリーのプラス端子と端子4が接続されている	端子4とプラス端子を接続
スイッチYが開いていても、電球aの閉路は存在する。	電池と一緒に閉じた経路の中に、まだ電球aが含まれています。
電池で閉じた経路のままだった電球aは	電池と同じ閉じた経路の中に、まだ電球aが含まれていた。
端子1がバッテリーのプラス端子に接続されていた	端子1とプラス端子はギャップにより分離されています。
電球 a と b は、電球 c と同じ経路にはありません。	bulb cは別のパスにあります
パスがスイッチを介してエネルギーを通過させる	電球とスイッチが同じ経路にある場合、スイッチは電球に影響を与えます。
球体a b cは閉じた経路上にある	aとcは同じ閉路にある
すべての端子が他の端子に接続されているため、スイッチが開くと、それが中断されます。	オープンスイッチの場合、ギャップが生じる
端子1と端子4が接続されている	端子1と端子4は接続されています
プラス端子が5番端子と隙間なく接していること。	端子5とプラス端子はギャップによって分離されていません。
電球端子とバッテリー端子が接続されていない。	端子が接続されていない
バッテリーが閉じた経路にない。	4のバッテリーはクローズドパスになっていない。
回路に隙間がある	端子1とプラス端子はギャップにより分離されています。
あながあいてしまう	電球aが燃え尽きれば、bもcも閉路にはならない
端子が閉路になっていないため、バッテリー自体の電圧を与えていることになります。	電池は化学反応を利用して、端子で異なる電気的状態を維持します。
バルブbにギャップがあるため	端子1，2，3は，正電池端子と隙間なく並んでいる。
スイッチyは電球aの閉回路に影響を与えない	スイッチyと電球aは同じ閉路にはない
電気的な状態から、回路に隙間があるか、接続されているかを判断します。	電圧測定は、2つの端子がギャップによって隔てられているかどうかを示します。
閉回路が形成されたからです。	電池と同じ閉じた経路の中に、まだ電球aが含まれていたのだ。
スイッチと電球が同じ経路にある場合。	スイッチと電球が同じ経路に含まれる場合
電球の結果はお互いに影響しないので	aとcはバッテリーと同じ経路にはない
隙間があれば	電圧測定は、2つの端子がギャップによって隔てられているかどうかを示します。
バッテリーと閉じた経路にある	a , c , z を含むパスが存在し、バッテリ
電球aと電球cは、電池を含む閉じた経路のままです。	aとcの電球はまだバッテリーと閉じた経路にあります。
同じ経路にある場合、スイッチの切り替えは電球に影響します。	スイッチと電球が同じ経路に含まれる場合
電池は閉回路にあり、電池の通り道には何もありません。	電池が他の部品を含まない閉じた経路に収まっていること。
電球aと電球bは、まだバッテリーと閉じた経路に収まっています。	cが燃え尽きても、aとbはバッテリーと閉じた経路のままです。
中心部にあるからでしょうか。	バルブbは別経路
バッテリーの両端が接続されていないため	バッテリーがオープンパスにある
電池は化学反応反応を維持する.	電池は化学反応を利用して、端子で異なる電気的状態を維持します。
端子4,5,6がプラス端子に接続されています。	端子 4 , 5 , 6 はバッテリーのプラス端子に接続されています。
バッテリーのプラス端子が接続されていない	6番端子とプラス端子の間に隙間がないこと
閉じていれば点灯するが、開いていれば点灯しない。	電球とスイッチが同じ経路にある場合、スイッチは電球に影響を与えます。
電球aは閉じた循環経路上にある	電池と同じ閉じた経路の中に、まだ電球aが含まれていたのだ。
電球が同じ閉路上にある場合	破損した電球ともう一つの電球は同じ経路に含まれていなければなりません。
片側が閉じていて、もう片側が開いている。	バッテリーがオープンパスにある
電池と一緒に閉路に収められた電球aは	電池と同じ閉じた経路の中に、まだ電球aが含まれていたのだ。
は閉じたパスです。	電池を含む閉路は存在しない
電球から電池までの経路がある	電池と一緒に閉じた経路の中に、まだ電球aが含まれています。
を経由して、電球bはまだバッテリへの閉じた経路に含まれています。	cが燃え尽きても、aとbはバッテリーと閉じた経路のままです。
スイッチと電球が同じ閉路に含まれる場合	スイッチと電球が同じ経路に含まれる場合
電球bとcは電池と一緒に閉じた経路に収まっていました。	電球bと電球cは、電池と同じ閉回路に収まっていた。
というのも、バッテリーのプラス端子が端子6と隙間なく離れているからです。	端子6とプラス端子はギャップによって分離されていません。
3と正電池の間のギャップ	端子3とプラス端子はギャップによって分離されています。
の場合、回路4には閉路が存在しない。	回路4は閉路をもたない
バッテリーの電圧は変化しないので	電池は化学反応を利用して、端子で異なる電気的状態を維持します。
a はそのパス上にある b と c はパスを共有している	aを含むパスとbとcを含む別のパスが存在する。
化学反応がある．	電池は化学反応を利用して、端子で異なる電気的状態を維持します。
電球は電池と一緒に閉じた経路に収めなければならない	破損した電球ともう一つの電球は同じ経路に含まれていなければなりません。
Yスイッチを入れないと、aはバッテリーと閉回路になります。	電球aはまだバッテリーと閉じた経路にあります
aとcの電球は、電池と異なる経路に含まれています。	aとcはバッテリーで異なる経路にあります
スイッチzは電球aと同じ経路にあります。	電球aは、電池とスイッチzで閉じた経路の中にまだ含まれています。
同じパスに含まれない	cが燃え尽きれば、aとbはまだ閉じた経路の中にある。
電球bとcはバッテリーへの閉回路にあります。	電球aが燃え尽きても、電球bとcは閉じた経路にある
bとcにはまだバッテリーへの完全なパスがあります。	電球bとcはまだバッテリーと閉じた経路にあります。
2つの端子が接続されているため	端子1と端子4は接続されています
バルブAは隙間を作る	電球aが燃え尽きれば、bもcも閉路にはならない
2番端子と6番端子の間に隙間がある。	端子1と端子2が同じ電気的状態であること
それはまだ閉じた道を進んでいた	電池と同じ閉じた経路の中に、まだ電球aが含まれていた。
正電池の端子は端子4と間隔をあけて配置されています。	端子4と正電池端子が同じ電気的状態であること。
バッテリーのプラス側接続部と電球端子の間に隙間がある。	端子間に隙間がない
隙間風が吹けば桶屋が儲かる	電圧が0でない場合は、端子が接続されていないことを意味します。
電気的な状態が干渉される。	電圧が0でない場合は、端子が接続されていないことを意味します。
電球cがオープンパスにあったため	バルブcは閉じた経路になかった
電球aはバッテリーと閉じた経路にある	電球aはまだバッテリーと閉じた経路にあります
電池は正極と負極の間に独自の化学反応を持っているからです。	電池は化学反応を利用して、端子で異なる電気的状態を維持します。
バッテリーのプラス端子に接続される端子と	端子5とプラス端子を接続
端子と他の端子が接続されている	端子 4 , 5 , 6 はバッテリーのプラス端子に接続されています。
電球aとcはまだ電池と閉じた経路にあります。	aとcの電球は、まだバッテリーと閉じた経路に収まっています。
スイッチが電球と同じ経路にあるとき。	スイッチと電球が同じ経路に含まれる場合
各電球はそれぞれ完全な経路を持っているため	電球はそれぞれ独自の道を歩んでいる
バッテリーのプラス端子と4番端子の間に隙間がない。	端子4とプラス端子はギャップによって分離されていません。
端子6と端子1が接続されている	端子1と端子6がギャップによって分離されている
電球aと電球cは並列に配線されている	aとcは異なる経路にある
バッテリーの接続がうまくいかないこと	ショートサーキットがある
回路に隙間があると、電球は点灯しません。	電圧が0でない場合は、端子が接続されていないことを意味します。
1端子と2端子の電気的状態の違いは同じです	端子1と端子2が接続され，同じ電気的状態にあること。
道は閉ざされなければならない	電球とスイッチが同じ経路にある場合、スイッチは電球に影響を与えます。
プラス端子に接続されていた	端子1とプラス端子はギャップにより分離されています。
バッテリーに接続された独自の経路を持っています。	電球はそれぞれ独自の道を歩んでいる
電球と同じ経路にある場合	スイッチと電球が同じ経路に含まれる場合
電池が閉路にある。	電池が電球のない経路に収まっている場合
球根aは通路が閉じている	電池と同じ閉じた経路の中に、まだ電球aが含まれていたのだ。
オープンパスかクローズドパスかによる。	電球とスイッチが同じ経路にある場合、スイッチは電球に影響を与えます。
端子1がバッテリーのプラス端子から分離しているためです。	端子1とプラス端子はギャップにより分離されています。
バッテリや電球と同じ経路にある場合。	スイッチと電球が同じ経路に含まれる場合
両端子の電気的状態が異なるため	電池は化学反応を利用して、端子で異なる電気的状態を維持します。
は、両方ともバッテリーのマイナス端子に接続されています。	端子1と端子2が接続されている
の場合、2つの端子は共に0になります。	が同じ状態であること。
電球bが破損し、経路に隙間ができたため、電荷が届かなくなった。	端子1，2，3は，正電池端子と隙間なく並んでいる。
電池を使用したクローズドパスでは、電球を点灯させることができます。	電球とスイッチが同じ経路にある場合、スイッチは電球に影響を与えます。
を使用するため、電球が焼損します。	破損した電球ともう一つの電球は同じ経路に含まれていなければなりません。
電池が他の部品を含まない閉じた経路にあること。	電池が他の部品を含まないパスの中に入っていること。
端子が接続されていない	1番端子とプラス端子が接続されていない
なぜなら、電球bとcはバッテリーと閉じた経路をとっているからです。	電球bと電球cは、電池と同じ閉回路に収まっていた。
正と負のつながりがあったため	端子1はバッテリーのマイナス端子に接続されています。
3番端子との間に隙間ができてしまいました。	端子3とプラス端子はギャップによって分離されています。
