何が許可され、何が許可されないかについては、各出版社の特定のポリシーを確認する必要があります。	もし、本を出版する必要があり、それを許可してくれる出版社が1社でも見つかったら......。
大学が運営する参加者用プールがあることは知らない。	私が北米で勤務してきた大学では、人体実験（特に.
入学とは別に（普通は年齢と関係ないはずですが）、あなたの質問に関連することがあります。	ヨーロッパ大陸では、博士課程への進学率は高くはありません。
この記事は、幹細胞分野の研究についてのものであり、他の研究テーマには当てはまらない可能性があります。	これは私のコンピュータ工学での経験ですが、幅を広げるための読書がより重要なアプローチであることがわかりました。
adobe acrobat proにお金を払いたくない場合は、@ schultemが言及しているように、Latexは埋め込みハイパーリンクでこれを行うことができます。	あなたが気にしない場合は、ファイルをオンラインでホストする、slideshareは良いソリューションです。
この問題に特化した規格が存在するとは思えないのですが......。	この問題については、さまざまな答えが見つかるでしょう（つまり、おそらく「標準」はないのです）。
私の答えは、あなたが言っているのは、どのグレのことですか？	Gresの問題点は、スコアリングレンジが非常に圧縮されていることです。
トムソンロイターのウェブオブサイエンスポータルにアクセスすれば、簡単にできます。	arxiv culturomics のウェブサイトを見ることができます（http :/ / arxiv.culturomics.org で、arxiv の記事を検索することができます。
一般に、ポスターに至るまでには、多くの異なるワークフローが存在します。	完全を期すために、アップルのページには、かなり多くの素敵なポスターのレイアウトがあります。
相手が返さないかもしれないことを承知の上で、数字を要求するのは全く問題ない。	と聞けば、それは作者が受け入れるかどうかの選択です。
アメリカやほとんどのヨーロッパ諸国では、学年は9月頃に始まります。	私は、あなたが望むより悪い成績を得るのを避けるために、物事を加速させないだろう。
ブラボーが別の回答で言ったこととは全く逆のことをアドバイスします：Go for a !	入学を延期することは可能ですが、1年間延期することは少し珍しいことです。
edit, again : 質問の内容がまた変わっているようです。	教員が資格試験の成績を公表する理由は、3つ考えられます。
私はseteropereと完全に同意する、 "ネットワーク科学 "は非常に広い主題です。	私は、あなたが間違った方法でアプローチしていると思います。
個人的に、あるいは控えめにではなく、派手にイデオロギーを支持することは、人格の問題である。	適切な答えを出すには、「悪い」イデオロギーが何であるかを正確に知る必要があると思います。
これはあなたの質問に完全に答えるものではありませんが、一つの検討材料であることは間違いありません。	私は、数学、コンピュータサイエンス、エンジニアリングの学際的な専攻である計算科学の博士課程に在籍しています。
1）このようなIDシステムは、少々押し付けがましく感じられる。	数学では、我々はすでにこの種のデータベースを持っている - 2それら、実際には、でmathscinetとzentralblatt数学で 。
他の回答に補足する形で、「なぜ惑星は潮汐ロックする傾向があるのか」という質問にお答えします。	他の回答者の方々は、技術的な意味での説明が素晴らしいです。
星は回転していますが、それは星が安定している理由ではありません。	星は、星が形成されたガスの角運動量によって回転しています。
アンドロメダ銀河（M31）と天の川銀河（MW）が衝突しているように見えるのです。	数十億年後、天の川とアンドロメダが衝突する。
簡単に言うと、私たちは多くの星からもたらされた「物質」から作られているのです。	私たちがたった一つの星から作られたものである可能性は極めて低い。
私たちが知っているのは、遠くの物体は私たちからの距離に比例して遠ざかっていくということだけです。	宇宙の膨張は、宇宙論的距離にある物体が互いに遠ざかることを意味します。
クリスが言ったように、星は角運動量を保存するために回転している。	星は回転していますが、それは星が安定している理由ではありません。
このサイトによると、可視光度のピークは2月2日ごろの約10.5です。	aavsoのデータでは、10.5（目測）あたりですでにピークを迎えているようです。
これらの効果はすべて、11年の太陽周期に関係している。	太陽フレアの予測については、具体的にお答えします。
私たちは、「...動く宇宙の静止フレームに対して...レオ座に向かって約371km/sで」移動しているのです。	他の物体に対して相対的でない「静止」は存在しない。
確かに、月の見かけの大きさは30分角です。	月を "生で "眺めるとき、あなたは静止画を見ているのではありません。
球状星団のデータをm13と同等と仮定してみる。	球状星団は、複合星系の中で興味深い位置を占めている。
なぜ光の速度は 299,792,458 m / s で、( 例えば ) 3,1 や 4,3 x 10 ^ 44 m / s ではないのですか？	光速が有限であることは、私たちの宇宙の基本的な要素です。
あなたの定義によると、連星系で形成された星（したがって、何らかの重力体の近く）は、一般化された惑星である。	あなたの言う「一般化された惑星」の主な欠陥は、星と惑星の間の境界線でしょう。
星と星の間の距離を計算する方法として、3次元の三角法があります。	2つの星までの距離とその角度間隔がわかっていれば、2次元の三角法が必要なだけです。
遠ければ遠いほど、銀河は速く私たちから遠ざかる。	物理学スタック・エクスチェンジのサイトに投稿された同様の質問に対する私の回答です。
星は星形成領域で形成され、その領域自体が分子雲から発展する。	我々のような太陽系が銀河の外側に存在することは可能かもしれない。
ブラックホールとは、太陽質量の3倍以上の質量を持つ死んだ星にほかならない。	つまり、「greenwhichの恒星時とは？" .
しかし、同じ星座に留まることはありません。	星座は、夜空を理解するために人間が作り出したものです。
小惑星は、太陽系の内側にある小さな岩石質の天体で、小惑星と呼ばれるものです。	小惑星と彗星という2つの天体があります。
これは、私が数年前にphpとjavascriptを使って書いた語彙判断タスクです( github link )。	参考までに、私自身、ウェブベースの簡単な語彙判断タスクソフトを書くことになりました。
社会不安障害の人が外向的であることを想像するのはかなり難しい。	表面的には、社会不安障害と外向性は同じ人の中に存在してはいけないように見えますが。
感情には思考や感覚が含まれることがあるため、感情を思考や感覚から完全に分離することは困難です。	技術的に言えば、感情は、それが脳内で処理される方法と同じで、どちらも神経伝達物質が関与しています。
プロトタイプ理論というものがあります。	人間の概念学習に関する現在のモデルによれば、あなたの質問への答えは両方です。
世の中には、「直観像記憶（eidetic memory）」と呼ばれるような、並外れた記憶力を持つ人がいます。	なぜそうでないかは、いろいろな議論があります。
スパイクトリガーは特定のタイプであり、逆相関、共分散、確率のサブセットと言えるでしょう。	スパイクトリガー平均化のナイーブなバージョンと、洗練されたバージョンがあります。
他のコメントにもあるように、予測変数の種類が混在している場合、anovaは問題がある。	私は、マルチタスクとは、高速にタスクを切り替えることだと考えています。
Q : 極端な状況下において、人々が仲間を暗黙のうちに信頼する理由は何でしょうか？	人間同士の信頼関係によって定義される。
内発的報酬とは、ある活動を完了することによって得られる感情的な報酬のことです。	フレデリック・ハーズバーグの「動機づけの2要因理論」によれば、内発的報酬は動機づけの要因となる（例．
ドライバーの減速判断は、様々な要因に影響されると思われます。	このショートトークは、「ちょっとだけズルい」問題を扱っています : Dan Ariely : our buggy moral code .
成人のIQを研究する場合、一般的な成人の規範がよく使われる。	基本的には、各年齢層のiqを標準化サンプルと比較することです。
いくつかの古代の歴史的な先例は、10ドルを好むために存在する , しかしまた、6ドル , そう 'は完璧な数字にwikipediaからのサポートが混在しています .	これは確かに可能ですが、実現可能性以外の理由で、実験的に行われたのを見たことがありません。
これらは興味深い研究ですが、結論から言うと、「環境は認知能力に影響を与える」です。	私は、あなたの言う「認知能力」というものがよくわからないのですが、私は、言語が私たちの考え方を形成していると確信しています。
これは行動学の研究者にとって比較的新しい問題なので、共通のコンセンサスがあるとは思えません。	私はあなたの3つの質問のうち、最初のものだけを取り上げることにします。
もし人間以外の動物にも知性があるのなら、なぜ彼らの知性は人間ほど高くないのでしょうか？	自説がダメなのは、進化論のラマーキアン的解釈からきていると思われるからです。
ヘアーサイコパシーチェックリストは、臨床現場でのサイコパシーの評価によく使われます。	9歳児をサイコパスと呼べるか」という記事から。
ステーキを1枚ずつフリーザーペーパーで包み、ジップロックのフリーザーバッグに入れるんです。	をビニールでよく包み、フリーザーバッグに入れます。
油に加えて、調理を開始する前に、グリルが素敵で熱いことを確認してください。	今までペーパータオルで油を塗っていたのですが、新聞紙の方がずっといいことがわかりました。
一番良い方法は、焼く前に耳を殻に数時間浸しておくことです。	耳は丸ごと水に浸けておく。
実は、小麦粉の種類によって、かなりの違いがあるのです。	この違いは、小麦粉に含まれるタンパク質の量が5％から15％の間であることです。
卵の数で時間の長さを調整したことはないのですが......。	ゆで卵のタイミングをつかむのに十分な時間がないのです。
チーズをおろし金から離して端に寄せるだけでいいんです。	質問文から察するに、ピラミッド型のおろし金か、シート型のおろし金を使っているのでしょう。
私は2ヶ月以上冷凍庫でパンケーキを保存し、任意の冷凍庫焼けを持っていなかった。	包装の種類や冷凍庫によって異なります。
球根を底と真ん中にある乾いた棒を折って、クローブにします。	ナイフをクローブの上に水平に置き、それを叩く。
私はこのレシピを見つけることができました、私はここでアイデアを得たと思います。	バーベキューソースはまだ数種類しか作っていませんが、いつもとてもおいしくできています。
ニンニクのミンチ（缶詰）と生のニンニクの違いは、一度調理してしまうとわからないと思います。	私の経験では、生のニンニクは、食感が欲しいときや、風味の注入を遅くするときに最適です。
私は皮付きのサーモンを焼いています。	サーモンは素晴らしい選択であり、それはかなり多くの場所で容易に利用可能です。
私のレシピでは、肉を冷凍庫に入れてから、フライパンで焼くんです。	冷やした肉から始めて、すぐに沸騰したお湯を外側に注ぎます。
同じ味はしないし、もっと重要なのは、同じ匂いがしないことです。	ブラックペッパーとホワイトペッパーは、ニガウリの果実から作られる異なる調味料です。
これは、購入したトマトの品種の賞味期限によります。	トマトは冷蔵庫に入れると長持ちしますが、実は冷蔵庫に入れない方がいいんです。
凝固した卵タンパク質は、グルテンと一緒になって、焼き菓子に必要な構造を与えています。	ケーキは基本的にバターケーキとスポンジケーキの2種類に分けられます。
一般的なのはハドックで、一年中旬を迎えています。	白身魚は、原則として、濃い肉質の魚よりも繊細な味わいを持っています。
良いチェダーには乳酸カルシウムの塊があるのですが、そのせいでしょうか？	1つは、小麦粉とバターを混ぜたルーの加熱が不十分で、小麦粉が完全に混ざり合っていないのではないかということです。
銅は、その金属的な特性から、ある種の作業には有用です（すばやく加熱し、熱を均等に分散させる、など）。	おそらく主観的ですが、...良いクラッドステンレス鋼は、銅よりもドルあたりのはるかに良い調理性能を与えるだろう.
彼女は明らかに正当な理由を持っていますが、彼女はもっと責任を持って、事前にあなたに伝えることができたはずです。	最初のカバーが両方より責任を持って、その文の中であなたに言っている。
場合によっては、トムが彼女を愛していないことを暗示していることさえある。	このような文章には、Tomの意味合いは全くありません．
このフレーズを英語で聞いたことがないという点では、私も他の方（そしてあなた自身）と同意見です。	私は、あなたの言うようなフレーズを聞いたことも見たこともありません。
少なくともあなたがここで言い直したように、その主張は誤りです。	" i had mainly been " は、あなたが使っている文脈では、問題ありません。
生徒の母国語の構文に目を向けることをお勧めします。	bikeboy389が言うように、生徒の母国語を見ることで多くのことを学ぶことができます。
私は、ステータスが数えられないという言及をいくつか見ましたが、それは私にはあまり意味がありません。	また、「地位」を数えることができる場合もある。
もし私が正しく理解しているならば、あなたは包含と除外のハイパーニムを探しているのですね。	包含は含める行為であり、除外は除く行為である .
まず、ダッシュには「enダッシュ」と「emダッシュ」の2種類があることを知っておいてください。	セミコロンは、単独でも構わないが、その関係を強調するために結合する文に使用します。
簡潔な回答で申し訳ありませんが、この例の文脈では、「名前付き」が好ましいと思います。	この例では、メソッドに正式に名前を付けているため、 named の方が望ましいです。
標準的な英語では、" don 't got "は" ain 't "と同じ音域になると思います。	I don't got ...という表現は、一般に話し言葉では珍しいと言えるでしょう。
より上品な言葉は、通常ラテン語（時にはギリシャ語）を起源としています。	新東が指摘するように、下品な言葉はどの言語にも存在する。
私はアメリカ人ですが、バスルームがセントジョンズと呼ばれているのを聞いたことがありません。	このような場合、私はフレーズを長くする傾向があります。
排泄のための部屋は、ほとんど婉曲的に呼ばれます。	私はイギリス人ですが、おそらくほとんどの場合、そして常に個人宅の文脈で「トイレ」を使うでしょう。
insofar asかinsofar thatを使った文脈しか思い浮かばないのですが。	insofar はアメリカ英語であり、イギリス英語などの標準形は「in so far」である。
他の方もおっしゃっているように、「ten of six」は多くの英語圏では使われませんが、5：50と理解されるでしょう。	"ten of six" は、おそらく5：50の意味だと思いますが、私は聞いたことがありません。
確かに、多くの用法ガイドが、様々な「論理的」な理由から、この「単数形の彼ら」の使用に反対している。	2つ目は、"they / their ( 単数) "の記事を信じるなら、( 執筆の目的のために ) 。
当たり前といえば当たり前なのですが、アメリカ英語では「you 're welcome」と言うのが礼儀であり、スタンダードなのです。	ありがとう」に対する「とんでもない」の響きがよくわからない。
その昔、「ケーブル」は海外との通信を意味する言葉でした。	ケーブルの語源は、電信の時代に遡ります。
特に金融の話になると、これらの表現は微妙に異なる意味を持つ可能性があります。	この言葉の由来は、ネットワーク図にインターネットを雲の形に描く習慣からきているのではないでしょうか。
米国では、刑務所は市や郡（またはそれに準ずるもの）によって運営されています。	刑務所は市町村レベル、刑務所は州/連邦/州/準州レベルです。
そうですね、スラッシュの代わりに実際の単語を書くと、文章がより明確になりますね。	ほとんどのスタイルガイドでは、「x と / または y」のようなフレーズや、「これは難しい / 不可能」のようなフレーズでスラッシュを使用しないことを推奨しています。
自分自身と敵を理解すれば、どんな戦いにも勝てる可能性が高くなる。	理論的な戦いに勝つ確率とは別に、この言葉に込められたもう一つの意味は、他人を知る／理解することの大切さです。
腕立て伏せのバリエーションはたくさんあり、それぞれ異なる筋肉系に負荷をかけることができます。	腕立て伏せのバリエーションはいくつもあり、そのほとんどがユニークな利点を持っています。
普通に乗る分には、腕で体重を支えるようなことは絶対にしたくない。	いや、腕で体重を支えるのではなく、手は単にその体重を支えるために作られていない。
そうですね、走る前にストレッチをした方がいいですが、座って手を伸ばすようなストレッチはNGです。	神経筋の活性化とダイナミックストレッチ ランニングのためのダイナミックストレッチに関する優れたビデオです。
私はあなたの痛みを感じる - 私は絶対に涼しい条件下で、任意の激しい運動で汗を注ぐ。	汗の量は、汗の量です、あなたは本当にそれを制御することはできません。
下り坂を走ることは、四肢の筋肉を鍛えるのに最適な方法です。	さらに、下り坂のマラソンは簡単だと思われがちですが、実は上り坂のマラソンよりも難しい場合が多いのです。
最近、筋肉増強（回復を含む）のためのタンパク質摂取について書かれた素晴らしい記事を見つけました。	高重量での低レップは、運動の持続時間が短く保たれるため、質量を増加させない。
四角形、肺活量、カーフレイズを通して、少し火傷を感じるまで、それぞれを回転させる。	エアースクワット、フォワード＆サイドランジ、スプロール、ウォールチェア、そして縄跳びをたくさんたくさん。
もし、週6日フルボディのトレーニングをしているのであれば、休息週は絶対に必要です。	休息が必要な理由は、生理学的、神経学的なものです。
トレッドミルで走ったときと、道路で走ったときとで、顕著な違いがあることに気づいたんだ。	トレッドミルでは、本物のランニングの衝撃を味わうことはできません。
グーグル検索でトラベルWODSを検索すると、たくさんの結果が得られます。	軍曹が言うように、これは医師が適切に診断するためのものです。
あなたが曖昧な言い方をしているので、曖昧な答えしかできませんが。	一般的に、筋肉を温めるには、低重量で動作を行う必要があります。
まず、一般的な問題として、3-4週間ごとにワークアウトのルーチンを変更する必要があります。	しかし、私の経験では、最初は非常に難しいでしょう。
適切に実施されたウェイトトレーニングは、柔軟性と可動性を高めるものであり、低下させるものではありません。	ウェイトリフティングをしながら、まだ非常に柔軟な人を見たことがある。
翌年まで種を保存することは可能だと思います。	トマトの種は保存したことがありませんが、ピーマンの種は保存したことがあります（ピーマンは近縁種です）。
直接食べる野菜に中水を使用することはお勧めしません。	水に石けんを入れると、水に油分が溶け出す。
そうですね、コーヒーの粉をフィルターごと堆肥の山に入れることができます。	私たちは、コーヒーの出がらしを植物の餌に混ぜていますが、その出がらしにはペーパーフィルターが含まれています。
芝生を枯らさずに、カニ草を特異的に殺すポストイマーゲントがない。	エースから発売されているカニカマは90度以下で使用可能です。
完熟したらすぐに収穫してください。	私はデラウェア州に住んでいて、すでにハラペーニョとチリペッパーを収穫しています。
アザミはほとんどの地域で有害雑草に分類され、防除が必要です。	私は同じ問題を抱えています。私の庭の境界線のすぐ先にタンポポのフィールドがあるところ。
ナスは実が重くなり、枝が折れることがあるので、サポートがあるとよい。	特に大きな実のなる品種であれば、いくつかのサポートが傷つくことはないでしょう。
よく言われることですが、「雑草は他人の芝生」です。	まず、バミューダグラスとの戦いの経験がないことをお伝えします。
太陽光のない室内では、どんなものでも栽培できます。	ここでは、室内や鉢でピーマンやミニトマトを栽培している人が結構います。
一旦種ができると、その種を摘み取ることは、新しい成長を促進することにはならないのです。	種子の頭部を長く残すことができれば、より効果的です（私はそう思います）。
だから、私は個人的な経験を持っていない。	あなたはすでにきれいなソースの答えを受け入れたので、私はいくつかの補助されていない伝統（すなわち.
テキサス州北部にある我が家のデッキの鉢植えでは、ほとんど雑草のように育っています。	他の回答に加えて、バジルは一晩中湿っているのを好まないというのは有名な話です。
発根促進剤の種類については、こちらで詳しく説明しています。	根の成長を促す、特に根の生成を促すという意味です。
どれもこれも正解なので、1つだけ正解とするのは難しいです。	モンキーグラスは、ゆっくりと繁殖する雑草のようなもので、見た目も美しいのでおすすめです。
レタスの花芽は薹立ちの兆候です。	ボルトが抜け始めているように見えます。
土は、良い土から質の悪い土まで、あらゆるものを意味します。	ココピートを使用する - それは環境に優しい庭の野菜や植物のためのココナッツの殻から派生した有機土壌です。
もし、「気持ち悪さ」を克服することができれば、有機窒素肥料を身近なところで簡単に施肥することができます。	肥料に記載されているnpkの数字は、窒素、p2o5、k2oのそれぞれの重量パーセントを表します。
杭に空気を入れるのは、有機物を分解する微生物に酸素を供給するためです。	回さなくても堆肥化しますが、回した方が早く堆肥化します。
私は本を買いました、これについては、そうここに私自身の質問に対する答えです。	まあ、私はそれを危険にさらすことはありません、ない冷たい堆肥システムで。
アロエは、他の多肉植物と同様、非常に丈夫で、かなりの放置にも耐える。	職場でアロエの鉢植えを持っている人がいます。
これは、「ノー・トゥルー・スコッツマン」論への誘いのように見えます。	私は@ t.e.d.と同意見で、この質問は「真のスコットランド人ではない」バーベッティングです。
いくつかの村は、古代ローマ時代までさかのぼる歴史と名前を持っていました。	多くの町や村は、村の所有者である支配者一族からその名を取った。
米国が世界最強の国であるのは、その軍事力によるものである。	アメリカ合衆国は、世界で5番目に面積の大きな国の一つです。
1950年代と1960年代には、ほぼすべての国が同じ理由で急成長を遂げました。	50年代のソ連の成長率は、特別に高いものではありませんでした。
女王は摂政女王（君主）または王妃を指すこともあるが、国王は常に君主である。	王妃の配偶者を「王様」と呼ばないのには、とても良い理由があります。
中近東での戦争は、貿易によって異質な地域になっていることが原因であることは、まったくありません。	1941年に条約が結ばれましたが、その後、数回の小競り合いがありました。
" 私が本当に求めているのは、イスラム教徒の人口の推定です ..." @ thanosk and @ t.e.d. , a overall , general population estimation f.e. .	以下は、私の愛読しているNew Penguin atlas of medieval historyから引用したものです。
ヒンズー教や仏教には、平和のメッセージと、物質主義にならないようにという励ましがあります。	これは、アメリカ人によるアジアや他の非ヨーロッパ文化の「発見」に関連しています。
ギリシャの発掘現場や博物館のチケット（εισιτηριον）なんだろうけど。	確かにギリシャ語では、美術館や博物館への入場券のように見えます。
エピダウロス（現在も使用されている劇場がある）とミケーネの遺跡の入場券です。	ギリシャの発掘現場や博物館のチケット（εισιτηριον）なんだろうけど。
ヤスパースの「軸の時代」の概念を再発見したようですね。	中国からギリシャの文化に影響を与えることはなかった。
そう、個人的な経験から言うと、彼らは確かに口笛を吹いていたのです。	第二次世界大戦中の爆弾が落ちるとき、口笛のような音を立てていたのは事実です。
秦が完全に崩壊する頃には、湘友が中国の覇権を握っていた。	漢王朝は秦の時代の後、始皇帝の政権が崩壊した後、誕生しました。
1960年のケネディの選挙は、歴史上最も接近した選挙の一つであり、いくつかの重大な問題があった。	最初の質問ですが、ウィキペディアの項では、ジョセフ・P・ケネディがジョン・F・ケネディの勝利を買収したとは書いていません。
「イネ科は、地球上に最も広く分布し、豊富な植物群のひとつである。	wikiのページにあるように、家畜の放牧を改善するために草の種が新大陸に輸入されたのです。
http :/ / en.wikipedia.org / wiki / history _ of _ delhi # early _ history shows that the city was called delhi ( or dilli ) at least since 12 / 13th century.	正確には覚えていませんが、インドのメディアがデリーのことを「ハスチナ」と呼んだのを覚えています。
dominus , 複数形 domini , 古代ローマで、特に奴隷の「主人」または「所有者」。	ギリシャ語を話す奴隷（δούλος , doulos）は、主人のことをκύριος（訳注：kurios ; lord, master, sir ; vocative form : κύριε ）と呼ぶと思います。
当時のインドの大部分はポーラスではなく、パタリプートラを中心とするナンダ朝が支配していた。	アレクサンダーはポーラスとの戦いで馬のブケフェルスが傷で死んだ後、心を病んだと思う。
そして、@ mgnさんがおっしゃるように、ほとんどの場合、不定冠詞は数字から発展したものです。	不定冠詞は数詞から、定冠詞は指示詞から発展したものである。
文法性を維持することと、文の意味を維持することは、別のことです。	実際、意味の保存を気にしないのであれば、ほとんどを削除して文法性を保持することができます。
最近のインド・ヨーロッパ言語では、20進法の残りを見ることができます。	現代の英語、そして他の多くのよく知られた言語では、10進数（つまり10進数）を使用しています。
この問題は、多くの人が言うように、言語ペアのさまざまな言語的特性から生じるものではありません。	それは、一般的に2つの言語の構文構造に依存し、そうです、いくつかの語用論の問題です。
英語では、確かにdoの最も一般的な使い方はdo-supportです。	伝統的な文法では、doing はすべての例で分詞になります。
注意：私は3日間の偏頭痛の最後を経験しています。	私は、あなたの質問が少し混乱しているというコメンテーターに同意します。
その理由は、ロシア語は英語よりもずっと調子がいい言語だからです。	私はロシア語がかなり流暢ですが、英語の音は特に「冷たい」とは言いません。
ロシア語、ギリシャ語、トルコ語、ペルシャ語など、前母音の前の / k / の口蓋音化は至る所で起こっています。	スリランカで話されている言語の一つであるシンハラ語は、4通りのデイクシスシステムを持っています。
話し言葉で使われるのと同じ分析方法が、手話にもうまく適用できるのです。	少なくとも80年代からある考え方は、ホールドとムーブを区別することができるというものです。
ニュースピーク、破壊的なアイデアについて人々が話したり考えたりするのを防ぐために作られた「意図的に貧弱にした」言語。	どの言語も、その言語が浸されている文化的価値観が浸透しています。
ロシア語では、例えば、生気と無生気の区別は明確ではありません。	ロシア語のように、ポーランド語では、無生物男性名詞の主格-使役に対して、生気男性名詞の主格-使役で表します。
wals.infoのサイトにある地図を見ていただければわかると思いますが、たくさんあるんですよ。	これは、私がいつも一年生のために役立つと思う例です。
ZIPFの法則は、私が理解しているように、実際には言語についてではなく、統計と確率についてです。	すべての自然法則と同様に、ZIPFの法則は近似値である。
音素の概念が常に論争の的となってきたかどうかが、これまでのところ未解決の問題の一部である。	「音素」は理論的な構成要素であり、おそらく消えることはないだろう。
もし、あなたが非言語学的な環境から来るのであれば、fromkinの「言語入門」から始めるのがベストです。	これは、オックスフォード大学で言語学の修士課程に入る学生に入門書として推奨しているものです。
私が見たところ、一般的に英語話者のボキャブラリーは15000語から20000語程度と言われています。	統計的な推定によると、私は英語でおよそ7000語を知っています。
テントがあれば、野外で寝るより少しは安全かもしれませんが、それほどでもないでしょう。	いや、テントでは、中に入っているものを狙うクマから身を守ることはできない。
コヨーテが人間に攻撃的であることは知られていない。	一般的には、人間を襲うことはほとんどないため、危険な動物とは考えられていません。
ナイロンは乾きが早く、裂けにくく、破れにくい、そして通気性が良い。	ナイロンは、他の合成繊維の中でも、いくつかの理由から、ほとんどのアウトドアの追求のための衣類のための理想的な材料である。
gps ( wikipedia ) は軌道上の衛星をベースにしているので、世界中で正確です。	gpsシステムは、衛星があるところならどこでも使えるし、実際に使っている。
カリフォルニアは地域によって野生動物が違うので、地域を絞ったほうがいいかもしれませんね。	アメリカクロクマは、カリフォルニアの原野の一部、主に山岳地帯に生息しています。
だから、スキーに乗る前に基本的な知識を身につけることが重要なのです。	スキーは、レッスンを受けるとすぐに成果が出るスポーツです。
体育館では、トップロープは円筒形のバーの上に巻かれます。	さて、ここではいくつかの異なる問題を解決する必要があります。
私は毎年夏にアリゾナ州を訪れ、その際に砂漠でのハイキングも楽しみます。	また、水分の必要量は、食べたものによって異なります。
私の知り合いの素敵な女性が、reiのhabeneraのバッグを持っています（リンク）。	もし、紫のヌナタックとフェザーフレンドがその色で良い寝袋を持っていることを解決することができます。
医学的な意味での塞栓症は、血液の流れの中で動く大きな塊や欠陥のことを指す。	圧力関連傷害の概要について、wikipediaに興味深い記事があります。
蛇が止まっている人を襲うのは珍しいことです。	私は爬虫類学者ではありませんが、私の経験では、ヘビは「あなたが私に迷惑をかけないなら、私はあなたに迷惑をかけない」というカテゴリーに属します。
私は上に書いたように、それはこの壁を評価するのは難しい。	他の人と違って、ルートがよく描かれていると思います。
毒素に開放してしまえば、答えは明らかにノーです、煮沸では不十分です。	沸騰させることで、病気になる可能性のある特定の種類の汚染物質のみを除去することができます。
カリフォルニアは地域によって野生動物が違うので、地域を絞ったほうがいいかもしれませんね。	オンラインカロリーエスティメイトのサイトを利用すると、おおよその目安を知ることができます。
リュックに熊鈴をつけると、仲間のハイカーに「うるさい」と殺される。	上記のアドバイスは非常に良いのですが、ただ、熊の国での食べ物について考慮すべきことを追加したいと思います。
ああ、友よ、私もあなたのようにこの惨めな道を歩んできたのだ。	はい、新しいセミスタティックロープ（またはシングルロープテクニック/SRTロープと呼ばれる）は、洗浄するのが一般的です。
私の考えでは、子供が要求するのを待つことです。	私の考えでは、子供自身がそれを望んでいることを表明するまで待つことです。
哺乳瓶は正しく殺菌されていれば、安全に使用することができます。	ボトルに残った洗剤を十分に洗い流していれば、全く問題ありません。
不快だからオムツを外しているのです。	おむつを後ろ向きに装着することもできますが、少しの間しか効果がないかもしれません。
イエスかノーかの答えを求めない方法で質問することをお勧めします。	もし彼が大声を出したり、行儀が悪かったりしなければ、心の変化を心配することはないのでしょうか？
そうですね、双子は自分の言葉を発達させることができますが、それは当たり前のことではありません。	私が二卵性双生児で見たものは、次のとおりです：話すことを学ぶ間、すべての子供が独自の方言の一部を開発する。
何をするにしても、彼に噛み付いて痛いところを見せたりしないように。	私たちはいつも子供の口を軽く叩いて、「口は災いのもと」と教えていました。
私が聞いた経験則では、「小さな子供には大きな犬」です。	どんな犬種でも、完全に安全なものと非常に危険なものがあります。
赤ちゃん言葉が言語発達に役立つ、あるいは有害であることを示す確固たる証拠を私は知らない。	ベビートークは、正しく使えば、言葉の発達に有益です。
可能性としては、家事に対する報酬を考えることを目的とした家族会議を持つことです。	多くの子供たちは、報酬によって動機づけられるのではなく、支配されることによって動機づけられます。
ポイントは、乳児が授乳中に胃の中に吸い込んだ空気を外に出すことです。	私はそれがより正確であることが私の赤ちゃんと一緒に発見した彼の行動によって行くには、 " ルール " によって。
学校長との相談ルートがあり、そこから医療専門家に直接相談することも可能です。	教師にとっては当たり前のことを、親が見ようとしないのは、いつもつらいことです。
これらの質問に確実に答える科学的な研究を見つけるのは難しいでしょう。	あなたの言うトピックは非常に幅広く、科学の世界では密接に関連するものではありません。
チーズは非常に健康的で、妊娠中にも良いですが、いくつかのタイプは、深刻な問題を引き起こす可能性がリステリア菌が含まれている可能性があります。	チーズの問題は、前述のようにリステリア菌の可能性です。
少なくとも最初の1年間は、2人ともポータブルペンで寝ていましたが、何の問題もありませんでした。	この製品は、我が家の子供たちに使っていたものと同じです（ブランドもすべて同じです）。
歯固めが悪いという話は読んだことがないのですが、どこで読んだのですか？	子供や孫と一緒に、きれいな布やベビーソックスを氷に巻いて使っていました。
私はデンマーク人で、（ドイツ語を話す）オーストリアに住んでいるため、同じような状況に直面しています。	保育園でヒンディー語だけ、あるいは追加で学ばせるという方法もあります。
私の息子がトイレのしつけをしたのは、4歳の誕生日くらいでした。	2歳半でトイレトレーニングを始めた息子に効果的だったことをいくつか紹介します。
水しぶきを上げるのがどんなに楽しいか彼女に教えてあげてください - それが私たちがしたことです。	おもちゃを近くに置いたり、おもちゃをあげたりしてあげてください。
うちの娘はお風呂が大好きなのですが、出てくるときはそうでもないんです......。	私たち夫婦はもともと、生まれたばかりの双子がお風呂の時間が終わると大騒ぎをする、という同じ問題を抱えていました。
お医者さんごっこは、子供なら誰でも一度はやってみたいものです。	私は、娘と女友達が5歳と4歳の時に、同じような状況に陥ったことがあります。
ほとんどの医師は、最初の食べ物としてライスシリアルを勧めています。	スプーンで食べるというのは、彼らにとっては非日常的な体験に違いない。
幼児の睡眠に関する文献のほとんどは、食習慣ではなく、主に起床時の習慣に関係するものです。	私の経験では、赤ちゃんはお腹がすくと自分で起きることが多いのです。
双子の男の子のために1年間母乳を搾り続けた私の個人的な経験に基づくアドバイスです。	最初の3日間が最も重要であることは理解していますが、それだけに、その時に実行することが肝要です。
それは可能ですが、おとなしいメスのベタと大きな水槽が必要です。	以前、オスのベタをコミュニティタンクに入れてみたことがあります。
カメは金魚や口に入るものをたくさん食べるのが大好きです。	まず、カメが魚を食べるのは、魚が食べ物であって、友達ではないからです。
抜け毛の量が普通であることを考えると、それを減らすためにできることは何もないように思います。	家具や洋服についた猫の毛の量を減らすには、脱脂ブラシを使うとよいでしょう。
私のダニオスの経験では、彼らはいつも「威張った」魚です。	ゼブラダニオスは非常に丈夫な魚で、殺すことはほとんど困難です。
猫はいろいろな理由でトイレを嫌がるのを見たことがあります。	猫って、トイレの砂の「味」を変えることができるんですね。
猫（そしてすべての動物一般）は、秩序や整理整頓という概念を理解しない。	彼らは家の周りにそれらの項目を残すか、または家を片付けないつもりではない.
猫が何かに怒っていて、それをあなたに伝えようとしているように聞こえます。	猫が何か嫌がっている。
私は、ほとんどの猫が人をあまり舐めないことに気づきました。	猫が人をなめるかどうかは、いろいろな要素で決まる．
なぜ、魚が自然死したと言い切れるのか。	私の200リットル淡水水槽は攻撃的な水槽で、魚は時々死にそうなほど嫌がらせをされる。
まず、ダブルチェック犬のボディランゲージは、それが本当に積極的であることを確認します。	まず、これはあなたやあなたの犬の問題ではないことを認識する必要があります。
水の適切なphレベルは、魚によって少し異なりますが、あまりにも酸性は間違いなくそれらを殺すことができます。	前の回答で与えられた情報は良いものです。
ということは、あなたの猫は、あなたが与えている餌をほんの少ししか好まないということだと思います。	家猫は精神的に完全に成長することはなく、常に母親のような目で見ていると考える研究者もいます。
玄関の入り口に古いカーペットを敷き、ホッチキスで固定する。	という質問で好奇心を刺激され、調べ始めたのですが・・・。
小型のものが必要な場合は、幼いラットに変えてみてください。	以前の回答にもあったように、ネズミの代わりにネズミやスナネズミを与えたり、ネズミと交代で与えたりすることができます。
この動物をすぐに獣医に連れて行く必要があります。	他の回答にもあるように、唯一の選択肢は、手術をするために獣医に会うことです。
アレルギーの主な原因は、唾液に含まれるタンパク質です。	動物アレルギー、特に毛皮のアレルギーは、特定の種というよりも、むしろ全体的なものです。
あなたのウサギが少し体重を増やすのに役立つものがいくつかあります。	ジョン・キャバン氏は、ウサギの体重を増やすための合理的で適切な方法をいくつか回答しています。
ストッキングは、特定の生物だけでなく、セットアップやあなたの水槽の経験によって非常に主観的です。	水槽に魚を入れるときは、必ずゆっくり入れてください。
毎晩、就寝前に猫と一緒に遊ぶのが一番です。	私の場合は、夜中に邪魔をされたら、猫を抱きしめて近くに置くという方法をとりました。
私はベタの直接の経験を持っていない、しかし、私はペアがどのような男性と女性の組み合わせで、長期的に動作することを聞いたことがない。	ベタは非常に縄張り意識が強く、どんな性別でも一緒に飼うと喧嘩になります。
私たちはいつも、砕いたものをバターやイワシにのせて食べていました。	毎日薬を飲ませなければならない猫がいたのですが、猫に薬を飲ませるのは大変なことでした。
私が考える最大の理由は、猫の防御機構を奪っていることです。	猫は通常、前足を握られたり、触られたり、そういうことが好きではありません。
ゼブラダニオスは非常に丈夫な魚で、殺すことはほとんど困難です。	ダニが群れを作るには、少なくとも5〜8匹のダニを水槽に入れる必要があるらしい。
排尿した場所を酢できれいにする（娘が子猫のときによくやりました）。	他の方からも、臭いを中和する方法について良いご提案がありました。
アリストテレスは、世界を宇宙の中心に置いてはいない。	アリストテレスはなぜ地球を無限の宇宙の中心に置いたのでしょうか？
私は、実証主義が左翼の哲学者の立場であるとは思っていません。	私は、実証主義が左翼的なイデオロギーと日常的に結びついていることに納得していない。
そうですね......ひとつには、物理的でない存在であっても、あなたの心の中に存在しないことがあります。	すべての非物理的なものが心の中に存在するわけではないので、その差は非常に大きい。
数学の哲学が得意なのは数学者であって、哲学者ではない。	私のモチベーションは、物事を根源から見て、上に向かっていくことが好きなことです。
必要」と「十分」の違いは、論理的な矢印の方向である。	sufficient は上界、necessary は下界です。
私はなぜそれが投票されるのか分からないが、レックス・カーの回答は疑問を投げかけている。	というのはトートロジーですが、論理と英語の記述の対応付けがおかしいのです。
確かに、「アクセス可能性」と「決定」のある理解のもとでは、アクセス可能性の関係は公理によって決定されます。	アクセシビリティはモードロジックの公理によって決定されます。
私はかつて、強いaiの立場をとる物理学者に会ったことがある。	私はSearleが間違いであると信じていますが、あなたが問題を発見したとは思いません。
ある文が証明可能でない場合、矛盾や自己矛盾が生じ、システムを無効にしてしまう可能性があります。	この時点に到達することが、どのようなシステムの検証の焦点になるのでしょうか？
ヒンズー教では、「あなたは妊娠しているから存在するのですか？	少なくとも言えることは、人は生まれながらにして学ぶ能力と知識を持っていなければならないということです。
ウィトゲンシュタインの「解答」を理解するためには、元の（歴史的）文脈を考慮しなければならないと思うのです。	ウィトゲンシュタインは、ラッセル自身がパラドックスを解決した方法を示唆している - ramified typesの理論である。
いわゆる「複素数」や「虚数」について学んだことは、少しばかり忘れてください。	すでに他の人が言っているように、数字はもちろん抽象的なものです。
時間の問題は、アリストテレスからハイデガーに至るまで、哲学者が扱ってきた非常に難しい問題である。	ウィキペディアは、自己修正するメディアであると同時に、必ずしも何かを決定的に説明するものではありません。
すべての否定的な主張が肯定的な主張に有効に再定式化できるわけではありません。	私は、証明の責任が正または負のバージョンにあるとは思わない。
私が理解しているように、変えることができるもの、より小さな部分に分解することができるものは、本質的に本物ではありません。	私たちの相互作用は、私たちの知覚をどこに置くかによって決まるだけです。
私たちが知っている宇宙を、たった一人の強力な神が創造したというシナリオを想像することができます。	それは、アリストテレスが「動じないもの」と呼んだものと同じ考え方です。
旅行用の三脚が必要なときは、トレックポッドも選びました。	この三脚に代わるものとして、トレックポッド（trekpod）があります。
高速画像ビューアは、9.99ドルの低価格のための広範なパックを持っており、それはそれらをすべてカバーするように見えます。	fast picture viewerは9.99ドルで、64ビットのWindows 7で問題なく動作します（私は自分で使っています）。
キャノンやオリンパスから水中ハウジングの付いたコンパクトカメラが多数発売されています。	オリンパスのタフモデルのように、10mまで行ける防水コンパクトがあります。
被写界深度は、絞りや焦点距離とは別に、カメラと被写体との距離によっても減少します。	絞りを開ければ開けるほど、焦点深度は小さくなります。
レンズに印刷されている場合、F値は通常、コロン（例： .	最大F値（焦点距離と有効口径の比で定義される）を意味します。
あなたは、カラーマネジメントをサポートしているブラウザを使用して、また、あなたのイメージでカラープロファイルを埋め込む必要があります。	私の経験では、最終的にsrgbで制作する場合、最初から最後までそのカラープロファイルを使用します。
私はいくつかのニコンのレンズと、超ワイドショット用のシグマ10-20mmを持っています。	もし、あなたの興味が光学にあるのなら、ブランド全体ではなく、個々のレンズを見る必要があります。
サイズを大きくするのに最適な方法は1つもないということがわかりました。	ウェブで使用する画像のリサイズやシャープネス処理には、実にさまざまなソリューションがあります。
私はWindowsでPaint Shop ProとDxo Optics Proを使用したことがあります。	Linuxではbibbleを使用しています。これは、いくつかの欠点がありますが、唯一の本格的な選択肢です。
クラス6のカードは、理論上、550dのHD（1080）ビデオ（48mbit）には十分すぎる帯域幅があるはずです。	カードによっては、HDストリームを受け入れるには遅すぎるものもあるので、十分な速度のものが必要です。
ここに多くのサンプルがあります：pbase.com そこに16kの写真のうち、私はいくつかはd700とされていることを確認してください。	それは1：1レンズなので、被写体の大きさがセンサー上で同じ大きさになることを意味します。
同じここで、私は50mm F / 1.4を持っている、と私の最速のレンズとして、私はコンサートや低照度撮影のためにそれなしでは生きられない。	私は18-55、50/1.8、50/1.4と20Dを持っていますが、50Dに取って代わられました。
私はエリンクロムのスカイポートを使っていますが、お金が問題でないなら、ポケットウィザードのために行く。	または、超安価なYongnuo RF-602を使用すると、降圧のための多くの強打を与えるだけです。
この用語は通常、「破壊的な編集と非破壊的な編集」と呼ばれます。	ロスレス/非破壊編集は可逆的であり、元に戻すことができる方法でデータを変換および/または追加することを必要とする。
レンズの汚れは、あなたが思うほど有害ではないかもしれません。	通常の食器洗い洗剤は、油脂を溶かすだけでなく、結合させるので、油脂を取り除くのに最適です。
大判カメラは、中古で買う価値が大いにあります。	もし私が選ぶとしたら、リンホフを選びます。
anilさん、確かに結果には差がありますね、主に画質で。	もしあなたが写真を学びたいなら、ほとんどどんなカメラでも始めることができます。
速いシャッタースピードと、適切なタイミングでのフラッシュです。	pearsonartphoto さんの回答に加えて、フラッシュ（内蔵または外付け）を使って動きをフリーズさせることができます。
連邦憲法は、憲法第9条と第10条のように、全面的な信義誠実条項をテストするものではありません。	議会制定法としてのドーマは、憲法の全面的信義条項に違反することはありえない。
公務員が組合を作れるのは、法律がそれを認めているからです。	公務員が組合を作ることができる法的な理由は、他の場所で説明されています。
米国はシャドーエコノミーが小さいように見えるが、それにはいくつかの理由がある（順不同）。	米国における低シャドー・エコノミーを推進する主な要因は3つあります。
医療はともかくとして、戦争は命を救わないという前提で動いていますね。	オバマの医療保険は命を救うというあなたの暗黙の主張を、彼らはおそらく否定するだろう。
ドイツ国民にとって、大統領はそれほど重要ではありません。	ドイツ大統領の機能は、ほとんど代表的なものでしかありません。
先願主義では、2つ以上の政党を維持することは困難である。	先願制は二大政党に有利であるが、第三者が疎外されることを保証するものではない。
経済学で最も物理学に近いのはミクロ経済学と呼ばれる分野です。	余談ですが、私は物理学者が理論や予測について常に同意しているとは思っていません。
ウクライナの市民として、東ウクライナのハルキフから私の意見を述べさせてください。	これは、見た目以上に哲学的で倫理的な問題だと思います。
多くの人は、ただ裕福になりたいだけでなく、時間が経つにつれて、より裕福になりたいと願っています。	まず、経済成長の主な要因は、資源、技術、そして制度です。
この現象に正式なポリシ名があるかどうかは、まだ答えられない。	質問で提示された視点には2つの問題があり、それが一見矛盾しているように見える原因となっています。
患者保護法と医療保険法には、大統領に暫定的な権限を与えるものはないのです。	規則を作成することによって、常に「過渡的な権限」が存在する。
ロシア連邦法はこの点に関してかなり具体的で、議論されているほど恣意的ではありません。	ロシアの大統領選挙は2012年3月4日に、下院選挙は2011年12月4日に実施されました。
この質問は、すでに懐疑論者の間で広く議論され、回答されています。	最低賃金法は、最も生産性の低い、最もスキルの低い人々を傷つける。
シーア派のイスラム教徒、特にイランとヒズボラによると、イスラエルという国は存在しないそうです。	パレスチナの定義と同じように、イスラエルの定義も、尋ねる人によって異なります。
なぜなら、陛下が法律を変更したり、拒否権を行使したりするには、もっと効果的な方法があるからです。	女王の意思に反する法律は誰も採用しないので、拒否権はない。
絶対的多数派は、常に制度や文脈によって定義される。	インドのような国では、国会の議席の2/3を占めれば、絶対多数となるのです。
バークハウザー教授は、最低賃金が上がると誰が困るのかについて、広範な研究をしている。	最低賃金法は、最も生産性の低い、最もスキルの低い人々を傷つける。
大学選挙区は、アイルランドが独立した1922年に英国で使用されていた大学選挙区をモデルにしています。	これはまだ政府の代表的な形態ですが、ユニークなひねりが加えられています。
あなたが主題の研究を開始したい前に、あなたが達成したいかを把握する。	ユージンが言うように、自分が何を達成したいのかを考えてみてください。
eclipse 以下は、私がほとんど毎日使っている eclipse のショートカットのリストです。	キーボードショートカットを使用するように自分自身を訓練するために、数日間、マウスを抜いてください。
他の方もおっしゃっていますが、irobotのルンバは、有意義な仕事をする家庭用ロボットの優れた例です。	i 've been happy with irobot roomba for floor cleaning .
私が覚えている重要なことは、ただ注意を払うということです。	この質問をしてから、このトピックについて読んでいます。
この件に関しては、少し統計的な考え方を適用する必要があると思います。	落ち込まないための一般的な鍵は、他人と自分を比較しないことです。
を調べてみると、カフェインの濃度は摂取後約30〜60分でピークに達するようです（1、2）。	問題は、本当の意味で役に立つことがないことです。
これは、私が意識せずに開発したテクニックです。複数のブラウザを使うのです。	時間を記録することが解決策の基本であることは、他の方々と同意見です。
職場でスタンディング／シッティングデスクを使用していますが、とても気に入っています。	他の回答者が述べているように、スタンディングデスクの使用は必ずしも完璧な解決策ではないことが判明した。
この質問にはすでに回答がありますが、私の回答を付け加えたいと思います。	こんなこと言っていいのかわからないけど、もしあなたの仕事があなたを不安にさせているのなら......。
終わりが見えてきたあなたの脳は、すでに疲弊し始めています。	私はここにモチベーションであなたを助けることができるいくつかのヒントを書いている。
伝統的なポモドーロ・テクニックにこだわるなら、これは中断とみなされます。	実は、ほとんどのブラウザには、これを実現するための機能がすでに備わっています。
一度に計画できるのは90日が限界だと思います。	1ヶ月前には必ず計画を立てましょう。計画が変わっても全く問題ありません。
ユーザーは、マクロのような「明白な」効率化ツールのコストと利益を自分自身で評価する必要があります。	具体的な答えや方法を押し付けるのではありません。
スケジュールを立て、仕事に向かう儀式を行うことについては、前の回答が好きです。	3面スクリーンを購入し、仕事場と寝床を分けるために使用。
私なら、まずDavid Allenの本、"Getting things done "を読みます。	私は、デビッド・アレンが宣伝しているGTD（geting things done）システムに毎月48ドルを使うことを検討しています。
勉強の後に頭をスッキリさせるには、激しい運動をするのが一番です（ 分 .	私の場合は、被写体を変えて、頻繁に休憩を取るのが効果的です。
私は、Josh Bruceのアドバイスには同意できないところがある。	の研究では、勉強した後に寝るというのは、かなり有効な手段であることが示されています。
現在、私は純粋なデジタルGTDのセットアップにかなり近いを持っている、これはいくつかの洗練された、微調整を行うことができますが。	私のGTDシステムは、ここに詳述されているように、事実上100％電子化されています。
恐怖を感じる......そして、とにかくやってみる この本では、恐怖を感じることを勧めている......。	恐怖に立ち向かい、乗り物を楽しむための13のヒントが面白そう.
最近、ikeaのsit/stand galant tableを2台購入しました。	http :/ / www.varidesk.com / のためのデザインテンプレートを得ることができるハンドメイド/ diyのバージョンもあります。
私にとってのベストは、適切で一貫した睡眠スケジュールを持つことです。	また、ios用のfreakyalarmは、アラームがオフになる前に、単純なロジック/数学の問題を解決することができます。
オープンスペースの環境では、中断、ストレス、騒音が原因で、作業効率が2～10％低下するという研究もあります。	iphoneのアプリでグループというのがありますが、これが便利かもしれません。
経験：プロジェクトやオフィスで、経験のある同僚が物事を素早く理解していることに気づいたはずです。	学ぶ姿勢こそが、独学者の基礎力だと思います。
制限区域を徘徊することができる人は比較的限られています。	都は制限区域に向かう者を厳しく罰している（例．
私は、ドロシー・ジョーンズ・ハイドの言語に「最も広範な」という名称を適用することには同意しません。	最も広範なバルカン語は、60年代にファンによって作られ、特に言語学者のドロシー・ジョーンズ・ヘイドによって作られました。
リングワールドのようなものだと思うのですが。	それは空洞ではなく、私たちの世界と同じように丸いのです。
一方では、タイムターナーが時間を進めることができることを示唆するキヤノンの何もありません。	タイムリープマシンは、過去に戻るために使用することが明示されています。
St : TngのRon Mooreにストーリーのアイデアを売り込むために招待されました。	無傷でフィールドを離れることは当然可能で、それは起こった。
まず最初に、呪文を唱えるには3つの主要な特徴があるようだと言わせてください。	私はいつも、ハリーは他の人よりも半神の王子から学んでいるように見えると思うんだ。
スターゲイトシリーズを見るきっかけは、まずアトランティスを見たことでした。	アトランティスとユニバースの詳細な分析に踏み込むことなく、できるだけ簡潔に説明します。
現実的なところでは、dyson sphereに一票。	アレン・スティールの「ヘックス」には、ダイソン球が描かれているが、六角形でできていて、1000マイル（キロ？
それはシーズンが始まる前のことで、エイミーは沈黙が彼女を連れ去る前にその女性を見たからです。	正確なタイムラインはまだ記載されていませんが、私たちが作ることができるいくつかの仮定があります。
私たちは、2つの平行した世界が衝突している、あるいはそれ以上かもしれません。	私たちの勇敢なヒーローはまた、宇宙服の中にいた子供を追いかけなかった。
ディックはアイデアマンであり、科学者ではなく、人間であった。	フィリップ・K・ディックの作品のほとんどは、少なくともハードSFではありません。
まず、「スフィア」はハードSFというより、ソフトSF、スリラー、空港小説などであると考えなければならない。	実際の宇宙船の「フィン」は、太陽電池パネルと放熱器の2つの目的のうち、どちらか一方に使用されています。
カノンによると、レイアは戦闘、特に射撃のエキスパートでした（これはEUの本からです）。	実際の戦闘では、ほとんどの火は敵を殺すためではなく、敵を抑制するために使われます。
哺乳類の種分化に関する確固たる理論があるわけではないと思います。	簡単に言うと、進化では人間にエラを作ることはできなかったということです。
2006年版のジャケットはこちら、ご質問の選択肢bは2006年版です。	wikipediaの「タイムトラベルのルール」は、このテーマについて調べるには良いリソースです。
手話は、意味、感情や意図を伝えるためにトーンがないので、多分。	すべての言語において、体の姿勢が大きな役割を果たしていると言ってよいでしょう。
艦隊の視点から見ると、銀河の他の部分は動いていて、時間の拡張を経験していることを思い出してください。	まあ、それは彼がどれくらいそこにいたか、そして艦隊の正確な速度によりますが。
この考え方は、神話や物語の始まりからあるものです。	スーパーヒーローの背後にある科学は、このトピックに光を当てるかもしれません。
d / l方式を適用しても、試合が引き分けになることはあるのでしょうか？	はい、d / l方式を適用した後、試合が引き分けになることは可能です。
スーパーオーバーでは、ボウリングとバッティングの両方に同じプレーヤーを使用することができます。	スーパーオーバーのボーリング/バッティングにどの選手が選ばれるかを決めるルールはない。
ボーリングした球数を取ったウィケットの数で割ったものです。	ボーリングストライク率とは、1人のボーラーが1つのウィケットを取るのに投じたボールの平均数のことである。
レシーブ側のプレイヤーは，サーブを返す前にボールをバウンドさせなければなりません．	ボールが自分のプレーエリアに触れるまで待つ必要がある．
ファートレックはフィットネス測定として、またちょっとした遊びとして利用しました。	ファートレックは、適切なインターバルトレーニングよりも効果的ではありません。
もし、両チームのフォアヒット数が同じであれば、両チームとも1点ずつ獲得することになります。	スーパーオーバーで両チームの得点が同じ場合、このルールが適用されます ...
近代オリンピックで女性が初めて登場したのは、1900年のオリンピックでのクロケット競技でした。	1900年の第2回近代オリンピックでは、22人の女性がテニス、セーリング、クロッケー、馬術、ゴルフの5種目に出場しました。
チームのために話すのは難しいし、ドラフトに臨む彼らの戦略もわからない。	新しい労働協約により、ドラフトは大きく変わりました。
ゴルフをするために、あなたが必要とする最初のものは、クラブのセットです。	私も最近このスポーツを始めたので、あなたの不快感を感じています。
そうですね、露（環境中の湿度）の要素は、試合の方向を変えることができます。	また、デューファクターの欠点として、バウンダリーへのヒッティングが難しくなることが挙げられます。
あなたの投稿を読んで、私は若い頃を思い出しました。!	大きな絵から目をそらす必要があると思います。
プロサッカーでビデオプレーが導入されないのは、正当な理由がない。	インスタントリプレイの適用には、ゲームの流れを中断させるだけでなく、もうひとつ問題があります。
基本的には、誰かがボールをキャッチするまでは、人ではなく、ボールをプレーしなければならないというルールです。	理解するのはかなり簡単ですが、審判を下すのはやや難しいです。
最高レベルでは、ペースセッターは、レースのゲームプランを正確に満たすことを保証します。	個人的な経験では、ペースメーカーの存在は非常に役に立つと思います。
私は、非常に論理的な推測である3つの主要因を考えることができます。	フットボールやサッカーの分野では、ホームフィールドアドバンテージについて、かなりの数の研究が行われています。
空中でボールが動くことをスイングボウリングといいます。	この2つのスタイルは、ミディアムペースとファストペースのボウラーによって行われます。
実は、同じ大陸にないものを数える方がずっと簡単なんです。	マラソンでも、タイムを狙うなら、この作戦がおすすめです。
黄色の投光器で照らされた赤いボールは、ピッチの色によく似た茶色を帯びている。	私も趣味で水泳をやっていますが、トライアスロンのトレーニングの一環で.
いいえ、マン・オブ・ザ・マッチを授与するための具体的な基準はありません。	ルール通り、お母さん賞はコメント欄で決定されます。
具体的には思いつかないのですが、何年も前にこんなシナリオがあったような気がします。	クリケットの法律では、合意された長さに関係なく、どんなイニングでも宣言することができるとされています。
FIFAの「用具規定」の第22条にあるように、GKだけがキャップを被ることが許されている。	ヘッドギアの着用は認められているが、ゴールキーパー以外にはお勧めしない。
ホッケーを始めたとのこと、素晴らしいスポーツですね。	一般的な目安は、5～6時間滑走するごとに1回。
後半は前半より1〜2分速く走るのがいい。	私なら、前半を少し遅めにするかな。
それは彼女が最初のラウンドで李娜に直面したことをランダムだった - しないので、彼女は 'シード/ランキング＃127です。	これはコメントには長すぎたので、CWアンサーとして投稿します。
ほとんどの場合、米国領事館で申請することができます。	一般的には、居住地の米国領事館で申請することになっています。
ライアン・エアーの真似をして、激安チケットと悪質なサービスを提供するスピリット航空がある。	また、格安運賃で運航している航空会社もあります。
あなたの国の銀行を探し、ユーロ建ての銀行口座を開設することをお勧めします。	フランスに居住していない人が、フランスで銀行口座を開設できるかどうかはわかりません。
私の記憶では、少なくともジュネーブでは、毎週のように青空市が開かれています。	このページでは、スイスの大きなクリスマスマーケットをすべて紹介しています。
私の経験では、普通のタクシーの方が常に安い。	通常のタクシーを使用する場合は、それが評判の良い会社であるか、またはあなたが前もって率に同意していることを確認してください。
同じような問題がありましたが、もっと簡単な状況だったようです。	実は、ロンドン・ヒースロー空港での乗り換えの際にも、同じことをしようと思っています。
テクニカルストップは、飛行機のためにある。	通常、給油のために停車し、飛行機の中で座っているだけです。
京都は、少なくとも、ここに書かれているように、Jr京都駅があります。	日本では、ほとんどの駅にコインロッカーが設置されています。
これにはマニアックな答えと、実用的な答えがあります。	航空会社がこれをオフにするように要求しているのを見たことがあるのは、かなりばかげている。
私は8月にペルーに行き、リマから出発し、3週間ツアーに参加しました。	クスコ : 最高気温 : 70度 最低気温 :40f この時期は雨季の直前で（12月〜3月）、一般的に混雑は少ないです。
一般的に、私はほとんどどこに行っても、私はそれがatmからお金を得るために最も簡単だと思います。	市内にはATMや両替所がたくさんあり、特に市の中心部にはたくさんあります。
一番わかりやすいのは、スコットランドで最も古い長距離歩道であるウェスト・ハイランド・ウェイです。	これを見てください : http :/ / www.capewrathtrail.co.uk / あなたは段階的にそれを行うことができます。
答えは、あなたが旅行している国に大きく依存します。	いつもたくさんの処方箋薬を持って旅行している者として、私はいつもそれを申告しています。
Knin経由の列車がありますが、これは内陸に大きく回り込むことを意味します（沿岸線がないだけです）。	他の方もおっしゃっていますが、スプリットに行くなら公共交通機関のバスが一番です。
貨物船に乗るのはツアーに入りますか？	ozbusは、キトを起点とする29週間の南米ツアーを提供しています。
英語は、物を売り買いする人たちや、ホスピタリティや観光業など、あらゆる場所で通用します。	私はマハラシュトラ州（ムンバイを含む）とアンドラプラデシュ州を旅行しましたが、英語だけで問題なく過ごすことができました。
二重の目標は、敵役の目的に大きく関係していると思います。	それは、その理由次第だと思います。
シンプルなサンプルサービス」という表現がありますが、これは間違いではありません。	そのため、"simple example service "と呼ぶようにすれば、違和感のない表現になります。
ywriterとstorybookが好きではなかったので、自分のツールを始めました。	私は、上記のようなことをたくさん試しましたが、私の場合はうまくいきませんでした。
読者に気づいてもらいたいことを強調することができますので、これはOKです。	私は、これは完全に許容範囲であり、あなたのポイントを強調するのに良い仕事だと信じています。
フィクションの場合、ブログが印刷物や電子書籍として出版されていることを示す証拠はほとんどありません。	あなたの質問に答えるために、はい、私はあなたの小説をブログに書くことは、後で伝統的な出版にあなたの試みを傷つけると思います。
デビッド・ウェーバーの「The war god's own」には、長時間の移動シーンがありますが、彼はそれをうまくこなしています。	オデッセイ物語を語る上で欠かせないのが、「誤った目的地」という考え方です。
解決策を講じる前に、問題を定義する必要があります。	同じ行を何度も読み始めると、読み飛ばしてしまうんです。
あなたの心配はもっともで、読者はこれでイライラしてしまうかもしれません。	私は、あなたがそうしない限り、キャラクターの名前を知らないことが混乱を招くとは思いません。
いいえ、あなたの地域で授業を受けたり学位を取得したりする必要はありません。	私は、医療情報システムのテクニカルライティングをかなりやりました。
神話について忘れているようですが、神話は極めて一般的な物語です。	映画評論家は神話を楽しむと言いますが、観客はどうでしょうか？
最近、この問題に取り組んだところ、優れた回答としてギユメが提案されました。	ローレン・イプサムが提案したギルメットは、良い選択肢です。
私が絶対に嫌いな悪役は、利己的で自分勝手ですが、同時に臆病者でもあります。	あなたが倒したいと思う悪役は、その根底に、他人の苦しみを顧みない人がいるのです。
あなたが本を書くとき、それがあなたのために働く限り、あなたが選んだ方法で書くことができます。	順番は文章のみ（時には戻って修正する必要があります）ライターではないオプションがあります。
そうですね、退屈な台詞は完全に削除するか、面白い台詞に変えるべきですね。	私はローレンの答えに同意します：どんな物語にも高低差が必要です。
質問に対する答えは、「作家の仕事ぶりによる」です。	最初は、これはちょっと難しい質問だと思いました。
webster 's new world rhyming dictionary : clement wood 's updated this is the rhyming dictionary I turn to first .	http :/ / www.rhymezone.com / あなたは、単語を入力し、次のいずれかを選択するだけです。
悪態をつかずに簡単に悪態をつくことができることを心に留めておいてください。	この点については、スティーブン・キングのコメントが参考になると思います。
グーグル全盛の昨今、引用の出典を探さないのは杜撰です。	私はケイト・シャーウッドに同意します。最近、ほとんどの引用文は、単純に事実を確認することによって、その理由を明らかにすることができるはずです。
私は、アウトライン化／執筆前の作業の多くを、workflowyで行っています。	またScrivenerを叩いていいのでしょうか？
