(させる）表面上に静止させる	になる、または休息になる.
英数字コード	識別のための数字または文字列.
吊り上げ	に登るという行為。
(をする、あるいはどこかにいる	遣る
暴力で押し切る、恐怖で満たす	暴力や脅しで強制する。
動かす、動かされる	操作を停止する、または操作を停止させる。
立ち振る舞う	立ち振る舞う
advance ;進歩または成長に寄与する.	の進歩または成長に寄与する。
に切り込み、新しいものを生み出す可能性があります。	割るという行為
裏工作で物を売ったり、物を手に入れたりする。	精力的な、特に裏の活動によって、何かを売る、または何かを得る。
安堵感	痛みを感じないリラックスした状態．
物理的に中心または焦点から外側に広がる、または中心に向かって内側に広がる；物理的に始点から広がる。	中心から外側に広がる、または中心に向かって内側に広がる.
聞こえるように表現する；音を発する（必ずしも言葉ではない）；示す.	を表現する；音を発する（必ずしも言葉ではない）.
と疑われること．	排除された状態．
承認・支援する行為。	財産を持ち、管理する行為。
交代で仕事をする；交代で仕事をする．	交代で仕事から（誰かを）解放する。
(...を)増大させる。	範囲または強度の増加.
いみをつける	を意味する ;意味を付与する .
新しいことを始めるということ。	雇うという行為
電算機出力	( コンピュータサイエンス ) コンピュータの中にあって、紙にタイプされたり印刷されたりするもの。
探る	を探す（水底のように） 貴重なもの、失われたものを探す．
口から出す（唾液、痰、痰、嘔吐物）．	口から出す（唾液や痰を出す）．
しぜんはっせい	を取り除く行為または手段．
もとの状態にもどる	もとにもどす
を取り除く行為または手段．	物理的な位置
なみのかたち	その時々の流行に合わせた
吊り上げ	留め置き
(異体字を採用させる	新しいまたは異なる信仰を採用する原因 .
保険金を決める	保険金の支払額を決定する。
エンジンの調子が悪いような音がする	潤滑油が不足しているエンジン特有の音がする。
触れ合う	直接の物理的な接触がある;接触する。
個人、グループ、または団体のためにプログラムを手配する。	番組を編成したり、.
かいけつをすすめる	介入の必要性を示唆する。
分断または切断すること。	を排出すること、または排出すること、または排出すること。
真贋判定	外見を変えることによって、何かを隠す行為。
水中を移動する。	ふるいにかけるように移動する。
らせん状になる、またはらせん状に動く .	を巻いて、螺旋状に移動させる。
なみのかたち	周期量の値を時間に対してプロットすることによって図式化された波の形状。
抑制することで、誰かまたは何かを制御する行為。	解放という行為
( 原因となる ) 乾いたパチパチという音を出す、おそらく混ぜることによって。	乾いたパチパチという音がします。
ガムで埋める、付ける、固定する、またはガムのようにする	ガムで覆う、埋める、固定する、またはガムのように塗る.
うちゅうのひろがり	物理的な位置
を支える、支える、負う、責任を負う	させる、または責任を負う。
強引に捕らえる	力または権限によって鎮圧すること．
装甲車を装備する。	武装・装甲した自動車を装備する。
(通信の内容	通信の最後の部分です。
急いでいる感じや状態．	やる気満々な状態．
降ろす	音高を下げる
新しいものを作るという人間の行為.	を明らかにする発話行為。
一巻の終わり	意味を知る
欺く目的で行為を行う。	誤魔化すつもりでコピーすること。
物理的な接触を必要としない、感情的または知性的な結合を維持すること。	を、「感情的な」または「知性的な」状態で維持します。
生きていてよかったと思える状態．	拒否られてる状態．
海面高度	地表の固体部分。
プライマーベースでカバーする	プライマーを塗布する。
を別のスクリプトで書き直します。	は、別の方向に伸びています。
推理という行為, 考察という行為	新しいことを始めるということ。
動機付けとなる理由を与える。	行動への動機付けを行う。
場繋ぎ	断ち切り
を許容する、または責任として引き受ける.	保証を与えたり、責任を負ったりすること。
うつりすむ	移り住む
櫂を回す	櫂を回す
由とする	理由または原因または正当化として機能する。
新しいものを作るという人間の行為.	何かを初めて始めること；新しいものを導入すること．
分子運動のエネルギー	紙幣や硬貨のような形のお金.
てんぬき	裂くという行為．
上向	上り勾配
萎む、枯れる、成熟しない、花のように。	萎む、枯れる、成熟しない．
アイデンティファイ	として認識し、誰かまたは何かのアイデンティティを確立します。
缶や瓶に保存する。	缶や缶に保存する。
お金を稼ぐためにする主な活動。	お金を稼ぐために行う人生の主要な活動.
暦の上では12月	一年の最後の（12番目の）月である。
こうえきざいむしゃ	政府の規制を受け、公共サービスを行う企業。
係わり合う	係わり合う
無効とする；法的な力を奪う、または無能にする.	の法的効力を奪い、または効力を失わせる。
非を責める	動作させるという行為．
ストーリーライン；文学または演劇作品の計画、計画、または主要な物語、真実またはフィクション。	きだん
物販店	商品またはサービスの小売のための商業施設。
捻じ伏せる	捻じ曲げる
肩や背中に乗る；背中や肩で支える.	背中や肩をサポートします。
拮抗する	対等な重さ、力。
視覚的特徴	何かする機会．
軸をとる	を軸に回転させる。
社会的失墜	地位や名誉を失墜させるような失敗をした場合。
通信の主成分	通信の最後の部分です。
目力	予想される興味や活動の範囲.
と疑われること．	拒否られてる状態．
土地を耕す過程、おそらく生活様式として。	職業または生活様式としての農業。
非を責める	解放という行為
を受け入れる、慣らす、適応させる	新しいまたは異なった条件に自分を合わせる。
新しいものを作るという人間の行為.	割るという行為
吊り上げ	止めるという行為
(させる）表面上に静止させる	を噴出させる。
より長くする、期間または空間を延長する。	期間または空間を長くする。
スタメン	( american football ) スクリメージライン上の位置。
に鋭いまたは刺すような痛みをもたらす。	鋭い、または刺すような痛みや不快感を与える .
事を起こす	引き金となる
ロマンシングアクション	義務、原則、または適切な行為から誘い出す、または誘い出す。
いみじょうのできごと	特殊事情
キルギスの基本通貨単位	キルギスのお金の基本単位.
吊り上げ	割るという行為
いみをとらえる	意味を知る
あてる	一か八かである。
目的設計	計画することで、特定の役割や目的、または効果を得ることができます。
対抗する	追い出し行為
(抽象的または物理的な空間において群れを形成させる。	を持たせる、抽象的な意味でも物理的な意味でも.
( ゲーム ) が許されている間、（おそらくは攻撃として）プレーしている部門。	( スポーツ ) 片方のチームが攻め込んでいる間の分割。
主権国家とその集合体	国家の統治権者である君主とその助言者たち。
一巻の終わり	を取り除く行為または手段．
参加登録する	参加者またはメンバーとして正式に登録する。
真贋判定	解放という行為
方向、態度、または行動のコースを、おそらく知覚的に逆転させる。	リバース（方向、態度、または行動のコース）。
公式または非公式に確立された、または認識された権利.	確立された、または認識された権利.
てんぬき	形成または確立の行為.
問題解決方法	問題解決に成功した行動．
オブザーバー	警察の一員.
ゆうびんアドレス	個人または組織と連絡を取ることができるアドレス。
削り出す	削る
吊り上げ	を構築することである。
(固体から液体へ変化させる。	熱を加えると液体または流体になります。
呼応する	刺激や命令に反応する.
多寡	落とし
ふどうしょう	政府または国立銀行が発行する公式通貨。
急ぎ足で動くこと．	慌ただしく動くこと．
新しいものを作るという人間の行為.	法律を制定すること、あるいは制定する行為。
コミュニケーション・インスタンスの意図する意味 .	通信の意図するところ.
手に入る	手に入る
つうずる	新しい場所に移動する、または設立する .
しんきのうしょうがい	心臓の病気.
原稿を赤く塗る	赤く塗った文字で（原稿）を飾る。
唾液、痰、または物を口から出すこと.	口から出す（唾液や痰を出す）．
淵を計る	測線で水深を測る。
鋳掛屋の仕事をする（鍋を直す）	として働く。
会議終了	会議終了後．
爪で掻きむしる	爪で攻める
社交の場	公式な社交の場、儀式。
不在の状態．	に登るという行為。
(粉にする、または塵にする。	が広く知られるようになる。
特定の目的のために準備する、手配する、作成する、組織化する	特定の目的のために確保された任意の領域。
聴衆に向かって講義をする	罪を着せる
廃棄された、または拒否された、または破損した材料を収集します。	廃棄物や拒否されたものを回収する。
しんぶんしゃ	新聞を発行している会社です。
誤魔化すつもりでコピーすること。	舌で受け止める．
もとにもどす	もとにもどす
体を前後させる	楽な姿勢で移動・配置する．
光源から安定した、均一な光を放つ。	は、炎を出さずに安定した均一な光を放ちます。
一式戦闘機	軍用機の一隊.
混乱状態．	大混乱に陥れる
国際的な取引を可能にする、ある通貨と別の通貨を交換するシステム	ある通貨を別の通貨に交換するシステム；国際取引を可能にする。
色や濃淡に基づく知覚的な区別.	非常に異なる色の並置による知覚効果.
クリーム煮やクリームを使った料理.	コーヒーにクリームを入れる、など。
見分ける	亡くす
囲い込み状態	枯渇状態
大枝	徒然なるままに...
見分ける	追い出し行為
嬲り殺し	鉄で足を包んでゆっくり押しつぶす足責め。
を制御できないように移動する。	を制御できないように歩く。
受益者管理制度	ある者（受託者）が別の者（受益者）の利益のために保有するもの（財産として）。
動かす、動かされる	横に傾く原因となる．
証拠品	とか、何か隠された活動をしている気配がする．
不在の状態．	と疑われること．
保護状態	ある特定の状態または条件にある．
範囲に制限をかける	範囲を限定する
おこぼれに預かる	雇うという行為
えんそうきょくもく	( music ) 音楽のテーマを提示すること。
ゆらりゆらり	を動かす、または、渦巻き状の、または円形のコースで動かす。
海外に売る、運ぶ	世界各地に広める。
委員会構成員	審査委員会
置く、位置する、静止する	定位置につく
を制限する；境界を形成する、または隣接する。	の境界を形成し、.に隣接している。
通貨から他の通貨への換算値	ある国の通貨を他の国の通貨に交換するための手数料。
かんみんぞく	結婚している二人．
牢屋に閉じ込める	枠で囲む、または枠で囲む。
誤魔化すつもりでコピーすること。	騙すつもりで信じ込ませる．
グライダーに乗る	グライダーで飛ぶ、またはグライダーのように飛ぶ．
民族・人種を問わない	あらゆる人種や民族のメンバーに開かれた（場所）。
後を追う	獲りに行く
中心領域	物体の中心。
完全に覆う；覆いを形成する；上に展開する.	カーペットのようなカバーを形成する（over）。
吊り上げ	落とし
発明者に権利や特権を与える文書。	発明者に発明の独占的権利を付与する文書。
体験者が感じられる、独特の、あるいは特徴的な味を持っている。	独特の味を持つ。
意味を知る、気づく、理解する	を知り、理解する。
特定の機能のために何かを作る、または作成する .	つくる
かわる	新しいまたは異なった条件に自分を合わせる。
を支える、支える、負う、責任を負う	を組織する、または責任を負う。
肩や背中に乗る；背中や肩で支える.	肩や背中に乗る
結合、混合、統合する行為	混ぜるという行為.
矩形の側面を持つ立体3Dオブジェクト	矩形片
作品翻訳	移動すること。
を書き換える、または、おそらく別の目的に合わせて、作品や文章を変更する。	書き直すことで、新しい目的に合うようにする。
不在の状態．	破門された状態．
浮き上がる	を表示する、または見えるようになる；を表示する。
力を弱める、抑制する、弱める	を、その効力または効果を減少させる。
てんぬき	に登るという行為。
相談する項目とマークする項目のリスト	確認すべき事項のリスト（名前やタスクなど）。
板で覆う、固定する	乗り込む
分断または切断すること。	ということです。
掛け台とする	饗応する
オブザーバー	ある活動に専念するための会合。
