ほとんどの場合、どの事象が起こるか、あるいは起こるべきかを検討しなければならないエージェントが関与しています。	好き勝手
このフレームでは，すべての「価値」につい て，評価者が「社会的地位の認識と関連する」パラ メータを組み込む以外は，望ましさのフレームと同様 の「価値」が含まれる．	日常的な言語であること、またはその性質があること。
このフレームは、型の概念的なプロトタイプとの類似性の観点から評価される型のインスタンスの特定のサブセットに関するものである。	標準的な、または典型的な例;
応答は、トリガーイベントに対処するための何らかのアクションであるか、トリガーイ ベントに対する明示的な判断のどちらかであろう。	逢うべくして逢うのです。
テキストとは、あるトピックに関する言語的、象徴的な情報を含む実体であり、ある作者によって作成されたものである。	人生行路記
提供者は、潜在的な受信者にテーマを提供することが可能であり、その意志があることを示します。	を提供する（通常、必ずしも食べ物である必要はない）。
この枠は、政治的・行政的に定義された地名を表す単語を対象としています。	統治または支配を行う領域。
エージェントは，ある出来事が起こらないように積極的に（常に成功するとは限らない）試みます．この出来事は（通常），エージェントが防ぎたいと思う行動を促す衝動です．	をしない ;常に否定的に使用されます。
この枠の中の言葉は、ある時点に対して、ある期間を表しています。	きのうてき
認知者は被評価者を判断し、被評価者に対する自分の評価の高低を表現する。	感情、直感、または不定な根拠に基づいて信じるようになる。
支配する主体が、従属する主体、従属する状況、または従属する変数を意識的に制御していること。	個人的・社会的な活動においての規律;
これは、基数によって呼び起こされる主要なフレームです。	ゼロと単位を含む量の概念。
このフレームは、ある場所に住んでいる人（住人）、時には同居している人に関係するものです。	に住む、または住んでいる；の住民である。
形式的実現は、判定表現において正しいか正しくないかとして記述されることもあれば、形式的実現の一部として部分的に示されることもあります。	( 音声学 ) ある言語の音素であるかどうかに関係なく、音声の個々の音の単位。
道具が作られる材料は、自然のものでも人工のものでもよく、別の道具も含まれる。	何に使うか
このフレームは、死によって誰かを失うことを経験する被災者を描写している。このフレームのルスは、被災者と故人の間の強い感情的なつながりを暗示している。	死亡または除去によって人を失うことになる。
このフレームには、時間の測定単位である（透過的な）名詞が含まれる。このフレームでは、「来週、今月、21世紀」のように、週、月などの名詞の指示的、暦的用法を注釈することはない。	何かを達成するのに十分な、自分のコントロール下にある資源とみなされる期間。
移動中にインパクタが被衝撃者に突然強制的に接触する、または2つのインパクタが共に移動し、相互に強制的に接触する。	ぶつかる；急に接触する．
顧客が供給者に実体を要求する。顧客は自分自身で、または媒体を通じて実体を注文することができる。	を作る、供給する、または提供することを要求する。
このフレームは、個人の集合体を示す名詞を含む。集合体は、aggregateproperty で記述することができる。	共通の目的を持った人々の集団（多くの場合、一時的なもの）;
このフレーム内の否定形の lus は、次の例に示すように、悪い、または認識が不足していると特徴付けることができる時間帯を表すために比喩的に使用することができます。	翳りのある、または黒っぽい;
顧客が供給者に実体を要求する。顧客は自分自身で、または媒体を通じて実体を注文することができる。	支払いと引き換えに何かを供給するよう誰かに依頼し、仕様と数量を提供するために使用される商業文書;
記録可能な一連の出来事は、与えられたトピックに関連しています。	過去から現在、そして未来へとつながる連続的な事象のこと。
このフレームには、化学物質の効能を表す言葉が書かれています。	強い生理的・化学的作用を有すること。
このフレームは、何らかの明確な構造とメンバーを持つ、意図的に形成された人間の社会集団（ここでは組織と呼ぶ）について述べている。彼らは、誰が仲間で誰が仲間でないかを認識している個人のグループのみからなる比較的非公式なものかもしれないし、ローマカトリック教会や保守党など複雑で長く続くものかもしれない。	監督権限を有する委員会
このフレームには、ある特性変数に対する項目の静的な位置づけを表す単語が含まれています。	程度または強度または量が通常より大きいこと。
実体はよく知られていたり、有名である必要はないが、もしそうであれば、その名前だけで述べられてもよい。その価値は、ある時間または場所に限定されてもよい。	重要な意義や重要性を持つ;
このフレームには、肩書きや地位を表す名詞（例：監督、王、社長）と、リーダーシップの作用を表す動詞（例：支配、統治）が含まれる。 動詞では、リーダーの果たす役割（王など、指導的地位の名前であることが多い）を言及することが可能である。	を行使する、国家として。
このフレームは、何らかの共通性（一般的には共通の属性）を持つ個人の集合を表す単語を含んでいます。	共同体全体に属する、または共同体によって参加される; 公共の;
従業員は、特定の分野で仕事をする、または特定のタスクで仕事をする、雇用主が従業員に報酬を与えるためのポジションを持っています。	給料をもらっている職業;
このフレームには親族関係を示す単語が含まれている。これらの単語の方向性を示す注釈として、人類学の標準的な用語であるegoとalterを使用している。	一緒に暮らす社会的な単位;
がテーマと相互作用し，テーマを移動させる効果がある．	( 生理学 ) 機能や動作、反射などの調節や維持;
テーマが知覚的であれば，予想される軌道は通常，計画された軌道と同じになる．テーマが非知覚的であれば，予想される軌道は通常，テーマに作用するさまざまな力の結果である．	ある場所や地点につながる線
このフレームには、話し手が言語を使って、ある宛先にメッセージを送る行為を伝える動詞と名詞が含まれています。	提案する、計画を宣言する。
を、改善につながる順序で変化させる。	段階的に別のステージ（特に、より進んだ、または成熟したステージ）へと移行するプロセス。
体験者は、ある一定の行動パターン、すなわちライフスタイルを実現する。このライフスタイルは、体験者の生活の中でかなりの期間持続し、その人の性格や普段の生活の一部として認識される。このライフスタイルは、必ずしも意図的に実現されたものではなく、単に状況の結果である場合もある。	ある種の生活を送る、ある種のスタイルで生活する．
ある種の特異性は、ある実体を他の実体から区別するために、その実体に属している。	人または物またはカテゴリに固有または特異な;
このフレームでは、エンティティは温度を経験しておらず、単に外的に検証可能な特定の状態にあると記述されていることに注意してください。	快適で心地よい熱を持つ、または作り出す、または熱を与える、または維持する;
この役割は（通常）一時的なものであり、異なる時期に他のエンティティによって占有される可能性があります。	職務を行う、または役職に就く;特定の機能を果たす;
このフレームは、参加者間に永続的または半永久的な関係がある場合とない場合がある社会的イベントを記述します。さらに、このフレームの参加者は、1つの代表的な形である参加者で表されます。	デートの参加者;
このフレームには、操作することで何らかのデバイスの機能を変更するアイテムが含まれています , 内部または外部 .	機械の動作を制御する機構。
このフレームは、所有者が所有物の量を増加または減少させる一般的な状況を記述している。	物理的または抽象的な意味で、保持または維持することができなくなる。
エンティティは、車両全体を指す場合もあれば、単に車両の一部分を指す場合もある（表現されていない場合もある）全体の一部として、車両に統合されています。	自動車に設けられた透明な開口部で、側面や背面の視界を確保するもので、通常は開けることができます。
このフレームには、色の特定の側面を説明する言葉が含まれています。説明されている色がプロトタイプから逸脱している程度をマークすることができます。	(色相が暗い。
データの永続的な記録を含む記録。この記録は、特定の団体の記録係によって管理されることがあります。	商業用口座が記録されているレコード。
このフレームは、所有者（poss）が持つ、記述子（desc）で特徴付けられる身体_部分（bp）の単語を対象とする。 bpの位置は、その付着またはその方向 _ の位置の観点から特定することができる。	額から顎、耳から耳までの人間の前頭部。
多くの場合，トリガーが発生した後に，エージェントは非エージェントのレスポンス・エンティティによってレスポンスが引き起こされる．	あいてにする
主人公が生きているというダイナミックで維持された状態にあるか、この状態から脱したか。	生きている状態、または生きている状態．
ある状況において、他の競合する行為者を排除して、最も強い力、または最も重要な原因因子となるように行動する行為者。	数で勝る、量で勝る、力で勝る、地位で勝る、重要である。
このフレームに含まれる語彙ユニットの中には（great や good など）、エンティティの永続的で一般的な状態しか表現できないものがある。	品質も状態も良く、しっかりした作り。
エージェントは、インパクタを被衝撃者に突然強制的に接触させるか、または2つ以上のインパクタを操作して、相互に強制的に接触させる。	打ち込む
体験者は、周囲の気温に関係するしないにかかわらず、さまざまな温かさを感じる。温かさのレベルは、通常、体験者の主観的な快適さの基準と比較される。	快適で心地よい熱を持つ、または作り出す、または熱を与える、または維持する;
囚人は、罪を犯した場合、一定期間刑務所に収監されることによって罰せられます。	刑務所や労働キャンプで過ごす。
このフレームでは、話し手が相手に何かを求めたり、ある行動を実行するように要求します。	権限を持って指示する。
時間や場所によって決まる、ある環境の温度を指定します。	快適で心地よい熱を持つ、または作り出す、または熱を与える、または維持する;
エージェントは目的を達成するために、手段（行動または行動を代行する（システムの）実体）を利用する（この枠は、非意図的な中間行動を含むように拡大されることもある）。)	どのように結果が得られるか、または目的が達成されるか。
テキストとは、あるトピックに関する言語的、象徴的な情報を含む実体であり、ある作者によって作成されたものである。	過去の記録や物語を記したもの。
影響する_変数，影響する_状況，または影響する_実体は，従属する_実体，従属する_変数，または従属する_状況に影響を与えます．	あるものが別のものに与える影響．
このフレームは、物質の断片を表す透明な名詞に関するものです。また、断片の性質、例えば大きさに関するものであるpiece _ propも存在します。	コンピュータの拡張スロットに挿入して、コンピュータの能力を向上させるプリント回路。
聴衆は一般に受動的であるが、多くの種類の講演（学術講演や記者会見を含む）では、事実上常に討論や質疑応答の時間が必要である。	を語る、または詳細な説明をする。
このフレーム内の単語( s )は、時間の特定の瞬間を詳述しています。これらは、this や that のような指示詞と一緒によく起こります。	その月の指定された日 ;
このフレームは、全体の実体の一部または部分を表す名詞に関係します。 部分は、全体の向き、中心、端に対して定義されず、順序付けもされません。また、サイズなど、部分の特性も注釈します。	( 音楽 ) 作曲または楽章のうち、主要な音楽テーマが展開され、詳しく説明される部分（特にソナタ形式）。
エンティティは、ある活動を行うため、あるいはある役割を果たすために設計され、存在する。	目的、役割、または機能を果たす。
所有者によって定義された場所。	不動産が所在する土地;
当局は、犯罪の処罰として囚人を刑務所に入れる.	懲役刑の期間。
個人またはグループ（実務家）、あるいは仕事生活の一部（仕事）は、彼らが通常従事している活動によって専門的に定義されます。代わりに、その活動は、従来からそれに関連する顕著な実体によって示されることもあります。	人間が関わる過去の出来事を記録し、解釈する学問分野。
特定の情報の正確さを評価する。また、正確さの度合いを表現することもある。	事実または現実に即している；虚偽でない;
このフレームは、ある場所や機能へのアクセスを許可するために使用される、物理的またはその他のオブジェクトのためのものです。	コンビネーション・ロックを開くための数字や文字の羅列。
このフレームには親族関係を示す単語が含まれている。これらの単語の方向性を示す注釈として、人類学の標準的な用語であるegoとalterを使用している。	男系
このフレームにおけるlusは、有効化された_アクションが可能になる期間を示す。この期間の期間は、正確でも不正確でもよい。	何かを始める、または終えるのに最も適していると思われる期間。
このフレームは、身体の顕著な部分に基づいて人を表現する言葉に関するものである。	( 髪や肌の色で ) 淡い色または明るい色 ; ;
某イベントは、ある場所とある時間に行われます。	最近の出来事で、現在の状況に関連するもの。
あるイベント（通常は知覚や操作）に他のエンティティが参加できる一定の物理的な距離がある。[このフレームの言葉は一般的に「できるほど近い」と言い換えることができる。]	さまざまな心象風景。
競技者が競技に参加した結果、賞品を請求した場合。	コンテストや競争において勝者となる；勝利する;
人工物は、ある種の用途に使用するために、知的実体によって意図的に作成または修正されます。人工物のさまざまな特性は、その作成者、作成時間、名前、タイプ、および構成材料などを指定できます。人工物は、物理実体であってもなくてもかまいません。	大小さまざまな用途に使用される頑丈な木材です。
ヘルパーは、受益者が持っている目標を達成できるようにすることで、受益者に利益をもたらす。	助けや援助を与える；奉仕する。
形式的実現は、判定表現において正しいか正しくないかとして記述されることもあれば、形式的実現の一部として部分的に示されることもあります。	ある方法で話す、発音する、口に出す。
この枠は、政治的・行政的に定義された地名を表す単語を対象としています。	国家が占有する領域．
当局は、犯罪の処罰として囚人を刑務所に入れる.	囚人が生きている限り続く刑期。
エージェントは目的を達成するために道具を操作する．	特定の目的のために、あるいは本来の目的のために、仕事をさせる、あるいは雇用する。
このフレームは、認知者が信念や期待の正しさについて確信を持っていることに関係する。	あるものが真実であると認識する；あるものを信じたり、信仰したりする；疑いなく真実であるとみなす。
この枠内の単語は、エージェントや原因が犠牲者を傷つける状況を表す。最も直接的に影響を受ける犠牲者の身体 _ 部分は、犠牲者の代わりに言及されることもある。	鋭く当る
有用な場所とは、潜在的な障壁があるにもかかわらず、何らかの（おそらく一般的な）テーマでアクセス可能である、あるいは障壁のためにアクセス不可能である。	メラニン色素が豊富な肌であること。
話し手が、書かれた文章を解釈し、その内容を、通常は相手に向かって話すこと。その内容は、文章そのままである場合もあれば、文章の表現である場合もある。	文字や印刷物を見て、解釈して、声に出して言う。
この枠の中の言葉は、認識者が2つの現象の違いを認識している（または認識していない）ことに関係しており、それは共同または分離して表現されることがある。	区別することができる、異なっていることを認識する。
このフレームは、何らかの明確な構造とメンバーを持つ、意図的に形成された人間の社会集団（ここでは組織と呼ぶ）について述べている。彼らは、誰が仲間で誰が仲間でないかを認識している個人のグループのみからなる比較的非公式なものかもしれないし、ローマカトリック教会や保守党など複雑で長く続くものかもしれない。	同じ趣味を持つ人たちの正式な集まり．
このフレームは、所有者が所有物を紛失する状況を説明しています。所有者は、所有物の所有権を保持することに失敗した場合（例：強盗や賭博）、または意図せずに所有物を置き忘れた場合があります。	物理的または抽象的な意味で、保持または維持することができなくなる。
これらの形容詞は、あるエージェントの厳しさや寛容さの度合いを表すもので、通常は他の人（被制御者）に関して、また多くの場合は特定の問題に関して用いられる。問題に対する厳しさ／寛容さは、エージェントや何らかの媒体（法律など）、あるいはエージェントの何らかの行動、すなわち被制御者の行動で（表現されて）現れることがある。	こっきしょうじん
ある刺激によって、認知者は、その知覚された類似性により、先行する現象を思い浮かべます。	介入の必要性を示唆する。
人工物は、ある種の用途に使用するために、知的実体によって意図的に作成または修正されます。人工物のさまざまな特性は、その作成者、作成時間、名前、タイプ、および構成材料などを指定できます。人工物は、物理実体であってもなくてもかまいません。	ボードゲーム用に設計された平らなポータブル表面（通常は長方形）。
当局は、犯罪を犯した疑いのある容疑者（容疑）を告発し、身柄を拘束します。	警察簿に告発を記録する。
このフレームは、階層構造内のランクやレベルを表す名詞を含んでいます。	( 通常は複数形 ) キリスト教の聖職者の地位や階級、役職。
テキストとは、あるトピックに関する言語的、象徴的な情報を含む実体で、ある作者によって、_作成されたものです。	出版された著作物または構成物(結合されたページに印刷される);
また、体験者が熱を感じるために行った活動や、断熱材を判定する際の状況も提示することができる。	快適で心地よい熱を持つ、または作り出す、または熱を与える、または維持する;
このフレームは、観察者が実体の存在を確認する場として場所がプロファイリングされる点で、存在とは異なるものである。	不在の状態．
実体が時間通りに変化する（と解釈される）こと。 このフレームは、主に共通のフェイズが継承されるために存在する。	は、突然に、通常は不利に、影響を与える。
ロケールは、形状によって定義される地理的な場所である。このフレームには、土地/氷の形や水域などの自然の地理的な特徴が含まれる。	一衣帯水
ある実体が、（一般に暗黙の）判定者にとって、感覚的に好ましい、あるいは知的好奇心をそそるものであると判定された場合。	目に楽しい。
この枠の中の言葉は、ある時点に対して、ある期間を表しています。	不定期（通常、特定の属性や活動を特徴とする）;
は、そのタイプの他のメンバーとの比較において知覚的に際立っている。	攪拌や活動がない、またはそれに近い状態であることを特徴とする。
このフレームは、物質の熱力学的な相の属性を記述しています。	( 化学 ) 物質の伝統的な3つの状態は、固体 ( 形状と体積が決まっている ) と液体 ( 容器によって形状が決まっている ) と気体 ( 容器を満たしている ) です。
これらの言葉は、特定の機会やトピック、または一般的に、話し手が（通常は表現されない）審査員によって判断されるメッセージの大きさを記述します。他のコミュニケーションフレームと同様に、媒体も表現されることがあります。	騒がない;または、ほとんど音を立てない;
この枠内の単語は、法律や規則の規範に対する行為の状態を記述します。オブジェクトは、その存在、場所、または所有によって、規範に違反または準拠している可能性もあります。	(ファウルラインの間に打った。
ヘルパーは、受益者が持っている目標を達成できるようにすることで、受益者に利益をもたらす。	食べ物や飲み物を手伝う。
この枠内の言葉は、表情とその持ち主を指しています。	表情に表れる感情。
使用によって定義されるジオグラフィー。	何らかの目的をもって開発された地区。
現象は、（通常は暗黙の）証拠、知覚者、およびそれが考慮される状況を考えると、それが知覚され、知られる可能性の程度に関して描かれている。見える，聞こえるなど，いくつかのルスについては，対象そのものが知覚的な経験であるため，証拠の種類は固定されている．	目に見える、または目につくようになる。
この枠は、政治的・行政的に定義された地名を表す単語を対象としています。	国家を構成する行政区域の1つが占める領土。
話し手は、ある実体の属性の強さを度合いで表します。	酷く悪い、あるいは不愉快な程度、質。
このフレームの語彙ユニットには、生物が共通の生物学的特性に基づいてグループ化された7つの主要な分類が含まれます。これらの分類は、このフレームではランクと呼ばれています。	(生物学）一つ以上の科を含む分類群。
実験者は仮説に基づいて実験を行う。この実験では、結果を決定するために、対照群または対照個体と治療群または治療個体とを比較する。	科学的な実験において、他の条件と比較するための基準となるもの。
このフレームは、個人の集合体を示す名詞を含む。集合体は、aggregateproperty で記述することができる。	一枚綴り
このフレームはイベントの繰り返し（特に繰り返しの頻度）に関係する。このフレームの形容詞や副詞の多くは、カレンド単位フレームの名詞を基にしている。	特別な区別や品質がない；広く知られている、または一般的に遭遇する；平均的または普通または通常。
このフレームには、質量や個体の量を表す透明な名詞（および一部の形容詞）が含まれる。group や set などの集合的な単語とは対照的に、これらの量はそれ自体で全体としての地位を持たない。少なくとも最初は、このフレームに質量と個体の量の両方を注釈するが、後にこれらの線に沿ってフレームを分割するかもしれない。	過剰でも極端でもない
大きさとは、その実体が占める三次元空間の大きさのことである。	比較的大きなサイズ、数、または範囲；他の同種のものよりも大きい。
あるエージェントまたは原因が、新しいメンバーをグループの一部とする。	を加える；結合する；質、量、大きさ、または範囲を増加させる。
このフレームのlusは、型のインスタンスが文脈上注目すべきものであることを示します。このフレームは通常、2つのfeレイヤーのアノテーションを必要とします。	同じグループまたはカテゴリの他者から分離され、区別される。
このフレームは、従来、特定の名前で呼ばれていたエンティティに関するものです。	人または物を知るための言語単位。
このフレームの語彙ユニットは、秩序または無秩序の状態にある実体に関係します。多くの場合、実体はこのフレームで表現されないため、空インスタンス化としてマークされます。	慣習的な国家（特に社会）．
このフレームに含まれる語彙ユニットは、ある状態 _ of _ affairs に対する認識者の態度や見通しを記述したものである。	を、陰険なユーモアで表現しています。
顕著な下位事象は、より大きなプロセスの中で繰り返されるパターンを持っています。	部音律
認識者は、社会に新しいアイデアを導入する。	発見をする、新しい発見をする ;
体験者は、ある一定の行動パターン、すなわちライフスタイルを実現する。このライフスタイルは、体験者の生活の中でかなりの期間持続し、その人の性格や普段の生活の一部として認識される。このライフスタイルは、必ずしも意図的に実現されたものではなく、単に状況の結果である場合もある。	特徴的な状態や生活様式;
このフレームには、アートワークが表現する形態を表すルールが含まれています。形態は、アーティストの作品全体を表すこともあります。	( 建築 ) 使用される柱とエンタブラチャーの種類によって区別されるギリシャ建築のオリジナルの3つのスタイルのうちの1つ、またはローマ人によってオリジナルの3つのスタイルから開発されたスタイル。
使用によって定義されるジオグラフィー。	仕事をする場所。
エンティティがイベントに参加するための前提条件を満たしている場合、そのエンティティが最低限必要な条件をどの程度上回っているか、または下回っているかを示すために、程度修飾子が含まれることがあります。	( 通常は `to ' が続く ) 何かをするのに必要な手段やスキル、ノウハウ、権限を持っていること。
人（認知者）は、時には推論の過程を経て、何か（内容）を信じるようになる。この信念の変化は、通常、人または証拠の一部によって開始される。この領域の単語には、トピック、すなわち、精神的内容に関することを表現するフレーズを伴うことがある。	計算、調査、実験、調査、研究の後に確立します。
このフレームでは、摂取者が物質を体内に取り込む。	取る、消費する（定期的にまたは習慣的に）。
このフレーム内の単語は、言語コミュニケーションのイベントを表しますが、外的な議論として話し手ではなく、聞き手を表現します。	を聞いて理解することです。
ロケールは、形状によって定義される地理的な場所である。このフレームには、土地/氷の形や水域などの自然の地理的な特徴が含まれる。	植物が生育可能な地表の最表層にある物質（特にその品質または使用に関するもの）;
このフレームの語彙ユニットには、生物が共通の生物学的特性に基づいてグループ化された7つの主要な分類が含まれます。これらの分類は、このフレームではランクと呼ばれています。	(生物学）1つまたは複数の属を含む分類群。
知覚者は、地面の中で探している実体の位置を決定する。	探した結果、見つけることができた; 見失ったものを見つける;
このフレームでは、話し手が相手に何かを求めたり、ある行動を実行するように要求します。	( 多くが複数 ) 上官（軍隊や法執行官など）から与えられた、従わなければならない命令。
