メキシコで麻薬王を海兵隊が捕獲	メキシコで「エル・タリバン」と呼ばれる麻薬王の容疑者が拘束された。
シリア・ホムスの石油パイプラインが爆発に見舞われる	アサド政権の都市攻撃でパイプラインが爆発
アフガンの攻撃でNATO軍兵士が死亡	ナトー兵士、南アフガニスタンで死亡
カストロは月曜日に86歳の誕生日を迎えました。	フィデル・カストロ、86歳の誕生日を迎える
イスラエルの元スパイがイラン戦争に警鐘を鳴らす	イスラエルの元スパイ：イラン問題で指導者を信頼できない - ビデオ
アイ・オープナー：アリゾナ州移民法に関する最高裁判所の判決	米国最高裁判所、アリゾナ州移民法について2つに分かれた判決を下す
NATOがアフガニスタンからの脱出経路を追跡している。	NATO首脳、アフガニスタン移行にコミット
シリア、ダマスカスで自爆テロ、10人死亡と発表	ダマスカス、自爆テロ、10人死亡
サチン・テンドルカー、「私は神ではない、私はサチンだ」と語る。	サシン・テンドルカールがクリケットで初の100世紀を達成
トロピカルストームがホンジュラス沿岸を通過する。	南東部沿岸に熱帯性暴風雨警報
ギラード首相、挑戦権獲得へ	豪州首相、指導力をめぐる圧力に屈せず
オバマ大統領、南シナ海でフィリピンを支援	オバマ大統領、南シナ海の静穏化に明確なルールが必要だと発言
中国の若者がナイフ攻撃で8人を殺害、5人に怪我を負わせた。	ティーンエイジャーがナイフ攻撃で8人を殺害
シリア反乱軍、トルコからシリアに司令部を移す	自由シリア軍、トルコからシリアに司令部を移転
ネセト議長：オバマ再選はイスラエルにとって悪いことだ	オバマ政権の出産規制をめぐり、7州が提訴
ネタニヤフ首相、早期投票に踏み切る	イスラエルのネタニヤフ首相、早期投票へ
ギリシャの債券交換 史上最大の債務再編	ギリシャ、史上最大の債務協定を締結
プーチン「ロシア大統領選挙で勝利する」。	露国大統領選の開票が行われました。
ナイジェリアの教会で自爆テロ、12人が死亡	パキスタン北部で自爆テロ、21人が死亡
インド財務相、大統領選出馬のため辞任	ジュリアン・アサンジ、オーストラリア上院議員選挙に出馬予定
ジェリー・サンダスキー、児童性的虐待裁判で有罪判決	サンダスキーは児童性的虐待の裁判で有罪になった。
中国西部でチベット人3人が焼身自殺：報道	中国でチベット人7人が焼身自殺
ホワイトハウスは、オバマ大統領の最高裁発言について損害賠償を要求している。	ファクトチェック : オバマ大統領による最高裁での発言
アナン、シリア・リスクについて会談で警告	プーチン大統領とアナン首相、シリア危機で会談
カルテット、イスラエルとパレスチナに刺激的な行為をやめるよう要請	占領軍、デイルエスティアのパレスチナの土地30ダムを没収へ
サウジアラビア、女性のオリンピック出場を許可へ	サウジ女子、五輪出場認める
ナイジェリア大学、武装集団に襲われる	ナイジェリア：北部で大学が爆破される
米国、盲目の中国人活動家を支援する用意があると発表	米国は中国の活動家を支援する用意がある：政府高官
中国、内閣が景気浮揚を約束	中国、温家宝首相が雇用創出を約束
アナン事務総長、安保理にシリア問題への対応を要請	ロシア、中国がシリアに関する国連安全保障理事会決議に拒否権を行使
グリーン・ランタン、DCコミックスからゲイとして再登場へ	グリーン・ランタン、ゲイのスーパーヒーローとして再スタートへ
フランス南部で軍用機が墜落 : 当局	トルコ南東部で軍用機が墜落、1人死亡
熱帯性暴風雨アイザックが失業保険申請件数を押し上げる	熱帯性暴風雨Joyceが発生し、大西洋の外側にとどまる。
ガザンがイスラエルにロケット弾2発を発射、負傷者なし	ガザのロケット弾2発がイスラエルに命中、負傷者なし
フレディ・スター、サヴィル虐待問題で逮捕	サヴィル氏による性的虐待の捜査で3人目の男を逮捕
ロムニー、ポール・ライアンを伴走者に発表	ロムニー、ライアンを伴走者に指名
ギリシャの合意を受けて株価が上昇し、その後横ばい。	ギリシャの債務問題で株価は上昇
イエメン軍のエリートキャンプで自爆テロが発生	自爆テロがイエメン軍基地を襲撃
NATO : アフガニスタンで国際部隊2名が殺害される	アフガニスタンで1日に3人のNATO軍兵士が殺害された。
モスクワのデモ隊、プーチン大統領の辞任を要求	プーチン大統領に抗議するモスクワのデモは小さく静かになった。
サウジアラビアのガストラック爆発、少なくとも22人が死亡	ナイジェリアの教会で爆発、少なくとも12人が死亡
フランス選挙の投票率が予想を上回る	フランス大統領選挙：第一回投票 ライブ中継
オーストラリア、世界最大の海洋保護区を設立へ	オーストラリアが世界最大の海洋保護区を創設
米兵2人がアフガン兵に撃たれ、死亡。	アフガン警官に殺害された英兵2名
イタリア兵、アフガニスタンで死亡	アフガニスタンで2人の英軍兵士が死亡
アッバス、パレスチナ統一政府を主導へ	アッバスが暫定統一政府の首相に提案されました。
エジプト・コプト教会、新法王を選出	エジプト・コプト教会、ローマ法王選出に向け準備中
マラウイ、大統領の死去を公式に確認	マラウイ、ムタリカ大統領の死去を確認
マリ共和国のトゥアレグ族が独立を宣言	マリの反政府勢力が独立「アザワド」を宣言
ランス・アームストロング、ツール・ド・フランスのタイトルを剥奪される	ランス・アームストロング、タイトルを失った後の戦略を練る
エジプト、大統領選最終日に投票	フランスで大統領選の投票が開始されました。
ベリ、国民統合政府の発足に協力する用意があることを表明	この政権でスペインに対する認識は大きく変わった。
マドレーヌ・マッカンは生きているのか？	マドレーヌ事件の再捜査、警察が要請
イラクの爆弾テロで13人死亡	北イラクの攻撃で16人死亡
ISAF : アフガン警察の攻撃で連合軍兵士4人が死亡	NATO、アフガニスタン南部での「内部者」による攻撃で4人の兵士が死亡したと発表。
コティ、ライバルのエイボンに100億ドルの買収を開始	コティ、エイボンを100億ドルで落札
国連安全保障理事会 シリアに関する全会一致の決議	国連安全保障理事会、最大300人のシリア監視員について投票へ
ウィスコンシン州のシーク教寺院で銃乱射、6人死亡	ウィスコンシン州のシーク教寺院で銃乱射、6人死亡
ハリケーン・アイザックが上陸後、内陸へ移動。	ハリケーン・アイザックがニューオリンズ近郊の海岸を直撃。
中国新聞社：シリア和平への希望はまだある	中国国営通信：シリア和平への希望はまだある
イエメン警察学校への自爆攻撃で22人死亡	au軍、ソマリア反乱軍への攻撃を強化
韓国、原子炉2基の即時停止を命令	韓国が原子力発電を強化？
ナイジェリア、航空機事故による死者193人を追悼	ナイジェリア、航空機墜落事故の調査を開始
米国と同盟国、イラン核協議への要求を設定へ	イランは核協議の前提条件を受け入れない」。
AOL、800件の特許をマイクロソフトに10億ドルで売却と発表	AOL、800件の特許をマイクロソフトに10億ドルで売却
千人隊長	女王の日のためにアムステルダムに集まる数千人の人々
中東 : イスラエル : ハマス指導者に有罪判決	中東 : イラク : キルクークで17人の囚人が逃亡
海軍ジェット機がマンションに墜落	米海軍のジェット機が団地に墜落
拒否された女性が死亡	ドーセット州で崖崩れ、女性死亡
ギリシアせんきょ	ギリシャは再選挙になるようです。
米国とトルコ、シリアの飛行禁止区域を検討	米・トルコ、シリアで連携強化
ブラザビルで爆発があり、死者数は236人に上った。	コンゴ共和国：武器庫で爆発、236人死亡
シリア人ジャーナリスト救出作戦が失敗	ホムスから密航したジャーナリスト
シークレットサービスを襲う新たな性犯罪の主張	シークレットサービスの新ルール
イラン、モスクワでの核協議が停滞する可能性を警告	イラン人、核科学者殺害を自供
モハメド・モルシーがエジプト大統領に就任した。	モハメド・モルシ、エジプト大統領に就任
RIMSHA MASHIが保釈されました。	マンデラ氏が退院
レバノンの宗派間衝突で1人死亡	イランで地震、180人が死亡
ICC、児童兵問題でコンゴの将軍を14年間収監	コンゴの戦争屋、画期的な事件で14年の刑を宣告される - ビデオ
金融株の上昇により、欧州株式は上昇。	英国のキリスト教徒、欧州裁判所に苦情を申し立てる
トルコがシリア難民に警鐘を鳴らす	トルコ、シリア難民の一部移送を模索
レバノンの宗派間衝突で1人死亡	レバノンでシリア関連の衝突があり、9人が殺害された。
フランスでアルカイダ資金供与の容疑者を逮捕	スペインでアルカイダ容疑者3人を逮捕
インドネシア・スマトラ島沖でM6.6の地震が発生、被害なし、津波なし	インドネシア・スマトラ島で5.9の地震 : USGS
IAFがガザのテロ拠点を攻撃	IAFがガザのテロ拠点を攻撃、1人死亡
イスラエル軍の空爆でガザで16人が死亡	イスラエルによる空爆でガザで4人が死亡、死者数は38人に
イラクで相次ぐ爆弾テロで18人が死亡、108人が負傷。	イラクのキルクークで自動車爆弾、9人死亡・31人負傷
パレスチナの囚人、取引によりハンガーストライキを終了。	イスラエル、パレスチナのハンスト者を解放へ
ヒズボラ、イスラエル上空で墜落した無人機の発信を確認	ヒズボラ、イスラエル上空にドローンを飛ばしたと発表
反乱軍の兵士がシリア兵を捕らえる	自由シリア軍、シリア人将校を捕獲
コロラド州銃乱射事件の容疑者は精神科医の治療を受けていた	オーロラ銃乱射事件の容疑者を治療した医師が、医師から叱責を受けた。
インドネシア・パプア州でM6.6の地震 : 米国地質調査所	インドネシア・パプア州でM6.6の地震発生 : 米国地質調査所
米上院議員、CIAに協力した医師を収監したパキスタンに罰則を科す	米国はパキスタンの医師の運命を非難する
アンディ・マレー対ロジャー・フェデラーのウィンブルドン男子決勝戦は何時ですか？ 大一番について知っておくべきこと	パラリンピックの開会式は何時？
イラン：227人が死亡した地震を受け、救援活動を強化	イラン、227人が死亡した地震を受け、救援活動を強化
アラスカ南部に津波警報が発令されました。	カナダで発生した地震による津波警報
アフガニスタン大虐殺事件で「証拠なし」。	アフガニスタンでの米軍犠牲者、2,000人に
キャッシュリッチなアップルが配当金支払い、自社株買いへ	アップル、2.65ドル/株の配当を支払い、100億ドルの株式を買い戻し
トルコ東部のPKK攻撃で兵士7人が死亡、56人が負傷。	イラクの攻撃で3人死亡、14人負傷
ニューヨークのエンパイアステートビルで銃乱射、2人死亡と報告	エンパイア・ステート・ビルディングの外で銃撃、2人死亡
オーストラリアの失業率が5.1%に上昇	フランス失業率、10％に上昇
ウォール街で株価が上昇	サンディが海岸に近づくと強まる、ウォール街は閉鎖
ハリバートン 1Qの利益は23％増加	ハリバートン第1四半期は、北米の好調な売上により増益
シリアのキプロス特使、カタールに亡命	シリア、和平合意にもかかわらずさらに軍を派遣
パキスタン北西部の神社で爆破事件が発生、4人が死亡	パキスタン北部で米軍の無人機攻撃により12人が死亡
中国株、金曜はまちまち	中国株、金曜日は安く始まる
インド、暴動後に大量のメール送信を禁止	チュニジア、暴動後、夜間外出禁止令を解除
国連監視団、シリアの「大虐殺」現場にまだ到着せず - ビデオ	国連監視団がシリアの大虐殺現場に向かう途中、銃撃を受けた。
アフガンの爆発でヨークシャー州の兵士が死亡	アフガニスタンの爆発で兵士が死亡
マリのイスラム過激派が新たな民兵を結成	マリで地元の民兵がイスラム過激派を強化
オリンピック開会式、世界中で大好評	開会式、オリンピックの幕開けを飾る
スキポール空港、爆破予告を受け一部避難	スキポール空港は、爆弾の脅威のために避難しています。
フランスでのテロ襲撃で男性が死亡	フランスの「反テロ作戦」で男性死亡
ダリの絵がギャラリーから盗まれた	ニューヨークの画廊からサルバドール・ダリの絵が持ち去られる。
カペッロ、イングランド代表監督を退任	カペッロ、イングランド代表監督を辞任
オハイオの学校で銃乱射事件、1人死亡	オハイオ州の学校で銃乱射事件、1人死亡、4人負傷
イスラエルの空爆でパレスチナ人2人死亡	IAFの空爆でパレスチナ人4人が死亡
パキスタンが米国の無人機による空爆を非難	パキスタンの車列、米軍の無人爆撃に抗議するために向かう
大型ハリケーン「サンディ」がアメリカ東海岸に上陸。	ハリケーン「サンディ」が速度を上げ、アメリカ東海岸を直撃。
サルコジ、ガダフィの資金提供の件で提訴へ	カダフィの現金請求が選挙戦に飛び火し、サルコジが提訴へ
ザ・ノート 2012年7月4日（水）の必読記事	ザ・ノート 2012年5月30日（水）の必読記事
イスラエルが攻撃すれば、イランはテルアビブを攻撃する」。	上級聖職者：イスラエルが攻撃すればイランはテルアビブを攻撃する
アナン事務総長、シリアでの暴力行為の終結を要請、公使は欠席	アナン事務総長、シリアの暴力に終止符を打つよう要請
東ティモール選挙でグスマオが政権を固める	ロムニー勝利の場合の最高裁の可能性
メキシコ大統領選、ペナ・ニエト氏が勝利：出口調査	世論調査：ロシア大統領選はプーチンが勝利する見込み
シリア、ロシアにホムスから一部軍を撤退させたと発表	シリア、軍隊の撤退を開始と発表 - ビデオ
ナイジェリア航空機墜落事故：生存者なし	ナイジェリア航空機墜落事故、犠牲者に中国人4人
mier、2012年の成長率見通しを4.2%に上方修正	cmie、2012-13年の成長率見通しを6.3%に引き下げ
ベネズエラの製油所で爆発、少なくとも39人が死亡	ベネズエラ、製油所爆発による死者を追悼
メキシコで強い地震が発生	アカプルコ付近で強い地震が発生
ロシアと中国が、シリアでの殺害に関する国連決議に拒否権を発動	ロシアと中国、国連シリア決議案に二重の拒否権
コロラド州銃乱射事件の容疑者はセラピーを受けていた	lawyers : コロラド州銃乱射事件の容疑者は精神障害者である。
自爆テロ、NATOのアフガン本部近くで4人殺害	アフガンの結婚式で自爆テロ、23人死亡
パキスタン航空機、127人乗りの墜落事故	パキスタン航空機が墜落、130人が搭乗
国連安全保障理事会、アフガニスタンのハッカーニ・ネットワークに対する国際的制裁を指示	国連、ハッカーニ・ネットワークに対する国際的制裁を命令
エルドアンとプーチンが声を荒げて話している。	ソマリアで外国人武装勢力が自動車を空爆して死亡
サウジアラビア、アルカイダと関係のある武装勢力の容疑者を逮捕	サウジアラビアが過激派容疑者を逮捕、国営メディアが報じる
ハリケーン「サンディ」がアメリカ東海岸に接近。	ハリケーン・サンディが米国東海岸を襲う
シカゴ教員ストライキ：生徒の休暇、良きにつけ悪しきにつけ	シカゴの教員ストライキは組合に試練を与える
パネッタ、2013年にアフガニスタンの役割を戦闘から移行すると発言	パネッタ：アフガニスタンがNATO会議のトピックのトップに
ロンドン証券取引所爆破計画、4人組が認める	ロンドン爆弾テロ計画、4人が認める
首相、テヘランでシリアについて明確な立場をとるよう命じられる	マンモハンがテヘランを訪問し、シリアについて態度を示すよう命じた。
イスラエルがガザ支援船への行動を予告	イスラエル、ロケット弾発射後にガザ地区を攻撃
インドネシアでのロシア機墜落事故で遺体発見	インドネシアでロシア機墜落事故、12人の遺体発見
セネタースは勝利すればプレーオフに復帰できる	メッシが4得点で勝利し、グアルディオラを送り出す
シリア、難民の帰還を促す	シリア、微妙な停戦を維持
米兵、アフガニスタンで最大16人の市民を殺害	米兵がアフガン市民を最大16人殺害する乱射事件
ルパート・マードック : 私は隠蔽工作の犠牲者だった	ルパート・マードック、2日目の尋問を受ける
バラク・オバマのボディーガードが売春スキャンダルで米国に送り返された。	バークレイズのボス、金利操作のスキャンダルで倒れる
中国人民元が対米ドルで最高値を更新（水曜	中国人民元、対米ドルで6.3103まで上昇（水曜日
南アフリ カの列車事故、少なくとも19人が死亡	南アフリ カの列車事故、26人死亡
日産自動車、ステアバイワイヤ車を販売へ	日産自動車、「インフィニティ」の一部車種にステア・バイ・ワイヤシステムを採用
チベット僧侶、中国支配への抗議で焼身自殺し死亡	中国、チベット僧が放火して死亡
ムンバイはインドで2番目に物価の高い都市	ハイテク産業の中心地バンガロールは、インドで最も住みやすい都市である：調査
19歳の男性、10代の殺人容疑で逮捕	ミーガン・リー殺人事件の容疑者として尋問された男
イスラエルがハマス司令官を殺害し、ガザの標的を爆撃。	イスラエルによる空爆でハマス司令官ら5人が死亡
アフガン攻撃の犠牲になるのは一般市民	タリバン、アフガニスタンで組織的攻撃を開始
東ティモール選挙でグスマオが政権を固める	東ティモールでのグスマオのパワーオン
国連監視団、シリアの「大虐殺」現場にまだ到着せず - ビデオ	国連監視団、シリアでの殺害現場に立ち入ることができず
ロシアと中国、シリアに関する国連決議に拒否権を行使	ロシアと中国、アラブのシリア支援策を支持する国連案に拒否権 ( ロイター )
NATO、シリアによるトルコ軍機撃墜を非難	NATO、シリアによるトルコ航空機の撃墜を強く非難
activists : シリア軍、ダマスカス近郊を襲撃	活動家、ホムスでシリア人カメラマンが殺害されたと発表
シリア反乱軍、国境近くのレバノン軍基地を攻撃 : 陸軍	トルコ軍がシリア国境付近で戦車演習を実施
中国のビル崩壊で5人死亡	土曜日、シリアで少なくとも20人が死亡
シリア軍、新たな攻撃を開始	シリア軍、アレッポ攻撃を開始
シリア人、爆発をめぐって非難合戦	イスラエル、アラブ抗議デモに備える
ガザンがイスラエルにロケット弾2発を発射、負傷者なし	ガザンが89発のロケット弾を発射、内閣は予備役の召集を承認
元ナチス強制収容所看守のデムヤンユク氏、91歳で死去	ジョン・デムジャンジュク、ナチスの死のキャンプの看守として有罪判決を受け、91歳で死去。
ボリス・ジョンソン、ロンドン市長に再選される	ジョンソン氏、ロンドン市長に再選
ブレイビク、法廷で極右の敬礼をする	ブレイヴィクに21年の判決
セカンドティーンエイジャー、殺人罪で起訴	イーステンダーズの女優ジェマ・マクラスキーの弟が、彼女の殺人容疑で起訴された。
フランスでは、殺人事件の後、新しい連続殺人犯を恐れている。	ジャージー州殺人事件裁判：犯人は「声を聞く」。
米国：マドフ兄弟、ニューヨークで詐欺罪の弁明へ	マドフ氏の弟、詐欺で有罪を認める
オランド、サルコジを破る フランス大統領選の投票結果	フランス各地で大統領選挙の投票が開始されました。
リビア政府、トリポリ空港を奪還	リビアの民兵がトリポリ空港を制圧
クリントン、ケニアに選挙暴力の代償を警告	クリントン、ケニアに選挙騒動の代償を警告
アーカンソー州最高裁判所、死刑執行法を破棄	アーカンソー州判事は死刑を無効とする。
アフリカのマンデラ元大統領が退院	マンデラ氏が退院
国連特使、シリアに関する協議のためトルコを訪問	NZ、中国への輸出を拡大
エジプト大統領選挙でイスラム主義者のモルシ氏が勝利した。	アルシャテル氏、エジプト大統領選に出馬へ
ディスコの女王、ドナ・サマー	ディスコの女王、ドナ・サマー、63歳で死去
米軍の無人偵察機、パキスタンで武装勢力5人を殺害	ダゲスタンの攻撃で6人の警察官が殺害された。
マリの将来の暫定大統領、就任に向け準備中	ローマ法王、独身主義について反体制派の司祭を非難
カイロでの最新の衝突で9人死亡、168人負傷。	アフガニスタン東部の空港で自爆テロ、10人死亡・12人負傷
テヘラン：EUの制裁はイランに核協議を強要するものではない	イラン核協議に期待薄
ポルトガルの溺死事件：英国の少女と祖父の名前が判明	イギリス人少女と祖父がポルトガルで溺死
ロムニーがメインの共和党の集会を制す	ロムニー、カムバックし、メイン州のコーカスで僅差で勝利。
バーレーンの裁判所、衛生兵の最後の集会の訴えを却下	バーレーン、活動家の控訴を棄却
ハリケーン・サンディが東海岸に接近中	ハリケーン・サンディが接近中
クリントン、シリアの友に団結を呼びかけ	造形作家、新たな才能の支援強化を訴える
JKローリング、初の成人向け小説を発表	シリア、アレッポで地上攻撃を開始
アルジェリア政府系政党が選挙で優位に立つ	アルジェリア国民投票率、44.38パーセントに達する
イエメンで治安当局者が殺害される	パキスタンの空襲で治安維持要員が死亡
米国株はギリシャの交渉で下落、リンゴは下落	ギリシャの交渉が長引く中、ウォール街で米国株が下落
ロムニー、ライアンを副大統領候補に選出 : 情報源	ロムニー、ライアンを副大統領候補に指名へ
アフガニスタンでの移行ロードマップを堅持：ラスムセン氏	ナトーヘリコプター、東アフガニスタンに不時着
ムバラク、殺人事件の裁判の評決を受ける	ムバラクの息子たちがインサイダー取引で新たな告発を受ける。
無投票投資	インド、パキスタンの投資を認める
パキスタン北西部で爆発、11人が死亡	パキスタン北西部で爆弾により19人が死亡
アフガニスタンでの活動で、5人の援助関係者が解放されました。	アフガニスタンのモスクで自爆テロ、37人死亡
アフガニスタンで2人のNATO軍兵士が殺害された。	アフガンの爆発でNATO軍兵士が死亡
ナダル、全仏オープンの決勝に進出	ナダル、7度目の全仏オープン決勝へ
ロシアのテレビがプーチン暗殺未遂を報じた。	ロシアとウクライナ、プーチン大統領殺害計画を阻止、との報道
プーチン、ロシア大統領選で勝利を宣言	プーチン、ロシア大統領選挙で勝利
イスラエル指導者、ヘブロンハウスからの入植者立ち退きを先送り	イスラエル軍、ヘブロンの家屋から入植者を排除するよう命令
政府はヒースロー空港の待ち行列に対する措置を約束	財務大臣が新税なしを約束
メキシコの洞窟で167体の遺骨が発見された。	メキシコの洞窟で167人の遺骨が発見された。
アルプス大量虐殺の遺児が英国に帰国	アルプス・アタック：少女、英国に戻る
オバマ・チーム、ディベートの賭け金を増加	オバマ、討論会でロムニーに攻勢をかける
航空機事故、ケニア閣僚2人が死亡、6人に1人	ポーランド、2010年の航空機事故で死亡した大統領を追悼
イラン、列強との核協議に臨む	米国とイラン、イスタンブールでの核協議に向け準備中
反プーチン新集会に数千人が集結	モスクワに数千人が集まり、対抗集会を開催。
シリア軍、アレッポの抗議デモで10代の少年を殺害	シリア軍、ダマスカスでデモ参加者3人を殺害-活動家ら
グーグル、モトローラ・モビリティの新CEOに就任	グーグル、モトローラ・モビリティの経営にデニス・ウッドサイドを起用
大型ハリケーン「サンディ」がアメリカ東海岸に上陸。	ハリケーン・サンディが米国東海岸を襲う
エジプト大統領、ムバラクの旧事務所に移転	エジプト次期大統領モルシ氏、政権樹立に向け始動
別のロケット弾がエシュコルを直撃、負傷者なし	ロケット弾2発がエシュコルを直撃、負傷者なし
311の悲劇に沈黙する日本	日本、台湾の震災支援に感謝
トルコに避難するシリア難民が一夜にして数千人に増加	シリア難民8000人が一晩でトルコに逃亡
アサンジ、英国最高裁に身柄引き渡しを上訴	アサンジ氏、英国最高裁に身柄引き渡しを上訴へ
パキスタンのほとんどの地域で強い地震が発生。	インドネシア東部で強い地震が発生
レバノンの武装集団、シリア危機で衝突	シリアの危機を解決するために、シリア人が保有する
シリア軍、ダマスカス近郊で35人を殺害	活動家 : シリア軍、ダマスカス近郊で数十人を殺害
暴徒がコーランを燃やした男を殺す	パキスタンの暴徒が「コーランを燃やしたから」男性を殺害
米無人機攻撃、北ワジリスターンで4人死亡	米無人機攻撃、パキスタン北西部で10人死亡 : 政府関係者
ニューヨークの画廊からサルバドール・ダリの絵が持ち去られる。	サルバドール・ダリの絵がNYで盗まれる
プーチン、ロシア大統領選で勝利を宣言	ロシアでのプーチン大統領の選挙勝利は、抗議行動で迎えられるのか？
サルコジ、再選を表明	フランスのサルコジ大統領、再選を正式に表明
米国と英国、石油の緊急備蓄を放出する協定を締結	米国と英国、石油在庫の緊急放出で合意へ
テルアビブで見つかった不審な物体は爆発物ではない	テルアビブ・バスターミナルで警察が不審物を処理
ユーロ圏の失業率は過去最高の11％にとどまる	6月のユーロ圏失業率、過去最高を記録
フランス社会党が国会で勝利	フランス社会党、議会で絶対多数を獲得
チュニジアでサラフィー・イスラム教徒と警察が衝突-目撃情報	イスラム教の2人目のハンガー・ストライカーがチュニジアの刑務所で死亡
ストロス・カーン、フランスの売春組織で捜査される	ドミニク・ストロス・カーン、フランスの売春組織で尋問を受ける
ロムニー、フロリダ州の予備選挙に勝利	ロムニー、米共和党予備選の終盤戦に注目
米無人機攻撃、北ワジリスターンで4人死亡	パキスタンで無人機による空爆の疑い、4人死亡
ナイジェリアの教会襲撃で少なくとも15人が死亡	ナイジェリアの教会で爆弾テロ、少なくとも12人が死亡
中国で2件の交通事故、47人が死亡	中国で3件の交通事故、56人が死亡
CIA長官が不倫問題で辞任	カプリヤティが殿堂入りを果たしました。
フランスのストロス・カーン氏、売春悪徳組織への関与で起訴	ストロス・カーン、売春悪徳商法で起訴
ソニー、過去最高の年間損失を計上	ソニー、過去最高の64億米ドルの年間損失を見込む
イスラエルによる空爆でガザで12人死亡	航空会社のストライキでICTU、IBECが動き出す
イラクの悲劇的な一日の後、攻撃で9人が死亡。	イラクの攻撃で19人死亡、ラマダン明け前に
バークレイズ、米国で新たな調査を受ける	バークレイズ、米国による新たな調査を受けている
米国、在シリア大使館を閉鎖 ( AP )	アルメニアの閉鎖された道路
ジャガー、英国で1,100人の雇用を創出へ	ロイヤルメール、1,000人の雇用を創出
EU、シリアに新たな制裁を発動	EU、シリア政権に新たな制裁を発動
米無人機攻撃、武装勢力8人を殺害	米無人偵察機による空爆で4人が死亡：米政府関係者
ロシア、プーチン政権に反対する集会を開催	プーチン政権に反対する数万人の集会 ( AP )
バーレーンGP、抗議デモの中、進行中	バーレーン・レース、騒乱の中、決行
中国株、月曜は横ばい	中国株、水曜はまちまちで始まる
シェリル・クロウ、良性の脳腫瘍を患っていると発表	シェリル・クロウが良性の脳腫瘍に
オバマ大統領、同性婚を支持	オバマ大統領の同性婚に関する微妙なダンス
イラク、シリア行きのイラン航空機を捜索 : 政府関係者	イラクがシリア行きのイラン航空機を捜索
アフガニスタン議会、米・アフガニスタン安全保障条約を承認	アフガニスタン議会、米国とのパートナーシップを承認
ケニア航空機事故、ドイツ人観光客2人とパイロット2人が死亡	リード上院議員、ラスベガスで自動車事故 : CNN
イスラエル、パレスチナの交渉担当者が静かに会談	イスラエルとパレスチナの交渉担当者、ヨルダンで会談
宇宙飛行士ニール・アームストロング、82歳で死去	宇宙飛行士ニール・アームストロング、死去
アムネスティ：シリア反体制派も虐待を犯している	アムネスティ調査員：シリア反体制派も虐待を犯している
ミット・ロムニー、インディアナ州の共和党予備選に勝利	ロムニー、フロリダ州の予備選挙に勝利
東ドイツの人権活動家ガウク氏が大統領に選出される	ヨアヒム・ガウク、ドイツ大統領に当選
南アフリ カ、鉱山での暴力行為の調査を開始	南アフリカ、鉱山紛争で「和平交渉」を開催
シリアで戦闘が激化、ロシアは西側に再考を促す	シリア、首都で戦闘激化、ロシアが報道
中国南部で事故、3人死亡・27人負傷	インドのボート事故で35人死亡、165人行方不明
エルドアン党、トルコ大統領選の構想を提出	エルドアン党、トルコ大統領就任を目指す
サントラム、ミネソタ州で圧勝	サントラムがカンザス州の集会を制す
ヨルダン、シリア難民のための初のテントキャンプを開設	ヨルダン、シリア人のための初の難民キャンプを開設
宇宙伝説のニール・アームストロングが死去	月面に降り立ったニール・アームストロング、82歳で死去
米国とトルコ、シリアの飛行禁止区域を検討	トルコ、米国がシリアの飛行禁止区域を検討
二人殺しで逮捕された男	麻薬捜査で逮捕されたWA男
フロリダ州の各郡が期日前投票を延長	フロリダ州、民主党が早期投票時間の延長を希望
軍艦、フォークランドへ出港	英国軍艦、フォークランドへ出港
ニューカッスル 2-0 リバプール : 試合のレポート、写真、ハイライトビデオ	QPR 1-2 ウェストハム : 試合のレポート、写真、ハイライトビデオ
パレスチナの囚人、ハンガーストライキを終了へ	パレスチナの囚人のハンスト交渉に進展があったことが報告された。
警察 : ドイツの人質事件で4人死亡	パレスチナ人：IDFの北部ストリップの攻撃で12人死亡
エジプト、ムバラク首相を大統領選に復帰させる	エジプト、ムバラク首相が大統領選に復帰することを確認
シリア人記者、首都で殺害される	米海兵隊、基地攻撃で死亡
GOP候補のロムニー氏、シリア反政府勢力の武装化を要請へ	シリアの反政府勢力に武器を提供する手助けをしている
国連監視団がシリアの大虐殺現場に到着	国連監視団、シリアの大虐殺の村に到着
個人情報保護法違反事件で出版社に無罪判決	PBS、公平性に関する新しいガイドラインを発表
アメリカン航空とパイロットが新契約に合意	ロムニー、イランの脅威に対し「イスラエルに寄り添う」と公約
ギリシャ首相、新選挙を発表へ	ギリシャ首相、5月6日の総選挙を呼びかけ
カナダ政府、変革をリードするモントリオールの女性たちを支援	カナダ政府、レジーナ市の女性の安全を支援
ムラヤム氏が第三戦線を結成しても問題ない：議会	ムラヤムが第三戦線を形成しても問題ない：ディグビジャイ
ブラッドレーがファイアストーンで優勝、フューリックは後退	バーレーン裁判所、蜂起した指導者に対する判決を支持
ガーナで飛行機事故、少なくとも10人が死亡	ガーナでの飛行機事故：国際メディアはどう報じたか
中国でグカイライの殺人事件の裁判が終わる	中国でのグ・カイライの殺人事件の裁判が終了しました。
ユーロ圏、ギリシャの救済策を支持	ユーロ圏、ギリシャの救済措置に合意
アフガンの爆弾攻撃で米軍6人が死亡	アフガニスタンでNATO軍6人死亡
シリア軍、アレッポ攻撃を開始	シリア軍、アナン平和ミッションに先立ち54人を殺害
ロムニー、オバマが医療保険制度で優位に立つために戦う	オバマ、ロムニー、未決定票を競い、支持層を刺激する
シリアの首都で2つの爆発が発生	シリアの首都で2つの爆発が発生
BBCの局長、「粗悪なジャーナリズム」で辞任	BBC局長、ニュースナイトのスキャンダルで辞任
リック・サントラムがカンザス州の集会を制す	リック・サントラムがカンザス州の集会で勝利を収めた。
イスラム教が支配するエジプトで、コプト教会が新法王を選出	エジプト・キリスト教団が新法王を選出
ハワイ復興のための米国の公約は守られていない	ハワイ復興のための米国の公約は守られていない
木曜日、中国株は高値引け	中国株、水曜はまちまちで始まる
ギリシャ、2013年予算案採決へ 抗議者ら集結	ギリシャ、2013年予算案採決へ
ロシアについて「ボールを隠していない」：オバマ大統領	オバマ大統領は、ロシアについて「ボールを隠していない」と述べた。
米欧、イランの核協議再開の提案を慎重に歓迎	米欧、イランからの核協議再開の申し出を歓迎
バラク・オバマの同性婚に関する個人的な進化	オバマ大統領、同性婚を支持
クリントン、ケニアに選挙暴力の代償を警告	クリントンはケニアに2007年の投票の混乱を繰り返すと警告している。
イングランド代表キャプテン、アンドリュー・ストラウスがプロクリケットから引退。	イングランド代表キャプテン、ストラウスがクリケットから引退。
映画に対する反米抗議運動が約20カ国に拡大	映画をめぐる反米の怒りが中東を席巻する
ロンドンオリンピック開幕を歓迎するジャーナリストたち	イスラエル代表団が2012年オリンピック開幕戦を行進
ウィキリークス、200万通のシリア向け電子メールの公開を開始	ウィキリークス、シリア関連文書を大量に公開
パレスチナ人：イスラエルによる沿岸部の空爆で、ガザの武装勢力2名が死亡。	政府関係者：ガザの男性、イスラエルの空爆で死亡 ( AP )
マリ大統領、辞表を提出	マリ大統領、正式に辞任
中国、国連決議でスリランカを支持	戦争犯罪：中国、国連決議でランカを支持
ナイジェリアの自爆テロで3人死亡	ナイジェリアの家畜市場襲撃で60人が死亡
ファクトボックス-イラクの安全保障の進展（2月1日	ファクトボックス-パキスタンにおける安全保障の進展（3月13日
HRW : ヨルダンはシリアからのパレスチナ人に偏見を持っている	ヨルダン、シリアからパレスチナ人を引き取る
イスラエル、世界有数の武器輸出国に : レポート	イスラエルが武器輸出入の上位にランクイン
エジプト人による新大統領の投票	ソマリア民主共和国、新大統領を選出へ
フェデラー、ウインブルドン7度目の優勝	フェデラー、ウインブルドン7度目の優勝
カイダ指導者がエジプトで欧米人の誘拐を呼びかけ	アルカイダ指導者が欧米人の誘拐を指示
中国株、金曜はまちまち	中国株は金曜日の昼間に高値で終了
トンアップ：テンドルカールが国際試合100勝を達成	サシン・テンドルカールが100世紀を達成 - 写真で見る
東スーダンで警察が抗議デモを鎮圧-目撃者	中国東部の化学工場に抗議する人たちを警察が取り囲む
バス事故で43人が死亡	インドで墜落事故、15人死亡
プーチン、ロシア大統領に就任	プーチン、6年後のロシア大統領に就任
中国貿易、3月に黒字化	テルアビブ南部に緊張した静けさが戻ってきた
副大統領討論会のハイライト	大統領選の討論会で注目すべき5つのポイント
B-G空港でパレスチナ支援活動家2名を逮捕	数十人の「フライティラ」活動家がパリ空港で抗議行動
full episode : nightline 6 / 29 : ケイティ・ホームズ、トム・クルーズと離婚へ。	クルーズとホームズの離婚で、親権と画像が問題になっています。
シリア政権、ホウラの大虐殺の役割を否定	シリア、ホウラで100人以上虐殺した反乱軍を非難
南スーダン、会談を前に爆撃を非難	スーダンが爆撃を非難、協議に打撃
スペインの失業率が25％を突破	米国失業率上昇、オバマ大統領に救いの手なし
パキスタンで銃乱射事件、9人死亡	ウクライナで500万人の市民が非公式の給与を得る
シリアが保障を要求、反体制派は和平計画は絶望的と指摘	シリア、兵力引き揚げに文書による保証を要求
ミネソタ州ターミナル、避難から再開	バッグによる避難の後、MINN.ターミナルは再開されました。
ゴルフ : ウェストウッドがドバイ・デザート・クラシックで首位に立つ	ドバイ・デザート・クラシックの前に立つウエストウッド
スーダンが反イスラムのフィルムでユーチューブをブロック	パキスタン首相、反イスラム映画をめぐりユーチューブでの公開停止を命令
露国大統領選の開票が行われました。	セネガル大統領選挙の投票が終了しました。
チャベス大統領、放射線治療のため再びキューバに出発	チャベス大統領、キューバで放射線治療の強化に着手
ルーマニア大統領勝利宣言	中国国家主席、デンマークへの公式訪問を終える
ロシア人、オマンコ騒動で正教会への支持を結集	ロシア正教会、批判を受けて信徒を集める
クリントン、インドに降り立ち、絆に息吹を吹き込む	クリントン、グラミン銀行を弱体化させないよう警告
マリ暫定指導者が就任	マリ臨時大統領に就任
プーチン、ロシア大統領選で勝利宣言	プーチン、ロシア大統領選に勝利
アル、シリアの暴力に改めて非難を表明	米国、シリアの暴力によりダマスカスの大使館を閉鎖
EU、アサド政権一族に制裁を発動	EU、アサド大統領夫人を制裁 迫撃砲がホムスを襲う
空軍教官、レイプの判決に直面	空軍教官への判決で女性たちが証言
30人以上の鉱山労働者が死亡	南アフリ カで30人以上の鉱山労働者が死亡
イスラエル首相、米国有権者にイラン問題を訴える	イスラエル、外交官襲撃をイランになすりつける
音楽業界がホイットニー・ヒューストンにオマージュを捧げる	音楽業界、ホイットニー・ヒューストンを追悼
アイアンドーム、ロケット弾17発を迎撃	アイアン・ドーム、ベエルシェバに向けて発射された2発のロケット弾を迎撃
マリのイスラム教徒が「ティンブクトゥの神社をさらに破壊」している。	マリのイスラム教徒がティンブクトゥの聖地をさらに破壊
中国株はPMIの影響で高く終わる	木曜日、中国株は高く始まる
先史時代の種子から花をよみがえらせる科学者たち	任天堂、赤字幅を縮小、通期見通しを引き下げ
バチカンリーク事件で有罪判決を受けた男	バトラー、「バティリークス」事件で裁判へ
ロムニー、ポール、メイン州党員集会で優勝を争う	ロムニー、メイン州集会で僅差の勝利
レバノンのトリポリで宗派間の衝突が発生。	レバノンの都市で宗派間の衝突が発生し、3人が死亡。
レプソル、YPFの国有化でアルゼンチンを非難	レプソル、石油の国有化でアルゼンチンを非難
アルゼンチンの列車事故で数人が死亡、550人が負傷。	ブエノスアイレスの列車事故、49人死亡のおそれ
アウン・サン・スー・チー氏、英国議員を前に演説	ビルマのアウン・サン・スー・チー氏、6月の訪問で国会演説
保安官：42年後に盗難車を取り戻した男性	盗難から42年後に車を取り戻した男性
GoogleのCEO、アンドロイドは重要だがクリティカルではないと発言	ラリー・ペイジは、アンドロイドは重要だが、クリティカルではないと言っています。
ムルシが大統領に就任しました。	モルシ、エジプト初の民間人大統領に就任へ
イラン、EU加盟国への石油輸出をさらに削減か	イラン議員、EUの一部の国への石油輸出を禁止する用意があると発言
パキスタンで工場火災、少なくとも260人が死亡	パキスタンでの銃撃戦で少なくとも6人が死亡
インドネシアで行方不明になった航空機の4人にオーストラリア人が含まれている。	イランの画家マンソウレ・ホセイニが死去
ロムニー、「アメリカの約束」回復を誓う	ロムニー、「アメリカ復興」を約束
サントラムの3歳の娘が入院	コニー2012」監督、入院
シリア反体制派、刑事裁判を懇願	シリアの野党指導者、米国を批判
マンデラ氏が退院	イスラエル大統領、病院から退院
サンダーランド 2-2 ボルトン : デービスのダブルプレーでトロッターズは勝ち点1を獲得したが、下位3位をキープ。	サンダーランド 2-2 ボルトン : デービーズがダブル受賞
ジャヤ・プラダがbjpに参加するようです。	ジャヤ・プラダはbjpに参加する可能性が高く、アマール・シンが彼女のために決定する。
パキスタンの自爆テロで5人死亡	パキスタンの工場で火災、120人以上死亡
ヒズボラのナスララが、反イスラムの映画について警告を発する	ヒズボラ、反イスラム映画の抗議行動をさらに呼びかけ
シリア軍、町を砲撃し、反乱軍と衝突	シリア軍と反政府勢力が沿岸地方で衝突
ナダル、ジョコビッチを下し、7度目の全仏オープン・タイトルを獲得	tennis : ナダルがジョコビッチを破り、モンテカルロ・タイトルを獲得。
保育料が6％近く上昇	育児「 年間15,000ポンドかかる。
オバマ大統領、欧州債務危機への断固たる行動を要請	オバマ大統領、欧州に危機への迅速な対応を要請
ビーフバーガーミックス、サルモネラ菌の問題でリコール	チョコパウダー、サルモネラ菌の問題でリコール
オバマ、ロムニー、最初の討論会に備える	オバマ、ロムニー、討論会準備
ケニア沖で初の大規模ガス発見	ケニアで土地の衝突が発生、38人が死亡
パキスタンで赤十字の職員が殺害される	パキスタンで誘拐された英国の援助関係者が殺害された。
CPCにて、ミット・ロムニーは保守的な資格を強調した。	CPC 2012 : 保守層との接点に苦戦するミット・ロムニー
ガザからイスラエル南部にロケット弾8発発射、負傷者なし	ガザからのロケット弾10発がイスラエル南部に命中、負傷者なし
バーレーン、葬儀後にデモ隊と警官隊が衝突	ギリシャのデモ隊と警察が衝突、救済措置が宙に浮いた状態に
アフガニスタンで米兵が発砲事件で死亡	アフガニスタンで5人のNATO軍兵士が殺害された。
エジプト大統領選挙の投票が終了しました。	プレスリリース : イエメン大統領選挙
警察はサヴィルの主張と無関係	BBC、サヴィル事件の引き抜きで質問に直面
ユーロ圏の失業率は過去最高の11％にとどまる	ユーロ圏の失業率が過去最高を記録
ジェームス・マードック、BSKYBを退社	ジェームス・マードック、BSKYBの役職を退任
代表的なSF作家レイ・ブラッドベリ、91歳で死去	伝説のSF作家レイ・ブラッドベリ、91歳で死去
エジプト大統領選挙 5月23日-24日	米大統領選2012
アフガンの自爆テロでフランス兵4人が死亡	アフガニスタン東部で外国人兵士4人が死亡
国連監視団、シリアの大虐殺の痕跡を発見	国連調査団、シリアの大虐殺を調査
AP世論調査 : 過半数が黒人に偏見を持っている	AP世論調査：過半数が黒人に対して偏見を抱いている
ap source : レッドスキンズ、2位指名でトレードへ。2位指名	レッズキンズが2位指名権をトレード
中国、2012年の国防予算は11.2％増と発表	中国の国防費、11.2％増加へ
イラクの連続爆破事件、少なくとも32人が死亡	イタリアで強い地震、少なくとも6人が死亡
エクアドルのコレア大統領、アサンジ氏の亡命について「決定していない」と発言	エクアドル、アサンジの亡命についてまだ決定していない。
アップル、セキュリティ企業のオーセンテックを3億5600万ドルで買収	ニュース要約 : アップル、オーセンテックを3億5600万ドルで買収
米国、パキスタンの武装勢力に1,000万ドルを提供	米、パキスタンの過激派幹部に1千万ドル提供
アフガニスタンのIED攻撃でNATO軍6人死亡	アフガニスタンでNATO軍6人死亡
オサマ・ビンラディンの妻が収監されることになった。	オサマ・ビンラディン主演映画、インドで撮影へ
エジプト人による画期的な大統領選挙の投票が行われました。	エジプト人、歴史的な選挙で投票へ
フライトを妨害したジェットブルーのパイロットが心神喪失を宣言、無罪に	ジェットブルーのパイロットは、フライトの混乱を引き起こしたが、無罪になった。
津波警報：パニックになる必要はない	アチェ地震に伴う津波警報
米国、バグラム刑務所をアフガニスタン当局に引き渡し	米国、バグラム刑務所をアフガニスタンの管理下に移す
ジェレミー・ハント氏、「的外れ」な顧問から距離を置く	ジェレミー・ハント、スパッド退任にしがみつく ニュース・コープ電子メール問題
オバマ大統領、米国とラテンアメリカの貿易関係を賞賛	オバマのシークレットサービスが帰国させられた
フィジーに敗れたブリッツボッケ	ブリッツボッケ、NZに敗れる
オバマとロムニー、スイングステーツに注目	チームアナ、州議会選挙への出馬を決断せず
手榴弾攻撃で1人死亡、少なくとも11人が負傷	女性への性犯罪を捜査
トゥールーズ包囲事件 : 警察が連続殺人犯と疑われる「イスラム戦士」のアパートを取り囲む	トゥールーズ銃乱射事件 : フランスは最高レベルのセキュリティ警戒態勢を敷いていた
シリアで「数十人の遺体」が発見される	船内でさらに8人の遺体を発見
ジョニー・ベアストゥとエオイン・モーガン、ムンバイでイングランド代表として輝く	ベアストウがインド遠征試合で1トン達成
風力発電所の開発者が「タービンを実際よりも小さく見せるためにカメラのトリックを使用する」方法。	風力発電所開発業者による「トリック」を使ったタービン小型化の試み
米無人偵察機、パキスタンで武装勢力6人を殺害 : 政府関係者	パキスタンで米軍のミサイルにより15人が死亡 : 政府関係者
ウィガン 3-2 ウルブス : マッチレポート、写真、ビデオハイライト	アーセナル 0-0 チェルシー : マッチレポート、写真、ビデオハイライト
英国、外国人刑務所に300万ポンドを支出	鯉の侵入に5000万ドルを費やす。
ナイジェリア : ナイジェリア軍、学生虐殺で40人死亡後、群がる	ナイジェリア、大学での大量殺人事件で警察を逮捕
神経質な人は落ち着く -- 今のところ : スペイン銀行救済への安堵感から市場は急上昇	スペインが銀行救済を受けた後、焦点はギリシャに移る。
シリアのアレッポで激しい戦闘が報告されている。	ダマスカスで激しい戦闘が報告された
フランス、ギリシャはユーロ圏への信頼性を示すべきと発言	フランスのオランド大統領、ギリシャを支持するも、信頼できる改革を要求
アベンジャーズ、興行収入記録を更新	ハンガー・ゲーム、米国での興行収入記録を更新
アフガニスタンでフランス人兵士4人が死亡したと報告される	アフガニスタンで死亡したイギリス兵
スペイン救済のジレンマはさらに深刻に	スペインのジレンマはさらに深刻に
アフガニスタンでナトー兵士が死亡	アフガニスタンで2人のAust兵士が負傷した。
中国株、水曜は安く始まる	中国株、金曜日は安く始まる
パレスチナ指導部、イスラエルのFMによるアッバス氏追放の呼びかけを非難	パレスチナ指導部、ファタハとハマスのドーハ協定を支持
ミット・ロムニー、メリーランド州の共和党予備選挙に勝利	ロムニー、メリーランド州の予備選挙で勝利
盗難にあってから42年後にebayで車を見つけた男性	テキサス州の男性が、盗難にあってから42年後に自分の車を発見。
シルベスター・スタローンの息子がハリウッドで死体で発見される。	シルベスター・スタローンの息子、セイジ・スタローン、香港で死体で発見される。
NATO : アフガニスタンの反政府武装勢力から4人の援助隊員を救出	アフガニスタンでの活動で、5人の援助関係者が解放されました。
ロシア、プッシー・ライオット・プロテストのパンクを2年間収監	ロシア裁判所がプッシー暴動裁判の判決を下す
ドイツ、第1四半期に成長し景気後退を回避	ユーロ圏、第1四半期に景気後退を回避、ドイツに感謝
イスラエル、詩をめぐりドイツ人作家グラスの訪問を禁止	イスラエル、ドイツ人作家の詩で草刈り場
2012年8月1日付のザ・ノートの必読書	ザ・ノート 2012年7月4日（水）の必読記事
アフガン市民射殺事件でNATOの米軍兵士が拘束された。	米国、アフガニスタンの民間人への銃撃に悲しみを表明
オランドがフランス大統領選挙で勝利	東ティモール大統領選挙
ランス・アームストロング、ドーピング疑惑との闘いを取り下げ	ランス・アームストロング、ドーピング疑惑との闘いに終止符を打つ
軍事 : シリアの化学物質がイスラエルを脅かす	ロシア、シリアの化学兵器による脅威を容認できないと伝える
フィッチ、フォードを投資適格に格上げ	フィッチ、フォードの信用を投資適格に回復
シリア和平案の条件「受け入れがたい」と野党が声明	シリア和平、期限切れで破談
ギリシャの投票で懸念が緩和され、アジア株が上昇	ギリシャの選挙結果を受けて原油が上昇
ギリシャ人がさらなる人員削減に抗議して衝突	ギリシャの投票間近に衝突が発生
モンブランで雪崩が発生、9人死亡、11人負傷、4人行方不明	モンブランで雪崩が発生、6人が死亡、数人が行方不明
タリバンがフェイスブックで「魅力的な女性」に変装し、スパイ活動をしている。	タリバンの兵士がフェイスブックで美女を装い、部隊の機密を入手する
中国の活動家、陳氏が米国に上陸。	中国の活動家、不公平との闘いを改めて訴える
シティルーム：エンパイア・ステート・ビルディング撮影	エンパイア・ステート・ビルディングの外で銃撃、2人死亡
モハメド・モルシーがエジプト大統領に就任した。	ムルシがエジプト大統領に就任した。
アフガニスタン南部で英兵が死亡	アフガニスタンで英兵2人が死亡
アフガニスタンのNATO基地に攻撃、15人が死亡	アフガニスタン襲撃で救助隊員を解放
イエメンの自爆テロ、無人機攻撃で少なくとも30人死亡	イラクの同時多発テロで少なくとも6人が死亡
トーレス、オリンピック招致失敗で移籍か	トーレス、4位入賞で6度目の五輪出場を逃す
オバマ大統領、中国の反体制派に沈黙	オバマ大統領、韓国DMZを訪問へ
パキスタン、ビンラディン氏の屋敷の取り壊しを開始	パキスタンがオサマ・ビンラディンの隠れ家を取り壊す
スーダン、Khartoumの武器による火災でイスラエルを非難	スーダン、イスラエルによる武器工場空爆を非難
給与税法について、上下両院で合意に達した。	交渉担当者、議会の給与税減税法案で合意に達する
フィリップ王子がロンドンで入院	英国のフィリップ王子が入院し、ジュビリーを欠席することになった。
熱帯性暴風雨アイザックは、ハワイを水浸しにし、キューバを一掃する。	熱帯性暴風雨アイザックがダムを脅かす
デスパレートな妻たち」女優のキャサリン・ヨーステンが死去	ハウスワイフ」女優のキャサリン・ヨーステンが72歳で死去
ガザのロケット弾がアシュケロン海岸に落下、けが人なし	ガザから発射されたロケット弾がスデロットの住宅を破損、けが人なし
外国人親パレスチナ活動家、西岸への入国を模索	100人の親パレスチナ人がアレンビーでイスラエル入国を目指す
アフガンの首都で自爆テロ、6人死亡	アフガニスタンのモスクで自爆テロ、37人死亡
EUや米国の景気刺激策への期待から世界の株式が上昇	株はFRB刺激策への期待で上昇
ゴア・ヴィダル氏死去、86歳 : 伝説の作家、劇作家、政治家、が死去	ゴア・ヴィダル、著名な作家、劇作家、86歳で死去
エジプトのコプト教皇、シェヌダ3世が死去	エジプト、コプト教皇シェヌダ3世を埋葬する準備を開始
ギリシャの債務処理期限を前に、世界の株価は下落。	ギリシャの債務処理期限を前にアジア株が下落
南アフリ カ警察、鉱山労働者30人を射殺	南アフリカ警察、30人以上の鉱山労働者を殺害したと発表
アイザックがハワイを濡らし、キューバ、フロリダへ向かう。	アイザック、地震で家を失った人たちとハワイに近づく
デンバー銃乱射事件：警察が容疑者宅の装置を爆破へ	コロラド州の銃乱射事件の容疑者宅で、警察が装置を爆発させる。
オバマ大統領、若年移民の強制送還ルールを緩和	米国、若者の強制送還ルールを緩和 : ナポリターノ
マイクロソフトのサーフェスは、未来への大きな賭け : アナリスト達	マイクロソフトのサーフェス・タブレットは有望だが、疑問が残る
バルジャーの恋人に8年求刑	マフィア「ホワイティ」・バルジャーの恋人に8年求刑
モーリタニア大統領、陸軍部隊に撃たれる	モーリタニア大統領銃撃事件
シリア、記者の遺体を引き渡し	政府軍が捕虜のジャーナリストを解放したとシリアのテレビ局が報道
ブレイビク裁判で男が放火	ブレイビク裁判の外で放火した男
米軍の無人機攻撃、パキスタン北西部で10人を殺害	パキスタンの米軍無人偵察機、武装勢力とみられる10人を殺害
米海兵隊9000人、沖縄から撤退へ	米海兵隊9000人、沖縄から撤収へ : 声明
トイザらス、お取り置きプログラムの手数料を無料に	ウォルマート、ホリデーレイアウェイプログラムの手数料を引き下げ
EU、イランへの新たな制裁を決定	EU、イランに対する大規模な新制裁を計画
イラン、核濃縮活動を拡大：IAEA報告書	イラン、機密性の高い核作業を強化-IAEA
ディスコの女王、ドナ・サマー、63歳で死去	ディスコの女王、ドナ・サマー
アサド、シリアで赤十字関係者と会談	アサド、赤十字の誓いを立てる
イラクの攻撃で将軍が死亡、警官4人が死亡	イラクの攻撃で将軍ら4人が死亡
イラン北西部の地震で少なくとも80人が死亡	イラン北西部の地震で180人が死亡、1,300人が負傷。
ブラジルの「ポップスター司祭」が巨大な新ステージを手に入れる	ブラジルの「ポップスター司祭」が巨大な新ステージを手に入れる
ワシントン州 : メディケア不正行為撲滅運動で100人以上が起訴される	ワシントン : アラバマ州の事件で裁判所が投票権法を支持
プーチン、ロシア大統領選で勝利を宣言	プーチン、大統領選の勝利を宣言
クリントン、オバマのために戦う覚悟	クリントン、オバマに続くタフな行為
ロムニー、ポール・ライアンを伴走者に発表	ロムニー、ライアンをGOPの伴走者に選出
ギリシャの救済措置への期待から欧州市場が上昇	欧州閣僚、ギリシャ救済を承認する構え
エドワードに1件の無罪判決、他は無効審理	エドワーズは1つの訴因で無罪となり、他の訴因では無効審理となった。
ウクライナの重量挙げ選手、4年間のドーピング禁止処分を受ける	ウクライナのコロブカに4年間のドーピング禁止命令
犯人は学校での虐殺を撮影していた可能性があります。	フランス学校銃乱射事件を撮影した犯人の可能性
香港の株価は0.28％下落。	香港株、0.62％高でスタート
検視官：ホイットニー・ヒューストン、バスタブで死亡	ホィットニー・ヒューストンが浴槽で発見されたことを検視官が確認した。
自爆テロ、アルジェリア治安維持基地を襲撃	ナイジェリアの教会を狙った自爆テロ
タイ：イラン人がイスラエル人への攻撃を計画	マレーシア、イスラエル人襲撃のイラン人を身柄引き渡しへ
イスラエル軍事裁判所、パレスチナ人ハンスト囚の控訴を棄却	イスラエル、パレスチナのハンガーストライカーと合意に達する
日本が深刻な洪水に見舞われる - 写真で見る	オクラホマ州の山火事で家屋倒壊 - 写真で見る
アベンジャーズ、興行収入記録を更新	ハンガー・ゲーム」、興行収入記録を更新
プーチン「ロシア大統領選挙で勝利する」。	プーチン、ロシア大統領選に勝利
日本、中国人を強制退去させる	ドイツの裁判所、ユーロ基金に関する判決の延期を検討
プーチン、ロシアの投票に投票する。	プーチン、ロシア大統領選挙で勝利へ
国連総長、中国に慎重な姿勢を崩さず、発言力を確保	insight : 国連事務総長、発言力を取り戻すも中国に慎重な姿勢を崩さず
シリアの一部の暴力は内戦に等しい-赤十字社	シリアの暴力は内戦と見なされる -赤十字社
リビア人による武器の引き渡しが始まった	リビアの人々が軍隊に武器を譲渡
カンタベリー大主教、ケンブリッジに転任	カンタベリー大主教、分裂の中で退任へ
パンジャブ・メール、ロータック付近で脱線、19人負傷	ハリヤナ州ロータック付近でパンジャブ・メールが脱線、19人が負傷。
ジョージ・ジマーマン、トレイボン・マーティン殺害で起訴へ	ジョージ・ジマーマン、トレイボン・マーティン事件で起訴される、と関係者が発表。
インドの反政府武装勢力、イタリア人の人質解放のために話し合いを申し出る	インド：マオイストの反政府勢力、イタリア人解放に向け交渉中
ニューヨークのエンパイアステートビルで銃乱射、2人死亡と報告	シティルーム：エンパイア・ステート・ビルディング撮影
パキスタンの自爆テロで5人死亡	パキスタンの工場で火災、少なくとも63人が死亡
ペンシルベニア州フットボール選手、制裁措置に反応	ペンシルベニア州立大学フットボール部がNCAAの制裁を受けた。
イスラエルは、長期ハンスト中のパレスチナ人を釈放するか、裁判にかけるべき	イスラエル大臣、パレスチナ指導者の退陣を要求
国連報告書、シリアの両陣営が権利の濫用を行っていると指摘	ナトーの指導者はトルコとシリアの衝突の危険性を軽視しています。
コーランを燃やした罪で起訴された少女が潜伏中	コーランを燃やした罪で起訴された少女が保釈される
マンチェスター・ユナイテッド、IPOの価格を引き下げ	マンチェスター・ユナイテッド、株価の詳細を明らかに
ロムニー、ネバダ州の集会を制す	ロムニー、コーラスを前にサントラムに焦点を移す
水浸しの夏至 : ストーンヘンジが水浸しになる	雨にも負けず、ストーンヘンジで夏至を祝う。
フランス、化学兵器使用でシリアに警告	国連、シリアの化学兵器の可能性に懸念
アメリカ中西部の暴風雨が心配されます。	米国中西部に「生命を脅かす」暴風雨のおそれ
シカゴの教員ストライキ、「枠組み」合意で終結間近	ゼネストが終了：ヒスタドルートと国庫が合意に達する
インドネシア大統領、英国訪問へ	インドネシア大統領、オーストラリア訪問へ
リビアでICC弁護士が拘束される、治安上の懸念から	リビアで拘束されたICC弁護士、45日間の拘束を受ける
暴風雨で共和党大会の開始が遅れる	嵐がフロリダを襲い、共和党大会が延期に
オハイオ州コロンバスで貨物列車が脱線、火災に。	貨物列車が脱線・爆発し、避難勧告が出される
アフガニスタンのヘリ墜落、少なくとも2人が死亡 : 軍事情報	アフガニスタンの爆弾テロで少なくとも18人が死亡 : 政府関係者
ミルズ社長は辞めるべき-講師	ジョン・エヴァンス・アタミルズ大統領は今すぐ辞任せよ -Npp ドイツ
マイアミ・ヒート、NBAファイナルに優勝	マイアミ・ヒート、NBAチャンピオンシップを獲得
日本が最後の原子炉を閉鎖する	日本、今週末に最後の原子力発電所を稼働させる
ライアンエアー、エアリンガスの新規入札に応じる	ライアンエアーの社長、報告書の内容を歓迎
ロシア空軍創立100周年記念式典	ロシア空軍創立100周年記念式典
アフガニスタンでNATO軍6人死亡	アフガニスタンで殺害されたNATO軍兵士
中国人民元、対米ドルで6.3282元まで下落	中国人民元、3日連続で対米ドルで下落
アップル ipad mini がデビュー	apple ipad mini、アジアで発売開始
ミット・ロムニーにとってのノット・スーパー・チューズデー	GOPスーパーテューズデーコンテストでロムニーがサントラムをリード。
ロシアの成長が鈍化する中、プーチン氏が就任	プーチン、6年後のロシア大統領に就任
アークール , 第一停止肺がん試験 , 株式タンク	肺がん研究の棚上げでアークルの株価が急落
衝突事故でティーンエイジャーと父親が死亡	ホラー事故で死亡した3人の名前が発表されました。
インドネシアでマグニチュード6.1の地震が発生	インドネシア・パプア州でマグニチュード6.1の地震が発生 -- USGS
アフガニスタンの騒乱が5日目に入り、米国人2人が殺害された。	アフガニスタンの混乱が続く中、2人のアメリカ人将校が殺害された。
officials : ロムニー、シークレットサービスの保護を受ける	オバマ大統領、シークレットサービスのスキャンダルに言及
日本首相、津波廃棄物処理の迅速化を要請	東日本大震災から1年を迎える日本。
ヨルダンに亡命したシリアの戦闘機パイロット	シリア首相、ヨルダンに亡命
シリア：シリア難民（2012年6月28日現在	シリア：アナン復帰に向け、70人以上が死亡
アフガニスタンで自爆テロ、16人死亡	ナイジェリアの教会で自爆テロ、12人が死亡
ハマス、ガザの囚人3人を絞首刑に	ミャンマー、囚人の釈放を発表
航空会社キャンセル ' flytilla ' 活動家 ' taへのチケット	英国航空会社、イスラエルへの異議申し立てで「フライティラ」航空券を取り消し
スペイン、銀行救済を要請	キューバ反体制派の死でスペイン人を起訴
東ティモール大統領選挙	ベネズエラ国民に大統領選の投票を呼びかける。
南シナ海の濁流	平和は南シナ海の上にある
スリランカ、パキスタンにワンデイで復活を期す	パキスタンでシニアジャーナリストが殺害される
スペースX、国際宇宙ステーションとドッキング：次は一般旅行？	スペースX、国際宇宙ステーションにドッキング
ロムニー、秘密のビデオに揺れる	ロムニー、秘密献金者の講演を録音
オバマのPBS支援を擁護する「ミリオンマペットマーチ」。	PBSへの米国の支援を守るため、100万人のマペットマーチが計画された。
シリアの野党が和解協議	シリア野党評議会、フランスに特使を設置へ
センシックス、予算難で193ポイント下落	ロムニー、予算の相違を理由に志願せず
フェイスブック、IPOの規模を25％拡大し150億ドルを調達へ	フェイスブック、IPOの規模を25％拡大
イラン、議会がアフマディネジャド大統領を問責	イラン議会、アフマディネジャド大統領に質問
イエメンの自爆攻撃、兵士7人が死亡 : 政府関係者	アフガニスタンの自動車爆弾、少なくとも7人が死亡 : 政府関係者
サンデー・タイムズのジャーナリスト、マリー・コルビンがシリアで殺害された。	サンデー・タイムズのジャーナリスト、フランス人写真家がシリアで殺害された。
KL株、午後から上昇	KL株価は午前中に下げる
シカゴの教師が厳しい契約上の争いでストライキ	シカゴ教員組合の代議員はストライキを終了させることができる。
大統領選の投票はエジプト人の両極化を招く	GOP大統領候補が南部のレースで激突
アフガニスタンでさらに3人の米兵が殺害された。	アフガニスタンで殺害されたNATO軍兵士
バス事故の死者数が8人に	ロドニー・キング死亡は事故と判定された
アフガニスタン東部で外国人兵士4人が死亡	アフガンのインサイダー攻撃で英兵2人が死亡
ユーロ圏、スペインに最大1250億ドルを融資することで合意	ユーロ圏、スペインに最大1000億ユーロの融資を決定
パキスタンで赤十字の職員が殺害される	パキスタンで誘拐された英赤十字の医師が斬首刑で発見される。
アフガニスタン、米政府、論争の的となっている夜間空襲に関する協定に調印	アフガニスタン、米国が夜間襲撃に関する協定に調印
中国鉱山事故、10人死亡	中国トラック事故、20人死亡
オーストラリアはウィンジーズでイングランドを食すことができる。	豪州首相、指導力をめぐる圧力に屈せず
シークレット・サービス、売春婦をめぐる「最大のスキャンダル」に見舞われる	シークレットサービスセックススキャンダル ' 後悔
クウェート：活動家がシリア大使館を襲撃、2人が負傷	活動家がクウェートのシリア大使館を襲撃
アウン・サン・スー・チー氏のアイルランド訪問について	アウン・サン・スー・チーの歴史的な旅を熱烈に歓迎する。
マラエ訪問は機会損失と語るキー	キーは、ワタンギのマラエ訪問の継続を望んでいる。
ノルウェーが虐殺の記念日を祝う	ノルウェー、ブレイビク虐殺の記念日を迎える
韓国経済成長率、3年ぶりの低水準に低下	韓国経済成長率、3年ぶりの低水準に低下
落下物による女性死亡	たもとを踏んだら
金利引き下げ後、オーストコリアの株価は1％上昇	RBAは再び利下げを実施
ドイツ、ギリシャに警告：改革なくして資金提供なし	ユーロ圏からギリシャへ：改革なくして救済なし
イスラエル、パレスチナのハンスト者を解放へ	イスラエルがイラン攻撃を支援する武器を米国に要求している。
オバマ大統領、銃乱射事件の犠牲者の家族に面会	オバマ大統領、バットマン銃の犠牲者に面会
オバマ、雇用統計にもかかわらずロムニーにリードを広げる : ロイター / イプソス世論調査	ロムニー、コンベンションの「バウンス」によってオバマをリード : ロイター / イプソス世論調査
ロシア、中国がシリアに関する国連決議に拒否権	ロシアと中国が、シリアでの殺害に関する国連決議に拒否権を発動
トロントで銃乱射、2人死亡、19人負傷	フィンランドで銃乱射、2人死亡・7人負傷
ローマ法王の執事が見たもの-バチカンの情報漏洩で逮捕された補佐官	ローマ法王の執事、バチカンの情報漏洩事件で逮捕
反プーチン抗議デモ、モスクワで人間の鎖を作る	反プーチンデモ隊が人間の鎖を作る
陪審員：サンダスキーは自分の運命を受け入れているようだった	ジェリー・サンダスキーに児童性的虐待の有罪判決
ワシントンの議会議事堂が980万ドルで落札される	ジョージ・ワシントンの合衆国憲法コピー、980万ドルで落札
レイカーズ、1勝4敗のスタートでマイク・ブラウン監督を解任	レイカーズ、1勝4敗のスタートでマイク・ブラウンを解雇
カナダのイスラム教徒が「名誉殺人」に反対するファトワを発布	米国とカナダのイマームが名誉の殺人に反対するファトワを発布
国連、シリア決議案採択へ	国連総会、シリア決議案採決へ
良くない始まり：ベルリンに向かうオランド航空機が雷に打たれる	オランド大統領がベルリンに向かう飛行機が落雷に遭う。
リビア首相、原案に対する抗議を受けて新内閣を組閣	リビア議会、新内閣を否決、首相を罷免
アフガニスタン東部で外国人兵士4人が死亡	アフガニスタンでフランス人兵士4人が死亡したと報告される
シリア軍、中央の町を襲撃	シリア軍がホムスを砲撃、ロシアが内戦を警告
パキスタン：イスラム教映画反対デモで20人死亡	パキスタンのイスラマバードで反イスラム映画の抗議デモ、25人が負傷
ホイットニー・ヒューストンの死因は数週間かかる可能性がある。	ホイットニー・ヒューストンさんの死について、捜査当局は答えを探っている。
韓国、南朝鮮の演習に報復を警告	北、ソウルの海兵隊訓練計画に報復を警告
A TALE OF TWO PASS : ニューヨーク・ジャイアンツはいかにしてスーパーボウルを制したか？	スーパーボウルで劣勢を挽回する
イスラエルによるガザへの新たな攻撃で1人死亡	イスラエルの新たなガザ攻撃で2人死亡：医療関係者
ドイツ、シリア危機でロシアに圧力をかける可能性が高い	ロシアはシリアについて何を考えているのか？
国連支援責任者アモス、赤色三日月でババアム入り	赤十字社、シリアの包囲されたババアムルは砂漠化したと発表
ナイジェリアの暴動で数十人が死亡	ケニアでの衝突で数十人が死亡
エジプト主要大統領候補者プロファイル	エジプト大統領選挙二日目
俳優のガザーラさんが死去、81歳	俳優ベン・ガザーラが死去、81歳
イギリスのゴールドラッシュは、コストに対する不満を黙らせる。	アフガンのインサイダー攻撃で英兵2人が死亡
雪崩で少なくとも100人のパキスタン人兵士が埋まる	雪崩で100人以上のパキスタン人兵士が埋まる
インフレ率、15ヶ月ぶりの低水準に：アナリストの見解	インフレ率、15ヶ月ぶりの低水準に
コーマンは計画的養子縁組の資金を削減しない	スーザン・G・コーメン、プランド・ペアレンソッドへの資金提供削減をめぐりUターン
為替と金 25 8月 2012	為替と金 19 july 2012
アフガニスタン議会、主要閣僚の更迭を決議	アフガニスタン議会、主要閣僚の解任を決議
イラン、国連核協議の継続を表明	イラン、国連との核協議は「建設的」とコメント
アグリビジネス : カリフォルニアで狂牛病が発見される	USDA、カリフォルニア州で狂牛病の患者を確認
BP、メキシコ湾の一部資産を55億5,000万ドルで売却	BP、メキシコ湾の資産を55億5千万ドルでプレインズに売却
ジミー・サヴィル氏の潜在的被害者300人：警察	英国：サヴィル氏による虐待の被害者候補300人が浮かび上がる
ロムニー、資金調達でオバマではなくライバルをリード	ロムニー : 私は1999年にベインの経営から撤退しました。
アームストロング、ライブストロングを退任	アームストロング、ライブストロングから降板
米無人機攻撃、パキスタンで武装勢力5人を殺害	米軍の無人機攻撃、イエメンの武装勢力容疑者16人を殺害
9 / 11 グアンタナモの公聴会で裁判官を無視する被告人たち	7月.11人の被告が公聴会で家族を激怒させる
シリア政府は攻撃を止めない	シリアの野党が「大虐殺」を報告
中国株は金曜日の昼間に高値で終了	中国株は金曜日昼間に高くなる
ミャンマー：野党がスーチー氏の勝利を主張	ミャンマーの有権者、スー・チー党の勝利に期待
オバマの世論調査が低下し、共和党のライバルを後押ししている。	オバマのヒスパニック系大勝利が共和党を悩ませる
アフガニスタンで2人のAust兵士が負傷した。	アフガニスタン東部で外国人兵士4人が死亡
アフガニスタンの制服を着た犯人が、NATO軍2人を殺害	アフガン軍の制服を着た男がNATO軍兵士を殺害
シリアの新野党党首は無条件で援助を望んでいる	イスラエルが威嚇射撃、シリアの反対派が結束
安価なジェネリック医薬品はインドの最貧困層のための万能薬ではない	インドの最貧困層には安価な抗がん剤では治療できない
エジプト人による初の大統領選出投票	エジプト人は重要な大統領投票の結果を待っている。
南アフリ カの鉱山で衝突、少なくとも30人が死亡	南アフリ カの列車事故、26人死亡
シリア軍がホムスを砲撃、ロシアが内戦を警告	シリア軍がホムスを空爆、ラブロフが会談のため来日
エジプト大統領選の結果延期	エジプト選挙結果延期
イランへの新たな制裁措置がないまま、期限が過ぎました	EU、新たなイラン制裁に近づく
逮捕されたロシア人殺人鬼、プッシー騒動との関係を否定	ロシアのテレビ塔への抗議で数十人が逮捕された。
ノルウェー・メモリアル、77人の虐殺犠牲者を追悼	ノルウェーが虐殺の記念日を祝う
ペトレイアス疑惑に関連する米アフガニスタン軍将官	ペトレイアススキャンダルに関連する米軍高官
モルディブ元大統領に「逮捕状」。	モルディブ裁判所、前大統領の逮捕状を発行
HRW : ヨルダンはシリアからのパレスチナ難民を追い返している。	レポート：ヨルダン、シリアからパレスチナ人を偏在させる
韓国、原子炉建設に「重要な」進展 - IAEA	韓国、核抑止力の拡大を宣言
モルディブ大統領、警察官の反乱で辞任 抗議行動も	モルディブ大統領、数週間の抗議活動の末に退任
アフガニスタンでNATOの空爆、市民を殺害	アフガニスタンで2人のNATO軍兵士が殺害された。
アルカイダ、アビヤンの戦闘でイエメン人兵士70人を捕獲と発表	イエメンでアルカイダと衝突、爆発で兵士35人死亡
海軍のジェット機が米国のアパートに墜落、パイロットは脱出。	米海軍のジェット機がバージニア州のマンションに墜落
水曜日の中国株は高く始まる	米国株はGDP未達成にもかかわらず、高く始まる
イスラエル中央部にアイアンドドームを配備するIDF	中央平原に大雪が降る
パキスタンで米軍の無人機攻撃、4人死亡	米軍の無人機攻撃でパキスタンにて3人死亡
シカゴの「ジハード」自動車爆弾計画で米青年を拘束	シカゴの自動車爆弾計画でシカゴの若者を逮捕
pc David Rathband : 双子の兄の「最良の友」に対する恐れ。	デイヴィッド・ミリバンド : 私の兄と古い労働党への回帰
シリア軍、アレッポを奪還へ	シリア政権、アレッポ市を奪還へ
20名の国会議員団、インドへ出発	商務長官が休暇を取る
スライ・スタローン「ソーン・サージ」がラオスで死体で発見される。	シルベスター・スタローンの息子が自宅で死亡しているのが発見された。
ウォール街	ウォール街は混戦模様
クリントン：米国と欧州は、暴君に対してもっと努力しなければならない。	クリントン：米国と欧州は、暴君を倒すために協力しなければならない。
中国の景気刺激策を受け、欧州株が反発	原油価格、景気刺激策への期待で上昇
シリア軍、反政府勢力の拠点を制圧	シリア軍、北部の反政府勢力の拠点を奪取
株価指数先物 安値スタート	株価指数先物
mpが攻撃され負傷し、男性が起訴されました。	平屋建て殺人容疑
中国株は金曜日の昼間に高値で終了	中国株、金曜日は安く始まる
ノキア、「偽造」広告を謝罪	米国はパキスタン支援のためのライダーを免除した
米無人機攻撃、パキスタンで武装勢力5人を殺害	パキスタンで無人機による爆撃が行われ、武装勢力と思われる4人が殺害された。
シリア反乱軍、包囲されたホムスを去る	シリア反乱軍、包囲されたホムス地区から撤退
米国、チュニジアとスーダンの非重要人員に退避命令	米国、チュニジアとスーダンの非重要人員の退避を命令
エジプトのムバラクが批判される	エジプトのムバラクが重体
北東部を襲う巨大な砂嵐、少なくとも18人が死亡、7.4百万人が停電。	米国東部の嵐により、バージニア州で2人が死亡。200万人が停電
ロムニー、オバマ、税と経済で初の討論会	オバマとロムニーが最初の討論の舞台に立つ
アサド、シリア騒乱の背後には傭兵がいると発言	アサド、シリア蜂起を煽ったとして米国を非難
プーチン、ロシア大統領選で勝利宣言	ロシア選挙への不満が高まる
しゅうぎいんかいさん	イランと世界の国々が核協議へ
イスラエルの新たなガザ攻撃で2人死亡：医療関係者	ガザ攻撃で5人死亡、武装勢力はイスラエルに砲撃
海軍ジェット機がバージニア州の建物に墜落、6人負傷	海軍ジェット機がバージニア州のアパートに墜落、9人が負傷。
南アフガニスタンでNATO軍兵士1人死亡	アフガニスタン南部で英兵が死亡
スペインの失業率が過去最高を記録	スペインの失業保険申請件数が過去最高を記録
道路脇の爆弾、アフガン市民10人を殺害 : 警察	路側爆弾、アフガン警官5人を殺害
トルコ、国境付近でジェット機を発進させる	トルコ、シリア国境にジェット機を派遣
最高裁判所、投票権法に関する裁判を審理	最高裁が企業の人権問題を審理
国連が土地を監視した後、シリアの暴力で2人死亡	コンタドールに2年間のドーピング禁止令
ホワイトハウスサイエンスフェアーでの大統領挨拶	ザ・プレジデンシャル・プランナー - ホワイトハウス・サイエンス・フェア
民間人、脱北者がシリアで殺害されたとNGOが発表した。	シリアの武装勢力、3人のシリア人将校を殺害 : NGO
マラウイ、大統領の死去を確認	マラウイ、ムタリカ大統領の死去を確認
台湾で強い地震が発生	中国、双子の地震に揺れる
イングランド銀行のポール・タッカー氏、リボール事件で汚名返上	イングランド銀行副総裁、金利不正操作の指示を否定
リビア、下院選挙を7月7日に延期	リビア、画期的な選挙を7月7日に延期
赤十字、シリアでの戦闘停止を交渉して援助を受けると発表	赤十字、援助物資を届けるためシリアの停戦を交渉中
シリア軍、バスに乗った市民を銃撃	シリア軍と反体制派がトルコ近郊で衝突
ドイツ議会、ギリシャの救済策を圧倒的多数で支持	ドイツ議会、ギリシャ救済策を支持
シリアで爆撃と衝突が続く	シリアの反体制派が武器を求め、爆撃や衝突が発生
2012年ロンドン五輪開会式「緑豊かで快適な大地をフィーチャーする	2012年ロンドンオリンピック：開会式は「緑豊かで快適な土地」になるとダニー・ボイルが語る。
ビルマの改革で米国の制裁が緩和される	ビルマの活動家、制裁緩和を急げと発言
ウサイン・ボルトが200mで優勝 - スティーブン・ハワードの反応	フェイスブックのモバイル化が収益拡大に貢献：反応
タリバンのリゾート攻撃で数十人死亡	インド警察は大使館襲撃のイラン人3名を指名した」。
世論調査を前にしたシリア東部での激しい戦闘	シリア東部で激しい戦闘が発生-住民
中国人民元、対米ドルで6.3282元まで下落	木曜日、中国人民元は対米ドルで6.2697まで後退
キリスト教学校での銃乱射事件で7人死亡	オハイオ州の学校での銃乱射事件で5人が負傷
インドネシア反テロ部隊、武装勢力容疑者2人を殺害	インドネシア、バリ島で警察が武装勢力容疑者を射殺
アメリカ大統領選挙：ミット・ロムニー氏が敗北を認め、バラク・オバマ氏が2期目の勝利を収めました。	ロムニー、電話でオバマに選挙を譲る
アーメニア人による国会議員選挙の投票	アルメニア、議会投票は大統領への試練
パキスタン、反イスラム的な内容でツイッターをブロック	パキスタン、「冒涜」問題でツイッターをブロック
アナン首相、火曜日、トルコのシリア難民を訪問	アナン首相、イランの前にトルコのシリア難民を訪問へ
ベネズエラのチャベス大統領、3度目の抗がん剤治療のためキューバへ	ベネズエラ指導者、治療のためキューバに戻る
サチン・テンドルカール、インドの上院議員に就任	サチン・テンドルカール議員、政府専用住宅に否定的
ガザ周辺住民に避難所にとどまるよう指示	最高の一日、ウェスト・インディーズに歓声が上がる
海軍ジェット機がマンションに墜落	米海軍のジェット機がバージニア州のマンションに墜落
ロムニー、プエルトリコの予備選挙で大勝利	ロムニー、イリノイ州の予備選挙で勝利
ヤフー、グーグルのメイヤー氏をCEOに指名へ : レポート	ヤフー、グーグル幹部のメイヤーをCEOに指名
アフガンの大虐殺で起訴された米兵が著名な刑事弁護士を起用	アフガン市民殺害の罪に問われた米兵の身元が判明
イタリア北部でマグニチュード6.0の地震が発生 : Usgs	インドネシア・スンダ海峡でマグニチュード5.9の地震が発生 : USGS
米政府、ハッカーニ・ネットワークをテロリストとして公式に指定	米国、ハッカーニ・ネットワークをテロリストに指定
motor racing : F1初練習でボタンが最速タイムを記録	ボタンが初練習でベストタイムを誇る
レンジャーが3部リーグに選出された	レンジャーが3部リーグに投票
シリア、停戦のオブザーバーに呼びかけ	シリアの停戦は不安な静けさをもたらす
ニューアーク市長、隣人を火事から救う	ニューアーク市長、燃え盛る家から隣人を救出
スパーズがレイカーズにリベンジし、西地区をリード。	イスラエル人を誘拐して囚人を解放せよとガザの指導者が言っている。
バーレーンでF1が抗議デモ	バーレーンでの怒りの一日
ニューヨーク証券取引所、水曜営業再開	dealbook : 証券取引所、開場準備
7月の中国CPI成長率は1.8%に減速	中国、7月の工業生産高の伸びが9.2％に鈍化
ホムスで迫撃砲、105人死亡	ホムス攻撃で200人死亡
オハイオ州の銃乱射事件で死亡した学生を数百人が追悼	オハイオ州の銃乱射事件の犠牲者の葬儀が行われる
タイ南部の爆弾で5人死亡、50人負傷	タイの爆弾で14人死亡、340人負傷
米議員、イラン新制裁に次の一歩を踏み出す	ソマリアの議員、新大統領選に投票へ
バラク・オバマは、米国が「必要以上の核兵器」を保有していることを認めている。	フランス人ガンマン、「武器を手にして死にたい」。
エシュコル地域でロケット弾2発が命中、負傷者なし	エシュコル地方議会で20分間に10回のロケット弾発射
コンゴ民主共和国の反政府勢力がパークレンジャーを殺害	コンゴ東部で反政府勢力がパークレンジャー2人を殺害
パキスタン軍9名が武装勢力の待ち伏せにより死亡	貿易：パキスタンとインド、一歩進んだ貿易で合意
エジプト・サッカー暴力事件で74人死亡	エジプト・サッカー場襲撃事件で少なくとも73人が死亡
ナイジェリアの騒乱、少なくとも95人が死亡	中国南西部で地震、少なくとも50人が死亡
ハリケーン「サンディ」がジャマイカ南東部に上陸 : NHC	ハリケーン・サンディがジャマイカに到達
ガザの武装勢力、イスラエルにロケット弾40発を発射、3人が負傷 : 警察	ガザンがイスラエルにロケット弾4発を発射、負傷者なし
エルケイブ首相との会談を終えての発言	玄葉光一郎外務大臣との会談。
イラク、米国が指名手配中のヒズボラ活動家容疑者を釈放。	イラク、ヒズボラ工作員を解放と発表
パキスタン首相、雪崩で軍人が犠牲になったことに衝撃を受ける	パキスタン雪崩：埋まった兵士を探す救助隊員たち
バリック、アフリカの資産に関して中国企業と交渉中	オバマ大統領補佐官、中国で会談 シリア拒否後に
