ハードハットをかぶった男が踊っている。	ハードハットをかぶった男が踊っている。
飛行機が離陸する。	飛行機が離陸する。
幼い子供が馬に乗っている。	子供が馬に乗っている。
男が蛇にネズミを食べさせている。	男は蛇にネズミを食べさせている。
男が大きな笛を吹いている。	男がフルートを吹いている
ピザに細切れのチーズをのせている人。	焼いていないピザにシュレッドチーズをのせている人。
三人の男がチェスをする。	二人の男がチェスをする。
女性がギターを弾いている。	男がギターを弾いている。
女性がフルートを演奏しています。	男がフルートを吹いている
男がチェロを弾いている。	座っている人がチェロを弾いています。
女性が玉ねぎを切っているところ。	男が玉ねぎを切っている
何人かが戦っている。	二人の男が戦っている．
男はピアノを弾いている。	男がギターを弾いている。
男がギターを弾きながら歌っている。	アコースティックギターを弾きながら歌う女性。
男が黒板を消している。	男は黒板を消している。
猫を天井に投げている人。	天井に猫を投げつける。
男は棒でもう一人の男を殴った。	その男は棒で相手を叩いた。
カンガルーの赤ちゃんを抱き上げる女性。	女性がカンガルーの赤ちゃんを抱いている。
男がフルートを吹いている	男が竹の笛を吹いている。
人が紙を折っている	誰かが紙を折っています。
男が道路を走っている。	パンダ犬が道路を走っている。
犬が背中からベーコンを取ろうとしている。	犬が背中のベーコンを食べようとしている。
女性が男の子を身ごもっている	女性が赤ん坊を抱いている。
少女が髪を結っているところ。	女の子が髪をとかしているところ。
雪の上を滑るシロクマ。	シロクマが雪の上を滑っている。
女性が書いている.	女が泳いでいる
3人の男がギターを弾いている。	ステージでギターを弾く3人の男たち。
猫が赤ん坊の顔をこすっている。	猫が赤ちゃんに擦り寄っている。
男は馬に乗っている。	男が馬に乗っている
男が鍋に油を注ぐ	男は鍋にワインを注ぐ
男がギターを弾いている。	女の子がギターを弾いている。
パンダが滑り台を滑っています。	パンダがすべり台をすべる。
浜辺でサッカーをする男たち。	浜辺でサッカーをしている少年たち。
女性が何かを食べている	女性が肉を食べている
女がジャガイモの皮をむく.	女性がジャガイモの皮をむいているところ。
女がジャガイモの皮をむく.	女性がジャガイモの皮をむいているところ。
少年は自転車から落ちました。	少年が自転車から落ちる。
男がギターを弾いている。	男がフルートを吹いている
女性がフルートを演奏しています。	女性がフルートを吹いています。
クーガーはクマを追いかけている。	クーガーがクマを追っている
ウサギはワシから逃げている	ウサギがワシから逃げている。
男は斧で木を切り倒した。	斧で木を切り倒す．
女性がパン粉をつけたポークチョップを揚げているところ。	女性がパン粉をつけたポークチョップを調理しているところ。
一人の女性が他の女性の足首を測っている．	女性が他の女性の足首を測定する。
少女が凧をあげている。	走る少女が凧をあげている。
機械仕掛けの牛に乗っている男。	男は機械仕掛けの牛に乗った。
男がギターを弾いている。	男がギターを弾いている。
男がギターを弾いている。	男がギターを弾いている。
女性が他の女性と一緒に踊り、歌っている。	雨の中で女性が踊りながら歌っている。
男が何かを発見している。	女性が何かを切っている
男がパンを切っている。	男が玉ねぎを切っている
男が鍋に油を注いでいる。	男がスキレットに油を注いでいる。
ライオンが人と遊んでいる。	ライオンが二人の男と遊んでいる。
犬がスケートボードに乗る	犬がスケートボードに乗っている。
誰かが像を彫っている。	男が彫像を彫っている。
女性がタマネギを切っているところ。	男が玉ねぎを切っている
女がエビを剥く	女性がエビの殻をむいているところ。
女性が魚を揚げています。	女性が魚を料理している。
その少女はマイクに向かって歌った。	をマイクで歌った。
女性がエレキギターを弾いている。	女性がギターを弾いている。
虎の赤ちゃんがボールで遊んでいます。	赤ちゃんがお人形で遊んでいます。
男がキュウリを切っている。	男がキュウリを切っている。
男がハープを弾いている。	キーボードを演奏している人
ロープを登っている人	ロープを登る男...
男がピアノを弾いている。	女性がヴァイオリンを弾いている。
女性がフルートを演奏しています。	男がギターを弾いている。
ジャガイモを切っているところ	ニンジンを切っている人
子供がギターを弾いている。	少年がギターを弾いている。
少年がギターを弾いている。	男がギターを弾いている。
男がギターを弾いている。	少年がギターを弾いている。
女性が玉ねぎを切っているところ。	女性が豆腐を切っているところ。
小さな男の子がキーボードを弾いています。	少年がキーボードを演奏している。
電動アシスト自転車に乗っている人。	自転車に乗っている人
男がギターを弾いている。	男がエレキギターを弾いている。
犬が赤ん坊をなめる	犬が赤ん坊をなめている
女性がタマネギを切っているところ。	男が玉ねぎを切っている
男がギターを弾いている。	男がドラムを叩いている。
男がドラムを叩いている。	男がギターを弾いている。
女性がピーマンを切っているところ。	女性がピーマンを切っているところ。
男がドラムを叩いている。	男が太鼓を叩く...
女が馬に乗る	女性が馬に乗っている。
木のそばでバナナを食べている男。	男がバナナを食べている。
猫がキーボードを叩いている。	男が2台のキーボードを弾いている。
某氏の発言	男が唾を吐いている
斧で木を切り倒す．	斧で木を切る男。
子供がおもちゃの携帯電話で遊んでいる。	携帯電話のおもちゃで遊ぶ少年。
女性が卵を焼いているところ。	女が料理をしている
男がギターを弾いている。	女性がギターを弾いています。
バイクに乗った男がいる。	男が馬に乗る
バイクに乗った男がいる。	男が馬に乗る
男がギターを弾いている。	男がトランペットを吹いている
男がギターを弾いている。	男がトランペットを吹いている
男がギターを弾いている。	男がトランペットを吹いている
動物が何かをかじっている．	動物がキーホルダーをかじっている。
男が玉ねぎを切っている	某氏が玉ねぎを切る
男女がキスをしている。	男と女のキス
男が車に乗り込もうとする。	ガレージで車に乗り込む男。
自転車操業	某氏が話しています。
男が踊っている	某氏が話しています。
男がギターを弾きながら歌っている。	男がギターを弾いている。
キノコを切っている人。	ナイフでキノコを切っているところ。
男が魚を切り開いている	某氏が魚を捌いているところ．
虎の子が鳴いている。	虎が歩き回っている。
男がピアノを弾いている。	男がトランペットを吹いている
女性がジャガイモの皮をむいているところ。	女性がリンゴの皮をむいているところ。
パンクダが竹を食べている。	パンダが竹を食べているところ。
猿が猿を押す	猿がもう一匹の猿を押した。
少年が歌い、ピアノを弾いている。	男の子がピアノを弾いています。
犬がスイカを食べている。	犬がスイカを食べている。
女性がブロッコリーを切っているところ。	女性が包丁でブロッコリーを切っている。
ジャガイモの皮をむいている人。	男がジャガイモの皮をむいた。
女性がギターを弾いている。	男がギターを弾く...
男がフルートを吹いている	男がギターを弾いている。
トマトを切っている人	男がパンを切っている。
男は水中を泳ぐ．	女性が水中を泳いでいる。
男女が話している。	男と女が食事をしている。
男がギターを弾いている。	キーボードを演奏している人
パンダの赤ちゃんがすべり台を滑る。	パンダがすべり台をすべる。
ヨガボールを追いかける小型犬。	犬がボールを追いかけている。
男たちはクリケットに興じている。	男子はバスケットボールをやっています。
バイクで走り出す男。	バイクに乗った男がいる。
男がギターを弾いている。	男が歌い、ギターを弾いている。
その人は電話で話していた。	男は電話で話している。
男が歌い、ギターを弾いている。	男がギターを弾いている。
男が浮いている。	某氏が話しています。
男が女を襲う	男から女へのビンタ
二人の少年が運転している。	2つのベイが踊っている。
男が車を運転している。	男が馬に乗る
サッカーをしている人。	男がフルートを吹いている。
男が馬に乗っている	少女が馬に乗っている。
自転車に乗っている人	猿が自転車に乗っている。
ジャガイモを切っている人。	女性がジャガイモの皮をむいているところ。
女性がジャガイモの皮をむいているところ。	ジャガイモを切っている人。
男がギターを弾いている。	ギターを弾いているのはsomeoenさんです。
女性が豆腐を切っているところ。	女性が玉ねぎを切っているところ。
少女が馬に乗っている。	少女が自転車に乗っている。
女性がネギを切っているところ。	女性が生姜を切っているところ。
男は紙皿を切った。	紙皿を切っている人
女性がヘアスタイルを整えているところ。	女性がハーブを切っているところ。
男がギターを弾いている。	男がフルートを吹いている
男がピアノを弾いている。	男はバイオリンを弾いている。
ガレージでウェイトリフティングをする男性。	男が重量挙げをしている。
女性が肉を切っているところ。	女性が肉にパン粉を塗っているところ。
キーボードで演奏している人	キーボード・ピアノを弾いている人。
二匹のシマウマが野原で遊んでいる．	二匹のシマウマが野原で遊んでいる。
ネギを刻んでくれました。	ネギを切ってくれた。
水中に麺を浮かべている人がいます。	女性が麺を茹でているところ。
動物が人の指を噛んでいる。	スローロリスが人の指を噛んでいる。
ライオネル・リッチーは天井で踊っています。	ライオネル・リッチーは、天井に立ちながら踊る。
男がピアノを弾いている。	ピアノを弾いている人
ジャガイモを切っているところ	ジャガイモを切っている人。
女性がフルートを吹いています。	女性がフルートで演奏しています。
男の子がカレンダーをチェックしています。	少年がカレンダーを見ている。
女性が玉ねぎを切っているところ。	女性が玉ねぎを切っているところ。
男がギターを弾いている。	男がギターを弾く...
女性がミシンを使っているところ。	女性がミシンをかけているところ。
パンケーキを焼く女性。	アニメのシェフがパンケーキをひっくり返しているところ。
男が玉ねぎを切っている	女性がカボチャを切っているところ。
男が踊っている	男女が踊っている。
バイクに乗った男がいる。	女性が馬に乗っている。
男が道路を走っている。	車が道路を走っている．
女性が読んでいる.	女性がパン生地をこねている。
女性がニンニクを切っているところ。	女性がタマネギを切っているところ。
男が馬に乗っている	男性が携帯電話で話している。
男が自転車に乗っている。	男が馬に乗っている
男が泣いている	女が踊っている
男がピアノを弾いている。	男がフルートを吹いている
男がフルートを吹いている	男がピアノを弾いている。
某氏の発言	男が料理をしている。
某氏が回転している	男が踊っている
小さな男の子が歌いながらギターを弾いています。	男が歌い、ギターを弾いている。
猿が手から手へ振り回されている。	猿が木から木へと揺られている。
人々は列車を降りた。	人々は駅で列車を降りた。
その女性は、ボウルに卵を割り入れました。	男はボウルに卵を割っている。
犬がトランポリンでジャンプしている。	犬がトランポリンで跳ねる。
男の子が楽器を演奏しています。	男がトランペットを吹いている
バンドがステージで演奏している。	バンドがステージで演奏している。
女性がギターを弾く...	男が歌い、ギターを弾く。
女性が缶を選んでいるところ。	女性がトマトを切っているところ。
男が車を持ち上げている。	壁を登っている人。
象が道を歩いている。	象の群れが道を歩いている。
男女がジープで通りを走っている。	男女がオープンエアーの車で道路を走っている。
シャツのない男が椅子に座った。	シャツのない男が椅子に腰掛けている。
亀が水の中を泳いでいる。	亀が水中を歩いている。
女性2人がレスリングをしている。	二人の女性が床でレスリングをしている。
子犬は青いテニスボールで遊びました。	子犬がテニスボールで遊んでいます。
猫がピアノを弾いている。	男がギターを弾いている。
その男はナイフでカーペットを切った。	男がナイフでカーペットを切っている。
女性がスクーターで道路を走っている。	スクーターに乗っている男性。
女が踊っている	某氏が話しています。
男がギターを弾いている。	男がギターを弾く...
犬が赤ん坊のヨダレをなめる。	犬が赤ん坊をなめる
某氏が舟を漕いでいる。	トマトを切っている人
若い女性が顔中にステッカーを貼っている。	顔にシールを貼っている女性。
じゃがいもを切っている人	ジャガイモを切る人.
床に座ってギターを弾く男。	部屋の中で床に座ってギターを弾いている男......。
女性がニンニクを刻んでいるところ。	女性がニンニクを切っているところ。
子犬がプラスチック容器で遊んでいる。	犬がプラスチックの容器で遊んでいます。
動物が円を描くように走る。	リスは円を描いて走る
ロープの橋をゆっくりと歩いて渡る男。	少年が橋を渡っている。
男がギターを弾いている。	部屋の中でギターを弾いている男性。
某氏がフルートを吹く	男がフルートを吹いている
ヴァイオリンを弾く男...	ヴァイオリンを弾いている人
ピアノを弾く人	男がピアノを弾いている。
人が食べ物を食べている	人が何かを食べている
女性がガラスのボウルに卵を2つ割る。	女性が卵を割っているところ。
バスケットボールをする人。	男がピアノを弾いている。
人が魚を切っている	魚のはらわたを抜く
二人の男が車のトランクにスーツケースを詰め込んでいる。	男たちはスーツケースを車のトランクに入れている。
幼児が廊下を歩いている．	少女が廊下を歩いている。
トマトにオイルをかける男。	男は切ったトマトにオイルをかけた。
男が何かを切っている	男がパンを切っている。
飛行機が着陸する。	飛行機が着陸するアニメ。
女性が豆腐を包んでいるところ。	女性が生地を丸めている。
男がカヌーを漕いでいる。	男がハープを弾いている。
男女が一緒に森の中を歩いている。	男女が腕を組んで森の中を歩いている。
猫がトウモロコシを食べている。	猫がとうもろこしを食べている。
女性はカンガルーを拾った。	女性がカンガルーの赤ん坊を抱き上げる。
魚が泳いでいる。	魚が泳いでいる
女性二人がフードプロセッサーで何かを混ぜる．	ミキサーで何かを作る二人の女性。
パンダが登っている。	ロープを登っている人
男がギターを弾いている。	男が標的を刺している
ある男がバンドでフルートを吹いている。	男がギターを弾いている。
男はパンにバターを塗った。	男がパンにバターを塗っている。
麺を茹でているところ。	女性が麺を茹でているところ。
丘の上で踊る一団。	一群の人々が踊っている。
男がギターを弾いている。	パスタを食べてる人
男が外で踊っている。	男がフルートを吹いている。
女が男を養う	女性が肉を混ぜているところ。
男が鍋をオーブンに入れる。	女性が玉ねぎを切っているところ。
男が水の入った鍋を蹴っている。	男が花を摘んでいる。
女性がデスクに座っている。	女性がロバに乗っている。
ストレッチャーで患者を搬送する医療関係者	医師が患者を担架に乗せ、急がせる。
パイプをはさみで切っている人。	男がナイフでカーペットを切っている。
女性がステージでフルートを吹いている。	女性がフルートを演奏しています。
雨の中で女が踊っている。	雨の中で踊る女。
2匹のパンダの赤ちゃんが遊んでいます。	2匹のパンダが一緒に寝ています。
子供たちはステージで踊っています。	ステージで踊っている人もいます。
赤ちゃんが笑っています。	赤ちゃんは笑っています。
男がギターを弾いている。	男の子がピアノを弾いています。
女性がお風呂に入っているところ。	女性が馬に乗っている。
男が紙を折っている。	女性がピーマンを切っているところ。
3人の女性が踊っています。	男が踊っている。
男がギターを弾く...	ピアノを弾く人
猫たちが遊んでいる。	二匹の猫が喧嘩している。
女性が肉を切っているところ。	女性がステージで歌っている。
女性が写真を撮っているところ。	男がギターを弾いている。
男が鍋で野菜を混ぜる	鍋の中の野菜をかき混ぜている人。
某氏が走っています。	ある男が道路を走っている。
女性は生地を転がしている。	女性が小麦粉をつけ、生地を丸めているところ。
女性が肉にスパイスを加えているところ。	女性は肉に砂糖を加えている。
女性が魚に油を注いでいる。	女性が魚に水をかけている。
少年がギターを抱えている。	小さな男の子がギターを弾いています。
男はピザを食べている。	ピザを食べる男。
オランウータンがバスに乗っています。	猿がバスに乗っている。
ある食堂で男女が話している。	男女が自転車に乗っている。
女性が携帯電話で話している。	男女が電話で話している。
男がギターを弾いている。	ガラス戸を掃除している人。
少女が歌い、ギターを弾いている。	若い男性がギターを弾きながら歌っている。
男がギターを弾いている。	男がギターを弾きながら歌っている。
男は馬に乗っている。	女性が鍬を使っている。
男がギターを弾いている。	男が車を運転している。
手話でコミュニケーションしている女の子。	少女が手話を使っています。
女性がウェイトエクササイズをしているところ。	女性が髪を結っているところ。
男が車の中に入っていく。	老人が赤い車に乗り込んでいる。
大きな緑の玉がジャガイモを倒す。	緑色の大きな球がジャガイモにぶつかる。
男が板に穴を開けている。	誰かが木片に穴を開けている。
猫がキーボードを弾いている。	猫がピアノを弾いている。
2匹の犬がプールで泳ぐ .	犬がプールで泳いでいる。
サイレンサーを銃に取り付けている人。	ある男が銃にサイレンサーを付けている。
男はチョッパーでタマネギを刻んだ。	男は機械を使ってジャガイモを切り刻んだ。
女性が豆腐を切る.	女性が豆腐を切っているところ。
鹿の群れが道路を横断している。	カリブーの群れが道路を横断している。
その人が馬に乗っている。	男が馬に乗る
誰かが動物に餌をやっている。	誰かがピアノを弾いている。
誰かがトルティーヤを切っている。	誰かが馬に乗っている。
雄鶏がネズミの死骸をつつく。	ニワトリがネズミの死体をついばんでいる。
カンガルーを抱く女性。	カンガルーを拾っている女性。
蛙と戯れる男	猫がカメラで遊んでいる。
二人が話している。	二人の男がギターを弾いている。
二人の少女が電話で話している。	少女が通りを歩いている。
手でリンゴを切っているところ。	男がナイフでカーペットを切っている。
男は大きなパンにバターを塗る。	ガーリックブレッドにバターを塗る男。
電線の上を走っている男。	ロープの上を走る男。
誰かがやかんの中のチリをかき混ぜています。	チリの鍋をスプーンでかき混ぜている人がいます。
女性がボウルに卵を割っているところ。	生卵をボウルに割り入れる。
芝生を刈っている人	女性がレモンを切っているところ。
男がドアを開けている	男が玉ねぎを切っている
男がドアを開けている	男がギターを弾いている。
トマトを切っている人	男が馬に乗る
ジャガイモを切っている人。	ジャガイモを切っているところ
タコ焼きを切っている女性。	女性がタコを切っているところ。
男が刀で紙を切っている	女性がトマトを切っているところ。
板を打ち抜いている人	犬が水の中を走っている。
女は肉に小麦粉を塗る．	女性が肉に小麦粉を付けているところ。
男が踊っている	某氏がパンを食べている
誰かがピアノを弾いている。	男がギターを弾いている。
レンガ造りの中庭で、2匹のキツネが皿の上で食事をしている。	キツネがお皿で食事をしている。
少年は鍵盤を弾いている。	男の子がピアノを弾いています。
キーボードを弾く人	キーボードを演奏している人がいます。
少年はカレンダーを研究する.	少年がカレンダーを見ている。
男が銃を撃っている。	男が唾を吐いている
誰かがタマネギを切っている。	ジャガイモの皮をむいているところ。
男性が携帯電話で話している。	男が女に歌っている
男がギターを弾いている。	アコースティックギターを弾く男。
女性がカボチャを切っているところ。	女性が象に乗っている。
女が踊っている	女性がパン生地をこねている。
女が踊っている	女性がヴァイオリンを弾いている。
女性がボウルに卵を割っている。	女性が串焼き器をラックに載せているところ。
女性がトマトを切っているところ。	女性がジャガイモを切っているところ。
フライパンに油を塗っている人。	smeoneが横になっている。
男がギターを弾いている。	パスタの湯切りをしている人。
女性が水上スキーをしている。	女性が魚をさばいているところ。
電子キーボードを演奏している男性。	男がフルートを吹いている
女性が肉を切り分けているところ。	女性が肉を切っているところ。
男がギターを弾いている。	男がバナナを食べている。
男がフルートを吹いている	スクーターに乗る男。
ステーキを洗っているところ	男がギターを弾いている。
男がピアノを弾いている。	男がギターを弾いた。
ある人が商品を売っている。	男が家の掃除をする
男が水に飛び込んでいる。	紙を切っている人
女性が缶を選んでいるところ。	男がギターを弾いている。
壁を飛び越える男。	男は短い壁の上にジャンプする。
ランナーがトラックを走り回る。	ランナーが競走する。
サッカーボールを蹴っている人。	某氏がボウルを混ぜているところ...
女性が何かを揚げている。	女性が馬に乗っている。
ネコが吸盤をなめている。	女性がキュウリを切っているところ。
女性が火のそばで踊っている。	女性がお風呂に入っているところ。
男がギターを弾いている。	男が楽器を演奏している。
男は魚を切り開いている。	ジャガイモを切っている人
女性が玉ねぎを切っているところ。	女性が庭を掃除しているところ。
フライパンでバターが溶けている。	男が鍋でバターを溶かしている。
何人かの人は鋸で切っています。	丸太を製材しているところ。
女は男とゲームをしている。	ピアノを弾いている人
男は白い車に乗っている。	インタビューに答えている男性。
若い男がピアノを弾いている。	女性が海老の殻をむいているところ。
自動車が道路を走っている．	少女が道を歩いている。
女性が材料を混ぜているところ。	女性がボウルの中の食べ物を混ぜている。
ある男が自分の車を運転した。	男が車を運転している。
車がスペースから出る	ブロックされた車線から車がバックで出てくる。
キャベツの葉を包丁で千切りにしている人がいる。	誰かがキャベツの葉を切っている。
ピザにチーズを乗せる男。	男はピザにチーズをかけた。
少年はピアノを弾いている。	ピアノを弾く少年。
男は女にキスをし、抱きしめている。	男が女に抱きつき、キスをしている。
その男がギターを弾いた。	男がギターを弾いている。
男が馬に乗る	キーボードを演奏している人
掃除機で床を掃除している少年。	男の子が掃除機をかけています。
女の子がフルートを吹いています。	ステージでバンドが演奏している。
人が電車を降りる	集団で列車を降りる
女性がミシンをかけているところ。	女性が肉にパン粉を塗っているところ。
プールを覗き込む犬。	プールの周りを犬が歩いている。
男がパンにバターを塗っている。	男はパンにバターを塗る
女性がアイペンシルでまぶたにアイライナーを引いているところ。	女性がまぶたに化粧をしているところ。
トマトを切っている人。	女性が野菜を切っているところ。
列車が動いている	ヨガをする人。
10代の女の子3人が、部屋の中で踊っていた。	10代の少女たちがカメラに向かって踊っている。
車を撮影する男．	ジャガイモを切っているところ
某氏がベッドメイキングをしています。	女性がギターを弾いている。
黒い馬が走り回っている。	馬が走っている。
誰かがタマネギを切っています。	女性が玉ねぎを切っているところ。
女性がエビの背わたをとっているところ。	雨の中で男が踊っている。
男が馬に乗る	女性が冷凍庫を洗っているところ。
キーボードを弾く人	キーボードを演奏している人
ジャガイモを切っている人	女性がハラペーニョをカットしているところ。
犬がボールに向かって吠えている	テニスボールを追いかけて泳ぐ犬。
女性が海で遊んでいる。	女性がエビを調理しているところ。
釣竿を振り回す魚から逃げ回る子供......。	小さな子供が釣竿を持って走り回っている。
荒野の道を歩いている男。	ある男が道を歩いている．
老人が演台に立っている。	壇上で演説している男性。
電子キーボードを演奏している人	子供がキーボードを弾いている。
馬に乗った男がスローモーションで	男が馬に乗っている
ブッラータチーズをカットしているところ。	チーズをスライスしているところ。
男は自動小銃を撃っている。	男が銃を撃っている。
ウサギがおもちゃのウサギと遊んでいます。	ウサギのぬいぐるみで遊んでいるウサギ。
飛行機が道路に乗り上げている。	飛行機が滑走路を移動する．
ナイフの背でニンニクをつぶしている男。	女性がナイフで肉を切っているところ。
女性が爪研ぎをしているところ。	女性が赤ちゃんに哺乳瓶でミルクをあげているところ。
スケートボードに乗っている男。	女性がジャガイモを切っているところ。
女性がシャワーを浴びているところ。	白い馬に乗った男がいる。
男が踊っている	男が馬に乗る
男が葉っぱを持っている。	猿が人と戦っている
女性がエビの殻をむいているところ。	男が水を絞っている。
某氏が舟を漕いでいる。	男が銃を撃っている。
天井のロープにぶらさがっている人。	男がロープにぶら下がっている
浜辺で馬に乗る女性。	男が男を背負っている。
男が片手に小動物を抱えている。	小猿を見せびらかす男。
四角い紙を折っている人。	男が紙を折っている。
人がフライパンで肉を炒めている。	人がスカンクを抱いている。
男が男を撃つ	ピストルを持った男が、他の男を撃つ。
男がギターを弾く...	その男は歌い、ギターを弾いた。
座ってタバコを吸っている人。	タバコを吸っている人
チンパンジーが女性を傷つけている。	男が車を運転している。
女性がエビを剥いているところ。	キツネザルを抱いているのは男性です。
男がギターを弾いている。	女性が馬に乗っている。
一人の男が他の男の胸の上でセメントを割っている。	男が他の男の上に噴石を壊す。
2匹のシマウマが遊んでいます。	シマウマは社交的である。
女性がバターを切っているところ。	女性が豆腐を切る.
ギターを弾いている男性もいます。	3人の男がギターを弾きながら歌っている。
浜辺で男が女同士で話している。	ある男が通りを歩いている．
犬が店のカウンターに座っていた。	犬はカウンターに立っています。
ドリルで帯状の木材に穴を開ける。	男が木に穴を開ける。
女性はタマネギを切っている。	駅で踊っている女性。
窓の前に立って外を見ている男性。	男が窓の外を見つめている。
スカンクがあちこち見ている。	スカンクがカメラを見ている。
女性が野菜を切っているところ。	女性がニンニクを切っているところ。
アナグマが穴を掘っている。	アナグマが地球を掘っている。
湖で水上スキーをする女性。	男がフルートを吹いている
女の子がヴァイオリンを弾いている。	赤ちゃんは笑っています。
ヘリコプターがヘリポートに着陸しています。	ヘリコプターが着陸する。
女性が鶏肉を切っているところ。	女性が肉を切っているところ。
女性がキュウリを切っているところ。	男がギターを弾いている。
女性が象に乗り、群衆を前にしている。	女が象に乗る
子犬が床を後ろ向きに滑っている。	子犬が背中を押している。
シェフが料理を作っているところ。	シェフが食事を用意した。
女性がニンニクを割る.	女性がニンニクの頭を割っているところ。
プールを覗き込む犬。	プールの縁を歩いている犬。
女性がグラスの中で美容液を混ぜているところ。	女性がグラスの中のクリームをスプーンで混ぜています。
その男は、インターネットカメラ越しに女の子に話しかけました。	ティーンエイジャーがウェブカメラで女の子に話しかける。
男がギターを弾きながら歌っている。	男がギターを持って歌う
亀が地面の上を歩いている。	大きな亀が草むらを這っている。
ミキサー用の卵を割ってくれた。	女性が肉を切り分けた。
女性がトマトを収穫しているところ。	女性がボウルに生地を流し込んでいるところ。
コンピュータのモニターを見ている男性。	ノートパソコンを使っている人。
少年は三輪車に乗っている。	水上スクーターに乗る女性。
二人の男がタイヤ転がしで競い合う．	2人がレースでトラクターのタイヤをひっくり返した。
男がヴァイオリンを弾いている。	女性がミシンを使っているところ。
5匹の子猫が5つの食器で食事をしています。	子猫はトレーの上で餌を食べています。
人々は外で踊っている。	一群の人々が踊っている。
女性がマグロを切っているところ。	女性が生魚を切っているところ。
カメラで釘を打っているところです。	カメラのレンズを釘に打ち付けている人がいる。
赤ん坊が玄関から這い出てきた。	赤ちゃんが床をハイハイしている。
キーボードを弾いている人。	ピアノを弾いている人
ギターを弾く男	女性が唇を塗っているところ。
2枚のピザの匂いを嗅いでいる男......。	女が男を養う
女性が爪研ぎをしている。	ニンジンの皮を剥いているところ。
猿が犬の尾を引く	動物園で猿が犬をからかっている。
フローリングの床に仰向けに寝た犬。	犬が床に寝そべっている。
男がフルートを吹いている	犬が蝿に吠えている
女性がフライパンで何かを焼いている。	男がギターを弾いている。
少年は犬小屋の中に潜り込んでいる。	少年が木の笛を吹いている。
みずからすすんで調味料を入れる	男はボウルの中の水に調味料を加えた。
老女がフライパンに油を注いでいるところ。	縛られた男が水に入れる。
サイの赤ちゃんがお母さんと一緒に檻の中を歩いています。	サイの赤ちゃんが大人のサイの後をついていく。
女性が玉ねぎを切っているところ。	女性がタマネギを半分に切っているところ。
女性はカンガルーを拾った。	女性がカンガルーを抱いている。
缶に噛みつく犬。	犬が缶詰を開けると......
女性が魚の骨を抜いているところ。	魚を釣る
男が草刈りをしている。	コンクリート打ちっぱなしの男。
猫がテレビを見ている。	葉っぱを切っている人。
少年は犬小屋の扉から出られない。	子供が犬小屋に閉じ込められている。
プールに飛び込む人々。	男たちがプールに落ちていく
女性が水中を泳いでいる。	ニンジンを切っている人。
男は剣でペットボトルを切り裂いた。	ペットボトルを刀で斬った男。
女が水中を泳ぐ......。	女が泳いでいる
男がギターを弾いている。	女が踊っている
機械が鉛筆を削っているところ。	鉛筆の先端を削る機械です。
飛行機が空を飛んでいる．	青空を飛ぶ南アフリカン航空の飛行機。
熊が2匹の犬から逃げている。	熊が狼と戦っている。
いかだで休んでいる女性。	インナーチューブでくつろぐ女性。
キッチンのカウンターで魚をさばいている男。	男がフルートを吹いている
手術室で人が死んでいる。	舞台で男が女にキスしている。
男が葉っぱを持っている。	女性がテレビを見ている。
人が馬に乗っている。	女性がジャガイモを切っているところ。
女性がタコを切っているところ。	男がギターを弾いている。
水差しを割っている男。	女性がニンニクの皮をむいているところ。
男がギターを弾いている。	女性が野菜を切っているところ。
少女がカップケーキを食べている。	男がキュウリを切っている。
少女は犬とボールと一緒に芝生で遊んでいた。	赤ちゃんが犬とボールで遊んでいます。
筏に乗り、筏を漕ぐ。	4人がいかだで浮いている．
電子レンジのボタンを押している人。	男が電子レンジの電源を入れる。
少女が馬に乗っている。	少女は馬を走らせた。
その女性はジャガイモを切った。	ジャガイモを切っているところ
猿が太鼓を叩いている。	ゴリラがドラムを叩いている。
ミサイルは爆発した。	ロケットが爆発した。
雪で遊ぶ犬。	犬が絨毯の中のハエをつつく前に
女性が他の女性と踊っている。	女性が鶏肉を千切りにしているところ。
バットマンとロビンが水上でヘリコプターを飛ばす。	ヘリコプターが水の上を飛ぶ。
男の子がダンスを踊っているところ。	少年が水差しから何かを注いでいる。
女性がソーダを開けて飲んでいるところ。	女性が象に乗っている。
スピーカーのパーツを組み立てている人。	男がギターを弾いている。
女性が話しながら、ペットボトルからスキレットに油を注ぐ。	年配の女性がストーブの上のスキレットにオイルを注いでいます。
犬はプールの縁を歩いていた。	プールに沿って犬が歩いている。
バターがボウルに入れられてる．	バターをボウルに入れる人。
男が箱を開けて紙を取り出している。	女性がジャガイモの皮をむいているところ。
女性がハーブを切っているところ。	女性がコリアンダーを刻んでいるところ。
女がリンゴを剥く	バイクでウィリーする男。
ある男が数学の授業を受けている。	ステーキを洗っているところ
動物たちが水遊びをしています。	二人の男がピンポンをしている。
男が馬に乗り、障害物を飛び越えている。	サッカーボールを蹴っている人。
鉛筆で手品をしている人。	ニンジンを半分に切っている人。
カメラに火をつけた人。	カメラに放火している人がいます。
男は箱からテープを切り取っている。	男が箱を切り開いている
おばさんが串刺しのエビをお湯の中に入れてくれた。	パン粉をつけた肉を高温の油で揚げた。
女が踊っている	女性がクラリネットを演奏している。
男が川で釣りをしている。	男が歌いながら歩道を歩いている。
男が自転車に乗っている。	女性が街で踊っている。
男が腕立て伏せをしている。	女性がタコを切っているところ。
男がギターを弾いている。	女性が豚肉を切っているところ。
女性が馬に乗っている。	銃を撃ちまくる男。
少年はピアノを弾いている。	バンドがステージで演奏している。
大きなタッチスクリーンで絵を描いている人。	デジタルボードに絵を描いている人。
コックが小麦粉をこねているところ。	トルティーヤの生地をこねている女性。
少年は歌いながらギターを弾いている。	赤ちゃんがギターを弾いています。
女性が顔にパウダーを塗っている。	女性はテーブルを指で叩いています。
草原で「フォロー・ザ・リーダー」ごっこをした。	サイは草を食んでいた。
女性が卵を割っている。	男が女に話しかけている
女性がライフル銃を撃っている。	スタントをしている人。
女が手でニンニクの皮をむく......。	女性がハーブを切っているところ。
北極熊は獲物をめぐって争った。	シロクマ同士が争っている．
女性が馬に乗って外周を走っている。	犬がスケートボードに乗っている。
女性が赤ん坊をゴミ箱に入れている。	女性はジャガイモに穴を開けている。
女性が男性の肩に花輪をかける。	水先案内人の頭に水をかける男。
老婆が男と握手している。	男女の握手
トランプで手品をしている人。	某氏がトランプ芸を披露しています。
女性が水上スキーをしている。	湖でウェイクボードをしている女性。
木が嵐で曲がっている。	の木が強風にさらされている。
猫が瓶をなめている	猫が小瓶で遊んでいる。
男女が車に乗っている。	女性がエビを揚げています。
男が木の枝を動かしている。	女性がヴァイオリンを弾いている。
トランポリンに飛び乗る猫。	トマトを切っている人
ピアノを弾く男...	女性がヴァイオリンを弾いている。
フライパンに油を注ぐ。	玉ねぎをさいの目に切る
動物が食べているのは.	女が踊っている
男女がテーブルで食事をしている。	カップルが食事をしながら会話をしている。
女性が犬の散歩をしているところ。	女性が犬を連れて通りを歩いている。
女性が馬に乗っている。	怒りに任せてテーブルをひっくり返す男。
男が壁に木材をネジ止めしている。	男が女にマッサージをしている。
女の子がフルートを吹いています。	少女が管楽器を演奏している。
猫が牛乳を飲んでいる	猫がミルクの入った受け皿をなめている。
ポテトピーラーでジャガイモの皮をむいている人。	男がトマトを包丁で切っている。
小さな赤ちゃんがギターを弾いています。	少年がベッドに座り、歌い、ギターを弾く。
まぶたを作る女の子。	女性がアイシャドウを塗っているところ。
女性が玉ねぎを切っているところ。	男がトランプの手品をしている。
二人の男が戦っている．	二人の男が武術で戦っている。
男女が森の中を歩いている。	男女が歩いている。
子供がコンピューターゲームをしている。	少年がノートパソコンでゲームをしている。
二人の女性が群衆の前で踊り、歌っている。	女性たちが歌い、踊っている。
橋から水に飛び込む男たち。	男たちは川に飛び込む
軍人は新兵に吠えた。	将校が新入社員に話しかけているところ。
男性が鶏肉を容器に入れているところ。	食品を箱に入れている人。
ステノグラファーの機械に縛られている人。	その人が使っていたのは、速記機だった。
女性が鍋にパスタを入れているところ。	女性が麺を作っている。
岩の上に毛布を敷いて本を読んでいる女性......。	座っている女性が歌を歌い、ギターを弾いている。
2匹の子犬が遊んでいます。	サッカーをしている男性もいます。
誰かが鍋に材料を注いでいる。	鍋に野菜を入れる
ニンジンに味付けしているところ。	女性がニンニクを切っているところ。
夫婦で歩いています。	何人かの人は鋸で切っています。
二人の男がカートを押して森を抜けていく。	二人の男がカートを押している。
ギターを弾いている人	その男がギターを弾いた。
ペンギンの一団が歩いている。	大量のペンギンが海へ向かっている。
男がギターを弾いている。	饅頭を扱っている人がいる。
犬がトランポリンでジャンプしている。	少年がギターを弾いている。
キッチンのシンクの上で容器を揺すっている男。	プラスチック容器を空にしている人。
サッカーをしている人。	サッカーボールを足で操っている人。
男が馬と一緒に歩いている。	男が馬の蹄鉄を引いている。
その女性はジャガイモの皮をむいた。	女性がジャガイモの皮をむいているところ。
エビを剥く人	エビの殻をむいたのは女性です。
男がギターを弾いている。	新聞を読もうとする男.........................
ホテルでベッドメイキングをする男性。	男が動物を抱いている。
女性が豆腐を切っているところ。	女性が豆腐の塊を小さく切っている。
女性が魚の皮をむいているところ。	女性がフライパンに黄色い液体をかけているところ。
その犬は犬の尻尾を引っ張り、次に足を引っ張った。	猿が犬のしっぽを引っ張った
おんなのこはたまごをたたく	ボウルの中の材料を混ぜている人。
は野球をやっている。	クリケット選手がボールを打った。
人がスープを沸かしている。	女性が鍋に卵を入れているところ。
外で縄跳びをしている人。	女性がキュウリを切っているところ。
カンガルーを抱く女性。	帽子をかぶった男が歌を歌う
誰かがキーボードを打った。	を入力している人がいます。
サッカー選手がサッカーボールを蹴ってゴールに向かっているところ。	サッカー選手がゴールを決める
女が料理をしている	女性がフライパンに材料を流し込んでいるところ。
浜辺で泳いでいる女性。	海を泳ぎまわる女性。
人が人を運んでいる	男が男にホースから水をかける。
女性がペーストを皿に入れているところ。	女性がボウルから何かネバネバしたものを取り出している。
グレーのTシャツを手に取り、話している男性。	Tシャツを着ている男性。
3人の若者がコカコーラの自販機から走り、飛び、蹴る。	3人の男が壁から飛び降りている．
トマトを盛ったボウルにオリーブオイルを注ぎます。	男はトマトの輪切りにオイルをかけた。
男がギターを弾いている。	その男は友人とギターを弾いていた。
オクラを茹でているところ。	トマトを盛ったボウルにオリーブオイルを注ぎます。
ジャガイモの皮をむく人。	猫が小瓶をなめている。
猫が箱に飛び込んでいる。	青年が葉っぱに話しかけている。
若いアジア系の女の子がアイラインを引いているところ。	女の子がアイメイクをしているところ。
女性がオイルに味付けをしているところ。	女性がボウルに材料を注いでいるところ。
猫がソファーの下を逆さまに滑っている。	猫が家具の下を仰向けで這っている。
シェフがスープの片付けをしているところ。	某氏がボウルの縁を拭いているところ。
砂漠で爆発が起こっている。	核兵器が砂漠で爆発する
女性がレモンを切っている	男がマイクに向かって話している。
太った男が縄跳びをしている。	若い男が踊っている。
猫が家の中を歩き回っている。	女性がジャガイモの皮をむいているところ。
その女性は生卵を2つ割った。	女性がボウルに卵を割っているところ。
ナイフで鉛筆を削る。	雨の中で女が踊っている。
プラスチック製のおもちゃが水に浮いている。	女性陣がダンスを披露しています。
女が踊っている	棒を折る男
亀は魚の後を追いました。	ウミガメが魚を獲っている。
アイシャドウを塗っている女性。	アイペンシルをまぶたに塗っているところ。
靴ひもを結んでいるところ	自転車に乗っている人の肩に犬が乗っている。
女性がナイフで肉を切っているところ。	某氏が生地を広げているところ
犬が地面を走っている。	少女が爪をたたいている。
女性がペットのウサギをあやしながら話しかけています。	女性が犬を散歩させながらアストロターフに入る．
猿が太鼓を叩いている。	ゴリラの着ぐるみを着た人が、ドラムを叩いている。
男が縛られた犬を撫でている。	愛犬をカメラに向ける男性。
女性がペットの犬を連れて広々とした土地を歩いていると、他の犬たちがついてくる。	男が数匹の犬を連れて歩いている。
女性がニンニクをみじん切りにしているところ。	ディスクをクリーニングしている人。
男がバスケットをシュートする	男がギターを弾いている。
2つのチームがサッカーをしています。	異なるチームがフィールドでサッカーをしています。
ネズミのような生き物が匂いを嗅ぎ回っている。	動物が地面を歩いている．
男が白い馬に乗り、囲まれた土地を走っている。	誰かが馬に乗っている。
二人の相撲取りが戦っている。	水中で水鉄砲に乗る男。
東洋の女性がニンジンを薄く切っている。	女性がニンジンを切っているところ。
地面に寝そべってライフルを構える男......。	トルティーヤにバターを塗っている人。
男は玉ねぎを切った	男が踊っている
カップルが海に向かって走っている。	男女が手をつないで走っている。
一群の人々が踊っている。	女性たちが外で踊っている。
男がギターを弾いている。	少年が巨大な犬に話しかけている。
女性が野菜を混ぜる...	女性がスキレットに材料を入れているところ。
女性がボウルに注ぎ、混ぜ合わせる。	女性がスキレットで卵を焼いているところ。
女性が固い卵を切っているところ。	ゆで卵を切っているところ。
2台のロボットがキスを交わす......。	男性と女性のロボットがキスをしている。
猫が犬を触ろうとしている。	猫は犬の頭を触ってからかった。
女性がまぶたに化粧をする。	アイシャドウを塗っている女性。
その男は小さな赤い車を走らせ、交通渋滞を回避した。	ビーチで犬が水の中を走った。
某氏がパンを切っている。	サッカーボールで芸をする男。
女と男が車に乗っている。	車を運転している女性が、隣の席の男性に話しかけている。
男がバターのかけらをミキシングボウルに切っている。	を加え、スタンドミキサーにかける。
猫が子供の頭を素早く叩く。	猫と男の子が一緒に遊ぶ。
猫が箱の中で遊んでいる。	犬が床掃除機で遊んでいる。
男がパンにニンニクを塗っている。	ある男が、分割してバターを塗った数個のパンに調味料をまぶしている。
パンダは丸太の上に寝ていた。	パンダが寝そべっている。
男がワニの口をなでている。	ストーブの上の鍋に刻んだ野菜を放り込んでいる人。
少女は檻の中で踊っている。	タマネギのみじん切り中。
五人組がプールに飛び込む	游泳隊がプールに落下する。
女性がガラスのボウルに入った2つの卵をかき混ぜています。	少女がステージで歌っている。
ドラムを叩いているのは、この人です。	シンクに洗剤を入れる男。
ロボットの上に猫が乗っている。	某氏がパンを食べている
少年は犬小屋の中に潜り込んでいる。	猫が床で遊んでいる。
少女は丘を駆け上がりながら凧を上げた。	凧を落とした少女。
女性がお湯の入った鍋に食べ物を入れている。	女が肉を焼いてる
男が自転車に乗っている。	パンダが食べている。
若い男が歌い、ピアノを弾いている。	男が手紙を書いている。
少年はサングラスをはずす	男の子が叫んでいます。
少女がピアノを弾いている。	男の子が腕立て伏せをしています。
その女性は、ボウルの中の生卵をかき混ぜた。	女性が目を器に注いでいる。
チーターは獲物の後ろを走っている。	チーターが野原で獲物を追いかけている。
女性がトマトを切った。	誰かがトマトを切っている。
女がジャガイモの皮をむく.	女性がパイナップルを焼いているところ。
猫が床で遊んでいる。	ニンニクを切っている人。
ステージでヴァイオリンを弾く少年。	鍋を混ぜている人
猫が水を飲んでいる。	トラックが坂を下っている。
豚肉に塩と胡椒をしている人。	ピアノの上に座っている少年。
その男は椅子に座り、じっと見ていた．	少女は髪をポニーテールにしている。
女性がジャガイモを切っています。	女性が豆腐を細かく切る
男はチキンのソースをかき混ぜた。	男が油をかき混ぜている。
赤ちゃんが楽しそうにハイハイしている。	赤ちゃんがくしゃみをして、他の赤ちゃんを怖がらせてしまった。
フライパンで肉を焼いているところ。	男が野菜を切っている
男が窓から外を見ている。	女性が水の中を泳いでいる。
座っている人がギターを弾いている。	アコースティックギターを弾きながら、マイクに向かって歌う男性。
犬がおもちゃに吠えている	小犬は電子玩具に吠えた。
女性がナイフでタマネギを切っているところ。	男が料理を作っている。
縄跳び屋	某氏が話しています。
女性がオレンジの皮をむいているところ。	女性がレモンの皮を小さく切り取る．
ライダーが馬を走らせ、ジャンプしている。	馬上でハードルを飛び越える女性。
少年は鍵盤を弾いている。	ランプの光に照らされた部屋でピアノを弾く少年。
自転車操業	男の子が自転車に乗っています。
二人の男が戦っている．	この人は、運動している。
男が木の笛を吹き、他の数人の男がボンゴを叩いている。	男がフルートを吹いている
人が猿を撫でている	男がスローロリスを抱いている。
ジャガイモを切っているところ	エレキギターを弾く女性。
女性が生姜を切っているところ。	人が2匹のロリスの赤ちゃんを抱いています。
二匹の漫画のウサギがキスをしている。	ウサギが他のウサギにキスしている。
ハリネズミはタオルを噛んでいた。	ハリネズミが毛布をかじっている。
男がパンにバターを塗っている。	紐で吊るされたスローロリス。
男が死んだ鹿を引きずっている。	崖から水に飛び込んでいる男。
猫が自分をなめている	マンドリンスライサーで白髪ネギを切っている人。
女性が野菜を切る	女性が串刺しの料理をクッカーに載せているところ。
男が蛇を調理しているところ。	男は切ったキュウリを水の中に落としている。
女性がロールパンにマスタードを塗っているところ。	子猫が女性の指にじゃれついている。
小さなモルモットが床に落ちているニンジンをかじって食べています。	モルモットがニンジンを食べる．
燃えている車の前に4人の少年が立っている。	背後で車が爆発する中、立ち尽くす4人の若者たち......。
エビの尻尾と胴体を切った。	女性がエビを掃除しているところ
糸を噛んでいる子猫を誰かが触った。	誰かが紙を切っている。
スキレットに肉を入れているところ。	女性が赤ん坊をゴミ箱に入れている。
子ゾウが小さな木を食べています。	スクーターをこぐ少女。
アコースティックギターを弾く男。	女と犬が一緒に歩いている。
3人の子供たちがご飯を食べている。	鹿がフェンスを飛び越えた。
潜水艦は水の中を進んでいる。	赤ちゃんが眠ってしまう。
ある男が道を走っている。	男がギターを弾く...
アナグマが土を掘っている。	大きな岩を動かしている人。
女性が大きなピーマンを切っているところ。	犬が口を動かしている
