この問題は、シャトルが再び飛行を開始する前に修正される可能性が高いです。	スペースシャトルが再び飛行できるようになるには、この問題を修正する必要があるとのことです。
技術系のナスダック総合株価指数（IXIC）は、1ポイント（0.11%）下がって1,650となりました。	スタンダード＆プアーズ500指数（Spx）は3ポイント（0.32%）上昇し、970となりました。
「出版社のアーサー・オックス・サルツバーガー・ジュニアは、1896年から同族が新聞を経営しているという。	このスキャンダルについて、新聞社の発行人であるアーサー・サルツバーガーは、「大きな黒目だ」と述べた。
証券取引委員会のウィリアム・ドナルドソン委員長は、「警察が動いているという確信が生まれつつある」と述べた。"	" 警官の腕に自信がついたようだ"
ビベンディ社の株価は、月曜日に3.6％下落した後、パリで1.9％下落の15.80ユーロで取引を終えた。	ニューヨークでは、ビベンディの株式は18.29ドルで1.4％減少した。
ミャンマーの民主化運動指導者アウン・サン・スー・チー氏は金曜日遅くに帰国するが、ヤンゴンの病院での手術から回復した後も拘留されると、彼女の個人的な医師が語った。	ミャンマーの民主化運動指導者アウン・サン・スー・チー氏は、手術を受けた病院から退院後、自宅軟禁状態になると、彼女のかかりつけの医師が金曜日に発表した。
スピッツァーのスポークスマンであるダレン・ドップは、木曜日遅くにコメントを控えた。	ワシントンでの委員会のスポークスマン、ジョン・ハイネ氏は、スピッツァー氏の批判についてのコメントを避けた。
ブレマー氏は、今後2週間で7000万ドルの全国的なプログラムを立ち上げ、近隣の清掃とコミュニティ・プロジェクトを立ち上げると述べた。	ブレマー氏は、イラク全土の近隣を清掃し、コミュニティプロジェクトを構築するために、今後2週間で7000万ドルのプログラムを開始すると述べたが、詳細は明らかにしなかった。
欧州の午後の取引では、フランスのcac-40と英国のftse100がそれぞれ0.7％上昇し、ドイツのdax指数は0.6％上昇した。	欧州では、フランスのCAC40が1.3％上昇、英国のftse100が0.2％下落、ドイツのdax指数が0.6％上昇しました。
後に、この事件はコンコルドのソニックブームが原因であることが判明した。	後に、この驚くべき事件は、コンコルドの強力なソニックブームによって引き起こされたことが判明した。
ジョン・ケリー上院議員とボブ・グラハム上院議員は、講演の招待を辞退した。	マサチューセッツ州のジョン・ケリー議員とフロリダ州のボブ・グラハム議員は欠席した。
ページでは、Y染色体上の遺伝子が病気のかかりやすさの性差に影響している可能性もあると述べている。	さらに、Y字上の遺伝子は、病気のかかりやすさの性差に影響を与える役割を担っているかもしれないと付け加えた。
気質に関する最もよく研究されている側面の1つは、人が新しさにどう反応するかということです。	気質の特徴としてよく研究されているのは、人が新しさにどう反応するかということです。
しかし、午前1時から午後1時までの早い光のサイクルにさらされた蝶は、南東を向いていた。	しかし、午前1時から午後1時という早い光のサイクルで飼育されている蝶は、南東に向かって飛んでいった。
RTジョーンズのアナリスト、ジュリ・ニーマンは、グラントは「私たち全員が応援していた選手だ」と語った。	RTジョーンズのアナリスト、ジュリ・ニエマンはグラントについて、「彼は非常に良い評判を得ている」と述べています。
重要な問題は、国連による戦争承認に反対してワシントンを激怒させたフランスが、「賛成」票を投じるか「棄権」票を投じるかであった。	国連の戦争承認に反対し、ワシントンを激怒させたフランスもまた、変更を求めていた。
メル・ギブソンの情熱的な聖書叙事詩「The Passion of Christ」が、ローマカトリック暦の灰の水曜日である2月25日に全米で公開されます。	メル・ギブソンは、ニューマーケットフィルムと、彼の問題になっている聖書叙事詩「キリストの受難」の米国での配給について交渉している。
ダンラップは水着コンテストとタレント部門で優勝し、"If I could "を歌いました。"	彼女は「If I could」を歌ってタレント部門で優勝し、イブニング・ウェア部門でも優勝しました。
グレイ・デイヴィス知事は昨日、この火災の被害額は約20億ドルにのぼると推定している。	州当局の試算では、その費用は20億ドル近くにのぼります。
アメリカン・エキスプレスは、必要な500万ドル以上のうち、少なくとも300万ドルを寄付しました。	市は連邦資金を要求していたが、アメリカーン・エキスプレスが少なくとも300万ドルを約束したときにその要求を取り下げた。
南アジアでは、110万人の若者が感染し、その62％が女性です。	南アジアの110万人の感染者のうち、62％が女性である。
その1時間後、イスラエルのヘリコプターがガザ市の車にミサイルを発射し、ハマスの幹部2人と少なくとも5人が死亡した。	その1時間後、イスラエルの攻撃ヘリコプターがガザ市の車にミサイルの雨を降らせ、7人が死亡したとパレスチナの情報筋は述べた。
エグゼクティブ・リクルーターによると、ベテランのチーフ・マーチャンダイジング・オフィサーを見つけることは、おそらくすべての雇用の中で最も難しいことであり、それは優秀な人材が少ないからだそうです。	エグゼクティブ・リクルーターによると、ベテランのチーフ・マーチャンダイジング・オフィサーを見つけることは、おそらくすべての採用の中で最も難しいことであるとのことです。
AaaのスポークスマンJerry Cheskeは、価格はいくつかの計画に影響を与えたかもしれないが、安価なホテル情報は、その影響を軽減すると述べた。	Aaaのスポークスマン、ジェリー・チェスケは、価格はいくつかの計画に影響を与えたかもしれないが、安いホテル情報はそれを補うために作ったと述べた。
数十年にわたる紛争により、資源が豊富な同州では1万人以上が死亡し、そのほとんどが民間人である。	30年にわたる反乱で、1万人以上（そのほとんどは民間人）が殺された。
大西洋の暴風雨シーズンの最初のハリケーンであるクローデットは、7月15日にテキサス州中部沿岸で風速85マイルの暴風雨に見舞われた。	大西洋暴風雨シーズンの最初のハリケーン、クローデットは7月15日にテキサス州中部沿岸を襲い、カテゴリー1のハリケーンに分類され、最大持続風速は時速85マイル（時速60km）に達した。
彼女は、グルナー＆ヤールが編集上の重要な決定から彼女を切り離すことによって、彼女との契約を破棄したとし、1億2500万ドルを求めて反訴したのです。	彼女は、g + jが彼女との契約を破棄し、編集上の重要な決定から彼女を切り離し、雑誌の財務数値を操作したとして、1億2500万ドルで提訴した。
スタンダード・エディションは、プロセッサーあたり15,000ドル、指名ユーザーあたり300ドルです。	Standard Edition Oneは、Oracle Standard Editionデータベースのシングルプロセッサー版です。
米国第2位のソフトドリンクメーカー、ペプシコ（NYSE : PEP - NEWS - PEOPLE）の業績が注目されました。( nyse : pep - news - people ) の業績が注目されそうです。	ウォール街では、アルミニウムメーカーのアルコア社（NYSE : PEP - NEWS - PEOPLE）の決算発表も待たれていました。( NYSE : PEP - NEWS - PEOPLE ) の決算発表が終盤に控えています。
マイクロソフトは、今年初めにコネクティックスの資産を買収した際に、バーチャルPCを取得しました。	マイクロソフトは今年初め、開発元のコネクティックスからバーチャルPCを買収した。
テイラーの側近は、突然の離脱はさらなる混乱を招くと警告している。これはリベリアの多くの人々が共有する見解であり、内心では調停者でさえある。	彼の側近は、突然の退去はさらなる流血を引き起こすと警告しており、これはリベリアの多くの人々が共有する見解です。
しかし、Odetteは12月にカリブ海で形成される最初のものである、とセンターは述べている。	12月にカリブ海で発生した最初の嵐である。
レオン・ウィリアムズの遺体が トンプキンスビル196ベイストリートの アパートの3階で発見されました ...	死んだ男、レオン・ウィリアムズは3階のアパートで発見された。
このような訓練は、9月11日のニューヨークとワシントンの同時多発テロ以来、初めてのことです。	これは、9月11日のテロ事件以来、全米初の大規模なテロ対策演習である。11のテロ事件以来、初めての大規模なテロ対策訓練です。
AFL-CIOは10月まで候補者を推薦するかどうか待っている。	AFL-CIOは水曜日、予備選の前に候補者を支持するかどうかを10月に決定すると発表した。
ursel Reisenは、このバスを運行していたことを確認しましたが、乗客の年齢層がまちまちだったということ以外、詳細は明らかにしていません。	ursel Reisenは、このバスを運行していたことを確認したが、乗客の詳細については、年齢がまちまちであったということ以外、明らかにすることを避けた。
南部のバスラでは合計17件の症例が確認されたという。	世界保健機関（WHO）は昨日、イラク南部のバスラで17人のコレラ患者が確認されたと報告した。
また、イエメンとバーレーンを訪問する予定である。	月曜日にベイルートに到着したカターミは、シリア、イエメン、バーレーンも訪問することになっていた。
マイヤーズ総監督は記者団に対し、「一見したところ、ルールが破られたようには見えない」と語った。	「一見したところ、ルールが破られたようには見えない」と、統合参謀本部議長のリチャード・マイヤーズ大将は述べた。
ミルヴィルの息子の犠牲を証明するために、ジェームス・クイン市長は、今後30日間、すべての市旗を半旗掲揚することを命じました。	昨日、ミルヴィル市のジェームス・クイン市長は、今後30日間、すべての市旗を半旗で掲揚するよう命じました。
ノースカロライナ州ベルモントの14歳、トム・カズマー君は、昨日の大会で「ジースティー」のような単語を出しました。	ノースカロライナ州ベルモントの学校に通う14歳の全米スペリング大会ファイナリストは、水曜日の競技中に「zistee」のような響きを持つ単語を獲得しました。
オハイオ州カントンを拠点とする東部中央地域信頼性協議会の運営・資源担当マネージャー、トム・クレイナック氏は、このシナリオは、捜査当局が検討している多くのシナリオのうちの1つであると述べています。	オハイオ州カントンを拠点とする東部中央地域信頼性協議会の運営・資源担当マネージャー、トム・クレイナック氏は、捜査当局がこのシナリオを検討していると述べています。
オゾンがコレステロールを分解したときにのみ生成される分子を発見したのです。	そして、すべてのサンプルに、コレステロールがオゾンと相互作用したときにのみ生成される分子が含まれていたのです。
これは、学界、産業界、政府、一般市民など300人以上のリーダーの意見を参考にして開発されました。	この計画は、Nihロードマップと呼ばれ、産学官の300人以上のコンサルタントの協力を得て、14カ月かけて策定されました。
1立方センチメートルに約12時間分の音楽に相当する1ギガバイト以上の情報を保存することができるのです。	1,000枚の高画質画像や約12時間の音楽に相当する1ギガバイト以上の情報を、わずか1立方センチメートルの中に保存することができるのです。
今月初め、リムは第2四半期に1株当たり7セントから11セントの利益を計上する見込みであると発表していた。	訴訟費用などを除けば、1株当たり1～4セントの損失を見込んでいます。
市議会とブルームバーグ政権の交渉が過熱する中、予算分析が行われた。	市長と市議会の予算交渉が佳境に入っている。
また、薬物治療やがん、糖尿病、エイズなどの病気によって免疫システムが抑制されている場合も、リスクが高くなります。	また、病気や薬で免疫力が低下している人もリスクが高くなります。
地元警察当局は、爆発を刑事事件として扱っており、何も除外されていない。	ニューヘイブン警察署長代理のフランシスコ・オルティスは、警察はこの爆発を刑事事件として扱っていると語った。
「昨日発表された抄訳によると、「私にとって、レヴィンスキーの騒動は、政敵が作り出した悪質なスキャンダルのように思えた。	「私にとって、ルビンスキーの騒動は、政敵が作り出した悪質なスキャンダルのように思えた」とクリントン夫人は書いている。
2001年と2002年には、同社の40の口座のうち4つから合計32億ドル以上の電信送金があったと、検察は述べている。	ビーコンヒルに開設された40の口座のうち4つからの電信送金は、2001年から2002年にかけて合計32億ドル以上であったと、モーゲンソーは述べている。
ソニー・ブルック大学は、先行研究により電磁界とがんの関連性が指摘された後、1996年に研究を開始しました。	ストーニーブルック州立大学では、先行研究で関連性が指摘された後、1996年に研究を開始しました。
以前、彼らは警察の命令に逆らい、バシルが厳重に警備された法廷の席に向かうとき、「アラフ・アクバル（神は偉大なり）」と叫んだのだ。	以前、バシル氏の支持者が警察の命令に逆らい、「アラーフ・アクバル（神は偉大なり）」と叫びながらバシル氏が席に向かって歩いた。
Metropolitan ambulance spokesman james howe によると、昨日の事件で5人が病院に運ばれ、3人が現場で手当てを受けたという。	広報担当者のジェームズ・ハウ氏によると、4歳から17歳の5人の子供が首と胸を負傷して病院に運ばれ、他の3人は現場で手当てを受けたという。
シロンはすでにパウダージェントの株主から20％近い承諾を得ている。	シロンは、パウダージェントの株式の約20％の保有者から承諾を得ている。
しかし、合同情報委員会が関与していないことは明らかである。	この報告書は、合同情報委員会によって承認されました。
20代の若者の約22％が肥満であり、これは健康的な体重より約30ポンドも多い。	現在、アメリカ人の約31％が肥満であり、健康的な体重よりおよそ30ポンド以上多い。
カップリングは、ヒットした英国のコメディのアメリカ版で、貴重な木曜日午後9時30分の時間帯を取得します。	カップリング、ヒットした英国のコメディのアメリカ版、木曜日に友人とカップルになります。
コークスの株式は、44.01ドルで木曜日のニューヨーク証券取引所の取引を終了しました。	ニューヨーク証券取引所の朝の取引では、コカコーラの株式は$ 43.67で34セントダウンしていた。
彼女の遺体は数週間後にグリーンリバーで発見された。	Aug.15, 1982 : チャップマン、ハインズ、ミルズの遺骨がグリーンリバーで発見される。
「これらのメッセージを送っている人たちは、私や他の人たちのコンピュータを使う権利を侵害していると感じています」とマッケニー。	これらのメッセージを送っている人たちは、私や他の人たちのコンピュータを使用する権利を侵害しています。
「戦闘は真夜中まで続いた」と、西部反乱軍司令官ウスマン・クーリバリは日曜日にロイター通信に衛星電話で語った。	「彼らは2つの村を略奪し、完全に燃やした」と反乱軍司令官ウスマン・クーリバリはブッシュから衛星電話でロイター通信に語った。
8月と7月の数値は、1997年8月の調査開始以来、最高値となりました。	これは、1997年8月の指数作成以来、最も高い数値である。
「一般に、迷惑なスパム、そしてしばしばポルノや不正な意図を持ったスパムは、迷惑であり、気が散るものです。	一般的に、不要な、そしてしばしばポルノや詐欺的な意図のあるスパムは、迷惑であり、気が散る , " ゲイツは書いている。
米国特殊部隊は、コロンビアで2番目に大きな油田から原油を輸送するパイプラインを保護するため、地域の軍事基地でコロンビア兵を訓練しています。	米軍の特殊部隊は、パイプラインを守るため、地域の軍事基地でコロンビア兵を訓練しています。
お客様や従業員の意見を聞き、今回の決定に至ったとのことです。	この決定は、「お客様や従業員の声に耳を傾けた結果」と、ウォルマートの広報担当者であるメリッサ・ベリーヒルは述べています。
鷹匠公は、「裁判所、検察庁、警察に関する限り、新たな始まりである」と歓迎しています。	「それは、裁判所、検察庁、警察に関する限り、刑事司法制度をより良く機能させるための新たな始まりです。"
7月中旬までに予算が決まらないと、9月に学校が開校できない」とストレイホーン。	テキサス州議会は、7月中旬までに1億8590万ドルの予算ギャップを埋めなければならず、さもなければ9月に学校が開かれないと、会計監査人のキャロル・キートン・ストレイホーン氏は木曜日に述べた。
ハートフォードの株式は、ニューヨーク証券取引所の複合取引で2.88ドル上昇し、46.50ドルとなった。	ハートフォードの株式は、最大2.28ドル、または5.2パーセント、昼間の取引で45.90ドルだった。
その後、DVD-CCAは州最高裁判所へ上告した。	DVD CCAはこの判決を不服として、米国最高裁判所に控訴しました。
「2004年の大統領予備選にタッチスクリーン機を導入する準備は万全です」と、州選挙管理委員会のジル・W・バーガー委員長は述べています。	メリーランド州選挙管理委員会のジル・W・バーガー委員長は、「ダイボールドの改良型マシンを導入する準備は万端整っていると考えています」と述べています。
カントリーミュージック局のKKCSは、メンバーの一人がジョージ・ブッシュ大統領を批判した後に課された禁止令に違反してディキシー・チックスの曲を演奏したとして、ディスクジョッキー2人を停職処分にした。	あるラジオ局が、スタジオに閉じこもってディキシー・チックスの曲を流し続けたとして、2人のディスクジョッキーを停職処分にしました。
技術系のナスダック総合指数< .ixic >は26ポイント（1.78%）上昇し、1,516となった。	スタンダード＆プアーズ500指数（Spx）は8.79ポイント（0.96%）上昇し、929.06となりました。
ビジネスウィークのオンライン版では、ワールドコムと証券取引委員会が早ければ月曜日にも和解を発表する可能性があると報じている。	ビジネスウィーク・オンラインによると、早ければ5月19日（月）にも和解が成立する可能性があるとのことです。
ソブリン社の株価は74セント（4.5％）下がり、15.68ドル。	ソブリン株は15.68ドルでニューヨーク証券取引所に上場し、74セント（4.5％）下落した。
アスペンテクノロジーの株価は74セント（23％）下がり、ナスダックで2.48ドルの終値となりました。	午後の取引では、アスペンの株式は、一株当たり2.33ドルで89セントまたは27％以上オフになっていた。
新法では、図書館や学校にフィルターを使用するか、連邦政府からの融資を失うかを要求しています。	6-3の判決は、図書館にフィルターを設置するか、連邦政府からの資金を放棄するよう指示した法律を復活させるものである。
さらに、米国とイスラエルにアラファト氏を回避する方法を提供した。	春に首相の地位が確立されたとき、米国とイスラエルはアラファトを回避する方法を提供したのである。
そして、マリリン・モンローは、「アーサー・ミラー、エリア・カザンとブラックリスト：罪なき者」と題された物語の一部であることは間違いないでしょう。"	アメリカン・マスターズ」シリーズのこの恐ろしい比喩の小見出し、「アーサー・ミラー、エリア・カザンとブラックリスト：罪なき者はいない」に注目してください。"
ギルロイ警察とFBIは、ゲーリングが協力的であると述べたが、土曜日に、彼は子供たちに何が起こったかについて何も明らかにしなかったと述べた。	土曜日、カリフォルニアの当局者は、ゲーリングが協力的であると説明しました - しかし、彼は子供たちに何が起こったのかについて何も明らかにしていないと述べました。
スクリブナーの死体は、彼が妻とハウスボートで暮らしていたポーテージ湾に浮かんでいるのが発見された。	ポーテージ湾のハウスボートで スクリブナー博士の死体を発見した 妻のエセルが出かけたとき 彼が昼食をとっていた場所だ
デモ隊がステージに殺到し、マイクへの電源を2度カットした後、ヘッジはスピーチを早期に終了させた。	デモ隊がステージに殺到し、マイクへの電源を2度カットした後、ヘッジは彼のスピーチを短くした。
午後7時頃、ベンがスパニッシュ・フォーク・キャニオンの未舗装の道路沿いに隠れているのを通行人が発見しました。両手はテープで固定されていましたが、足は自由でした。	木曜日の午後7時頃、スパニッシュ・フォーク・キャニオンの未舗装の道路沿いに隠れている少年を通行人が発見したのですが、彼の足は自由でしたが、手はテープで縛られたままでした。
アナリストは、177億ドルの収入に27セントの一株当たり利益を期待していた 、トムソン最初の呼び出しは言う。	ヒューレット・パッカードは、18億ドルの収益で、6億5900万ドル、または一株29セントの第2四半期の利益のために入れている。
医師によると、片方または両方の男の子が死亡する可能性があり、生存していても脳に何らかの障害が残る可能性があるとのことです。	医師は、少年たちの一方または両方が死ぬかもしれず、もし生き延びたとしても、脳に何らかの損傷を受ける可能性があると述べている。
また、スプリングデールのノースウェスト・メディカル・センターでは、1人が重体となっています。	スプリングデールのNorthwest Medical Center of Washington Countyで、子供1人が深刻な状態である。
" 私は泣き出し、彼に怒鳴った " どういう意味？' "	私は泣きながら、「どういうことだ！」と彼に怒鳴りました。
また、カリフォルニア州公務員退職年金制度の会長であるショーン・ハリガン氏は、27名からなるニューヨーク証券取引所の取締役会を縮小し、その構成を変え、より説明責任を果たすようにすることを提案しました。	カリフォルニア州公務員退職金制度の会長であるショーン・ハリガンも、27人の取締役を減らして、証券業界以外の投資家に席を割り当てることを提案した。
テキサス州フォートワースのアル・ラーセン（31歳）も行方不明です。	火曜日の朝、もう一人の犠牲者はテキサス州フォートワースのアル・ラーセン、31歳でした。
英国に本社を置くグラクソスミスクライン社は、今年初め、米国に出荷しているカナダのドラッグストアへの供給を停止すると発表した。	英国の医薬品メーカーであるグラクソスミスクラインは、米国に医薬品を出荷しているカナダの店舗への供給を打ち切ると発表した。
競争委員会は、提案された£41億合併について政府に最終評決を出した翌日、このフェスティバルは昨日キックオフされました。	競争委員会は昨日、テレビ局の大手2社、カールトンとグラナダの合併案について評決を下した。
スウェーデンの中央銀行も水曜日に会合を開き、木曜日に引き下げを発表すると広く予想された。	スウェーデンの中央銀行も水曜日に会合を開き、木曜日に半ポイントの引き下げを発表すると広く予想されています。
山火事で公園が閉鎖されるのは、この4年間で3度目です。	4年間で3回目の山火事で、メサベルデ国立公園、古代遺跡に捧げられた国の唯一の公園を閉鎖しました。
世界最大の自動車メーカーであるGMには、11万5000人の現役のUAW労働者と34万人の退職者とその配偶者がいます。	30万人以上のUAW従業員、50万人以上の退職者とその配偶者をカバーしています。
彼の1996年型シボレー・タホはバージニア州ヴァージニア・ビーチの駐車場に放置されているのが発見されました。6月25日、駐車場で発見されました。	彼のスポーツ用多目的車は6月25日、バージニア州バージニアビーチでナンバープレートなしに放置されているのが発見されました。
彼はしつこくつきまとい、結局、彼の車のフロントシートに座ったまま自転車を修理することを許したそうです。	彼女は結局、彼の車に乗っている間に自転車の修理をさせてもらい、おしゃべりをしたと言っていました。
ヒートリーは昨シーズン、41ゴールでリーグ6位、89ポイントで9位であった。	ヒートリーは昨シーズン、チーム記録の41ゴール、48アシストでアトランタの得点王となった。
ダニエルズは、今夜の一人2000ドルの大統領選資金調達パーティーで、ブッシュが自分について何を言うのか分からないと言った。	ダニエルズは、ブッシュが今夜の大統領再選のための資金調達のための1人2000ドルのレセプションで何を話すか分からないと言った。
第11連邦巡回控訴裁判所の3人の裁判官は、金曜日遅くに、小さなサイズ、限定的な使用、および世俗的な目的から、この画像を合法とする判決を下しました。	は、昨年出されたこの条例を支持する判決を覆し、セントルイスの第8回連邦巡回控訴裁の3人の裁判官のパネルが発表しました。
「と、スパーズ監督のグレッグ・ポポビッチ氏は語った。	私たちは3-2であることに興奮している、''コーチグレッグポポビッチは水曜日に言った。
エレクトロニック・データ・システムズ社は木曜日、証券取引委員会が同社に対し、米海軍との大型契約に関する文書の提出を求めたと発表した。	edsは、規制当局への提出書類において、証券取引委員会が、問題のあった米国海軍とのアウトソーシング契約に関する情報を求めてきたと述べている。
同社は、これまでで最大のアップルVAR xserveの単体販売であると主張している。	同社は、アップルストアによるXservesの販売としては最大であるとしている。
カエルは29科しか知られておらず、そのほとんどが1800年代半ばに同定・記述され、最後の1科は1926年に記述されました。	カエルの仲間は29種類しか知られておらず、そのほとんどは1800年代半ばまでに命名されました。
ブランデイス大学の関係者は、これはキャンパスにとって「非常に心苦しい」時間であると述べています。	「これは、ブランディス大学のコミュニティ全体にとって、非常に心を痛める時間です。
北米市場は、決算シーズンが減速し始め、経済指標が注目される中、方向感のない取引に終始した。	北米市場は、決算シーズンが減速し始め、経済指標が注目される中、月曜日の早朝に上昇した。
ドルフィン・スキームと同様に、この混乱は、外国企業が適切な監視や輸出規制なしに、有害な伐採や漁業に従事することを許しています。	内部の混乱により、外国企業が適切な監視や輸出規制を行うことなく、有害な商業伐採や漁業を行うことができるようになりました。
値は約124万ドルの合計になります 、転換証券を含む 、コレルによると。	転換証券を含む、取引の合計推定値は124百万ドルである 、コレルによると。
スタンダード＆プアーズ500株価指数は120ポイント上昇し、14％の上昇となり、この広範な市場のベンチマークとしては1998年以来最高のパフォーマンスとなりました。	スタンダード・アンド・プアーズ500株価指数（主要企業を代表する幅広い株式の集合体）は、昨日、1998年の最後の3ヶ月間以来、最高の四半期を終えた。
次の裁判は、2月中旬に3人の裁判官による判決が発表されたときに行われる予定です。	来年2月には、3人の裁判官からなる法廷が判決を下す予定です。
彼は1983年のスーパーボールで先発し、マイアミは27-17でワシントンに敗れた。	彼はマイアミで4シーズンプレーし、その中にはドルフィンズがスーパーボールでワシントンに27対17で負けた試合も含まれている。
ウォール街のアナリストのコンセンサスは、1株当たり28セントの損失と予想していました。	ファーストコールで調査したアナリストは、7億2300万ドルの売上と1株当たり28セントの損失を予想していました。
フィース国防次官（政策担当）は「圧力はない」と述べた。	国防次官（政策担当）のダグラス・フィース氏は、国防総省のブリーフィングで、「私は、誰かに圧力をかけた者など誰も知らない」と述べた。
nterprise linux サービスは、今年末までに提供される予定です。	エンタープライズ Linux サービスのベータ版は、7 月に一部の HP プロリアントサーバーで利用可能になる予定です。
一時的な項目を除けば、1株当たり6セントの利益を計上しました。	一時的な項目を除いて、1株当たり11セントから15セントの利益を見込んでいます。
"しかし、演説のために戦士の服装をするような デスクワークの大統領の動機には疑問を感じます"	上院の議場から発言したバード氏は、「演説のために戦士の服装をする、机に向かう大統領の動機に疑問を持っている」と述べた。"
より広い範囲のスタンダード＆プアーズ500インデックス.spxは3ポイント、0.30パーセント下落して995となりました。	技術系のナスダック総合指数< .ixic >は1.92ポイント（0.12%）上昇し、1,647.94となりました。
その代わり、ジャージージャムのチケットは昨晩からticketmasterで販売開始されました。	チケットは、ticketmasterを通じて、昨日発売されました。
グラント・ソントン スパは、月曜日に、「不正行為の被害者」であるという発言を繰り返した。	グラントソントンも詐欺の「被害者」であると主張している。
バークレー大学情報管理システム学部のピーター・ライマンとハル・ヴァリアンによると、1999年から2002年の間に、情報生産は毎年30％ずつ増加している。	この課題は、カリフォルニア大学バークレー校の情報管理システム学部の教授であるピーター・ライマンとハル・ヴァリアンという、メガバイトの達人2人に訴えかけました。
「私の判断では、その情報の95％は機密扱いを解かれ、検閲されなくなり、アメリカ国民が知ることになるはずです。"	私の判断では、その情報の95％は機密扱いを解かれ、検閲されなくなり、アメリカ国民は知ることができるだろう」とシェルビー氏はNBCの「ミート・ザ・プレス」で語った。"
が、腫瘍のあった場所には空の空洞と瘢痕組織しか見つかりませんでした。	腫瘍は検出されず、むしろ空の空洞と瘢痕組織が発見されました。
しかし、ワシントンは、そもそも苦情が出るのを防ぐために、もっと多くのことが必要だと述べた。	しかし、米国は、そもそも苦情が提出されるのを防ぐために、できれば法律全体を廃止して、もっとやってほしいと主張しました。
26時間に及ぶ手術と1年に及ぶ待ち時間の後、少年たちは日曜日にダラスの子供医療センターで引き離されました。	頭を結合して生まれた2歳のエジプト人の双子の男の子が、ダラスの子供医療センターでの26時間に及ぶ手術の後、分離された。
パインズ氏は、10日以内に関連する党組織を招集し、新たな選挙を実施するか、臨時のリーダーを任命するかを議論すると述べた。	ミツナとオフィール・パインズ党書記は、10日以内に党組織を招集し、新たな予備選挙を行うか、臨時のリーダーを任命するかを議論することで合意した。
彼女は泣いて怖がっていた」と、この店のオーナー、イサ・ヤシンは言った。	「彼女は泣いていて、本当に怖かったんだ」とヤシンは言った。
ユーロはアジアの取引で1.1914ドルまで急騰し、その後、ヨーロッパで取引が始まったときに1.1895ドルまでわずかに後退した。	ユーロはアジア取引で1.1914ドルまで急騰したが、欧州取引後半には1.1884ドルまで後退し、月曜日後半の1.1857ドルから上昇した。
アッバスはサミットで、彼は「武装したインテファデ」を終わらせるだろうと語った。	水曜日の首脳会談で、アッバスは「武装勢力」を終わらせることを約束し、「どこにいてもイスラエル人に対するテロ」を放棄し、武装勢力の武装解除を示唆した。
先月は、企業が9万3000人の雇用を削減したにもかかわらず、民間人の失業率はわずかながら改善し、6.1%になりました。	先月は、経済の健全性について複雑なシグナルが続く中、企業が93,000人の雇用を削減したため、民間人の失業率は6.1%に低下し、わずかに改善しました。
モフィットは、この結果を別の研究で再現する必要があり、その後に、この遺伝子のロングバージョンとショートバージョンの有無について個人を検査することになると述べた。	モフィット教授によれば、この結果は、遺伝子の長いバージョンと短いバージョンの存在について個人を検査する前に再現される必要があるとのことである。
「フランク・クワトロ-ンは無実である」とケ-カ-は声明で述べた。	クアトロンの弁護士ジョン・W・ケッカーは、クライアントは無実であると述べた。
アカデミー広報担当のロッド・ギボンズ大佐は、「アカデミーはショックを受け、悲しんでいる」と述べた。	海軍兵学校広報官のロッド・ギボンズは、「今日の発表は驚きだ」と述べた。
報酬委員会は、証券会社の取締役が委員になることを禁止する。	また、同取引所は、5名からなる報酬委員会を証券業界以外の取締役のみで構成すると発表しました。
lendingtreeの株式は6.21ドル、または42％上昇し、以前に21.36ドルを打った後、20.90ドル。	lendingtreeの株式は43％、6.31ドル、21ドルに上昇し、過去2ヶ月で2倍以上になりました。
先週、彼の弁護士はワーナーに、新しい判決公判につながるような条件で慈悲を与えるよう頼んだ。	先週、彼の弁護士はマーク・R・ワーナー州知事に慈悲を与えるよう求めたが、州知事は介入を拒否した。
Q : すぐに処方箋薬の保険に加入できますか？	congressは、処方箋薬の保険に加入するオプションという新しい特典を追加しました。
コロンバインで息子のダニエルを亡くしたブライアン・ロアボーは、「何年も前に公開されるべきだった」と語っています。	コロンバインで息子のダニエルが殺されたブライアン・ロアーボーは、このテープが気になる問題を提起していると述べました。
CIA長官ジョージ・テネットは、二人は「献身と勇気によって定義される」と述べた。"	CIAのジョージ・テネット長官は、「彼らは献身と勇気によって定義された」と述べています。
マンダレイの株式は8セントダウン$ 29.42に閉じ、収益が発表される前に。	マンダレイの株式は29.42ドルで木曜日にダウン8セントを閉じた。
しかし、金融アナリストが注視するソフトウェアライセンス収入は、21％減少し、1億760万 ドルとなりました。	ライセンス売上は、需要の主要な指標である21％減の1億760万ドルでした。
ドットソン（21歳）は、デネヒーが自分を撃とうとした後、デネヒーを撃ったと当局に報告した後、7月21日に逮捕・起訴された。	逮捕状の宣誓供述書によると、ドットソンは7月21日に、デネヒーが自分を撃とうとしたときに撃ったとFBI捜査官に話した後に逮捕された。
検察は、ダースト氏がブラック氏になりすますために殺人を企てたと主張しました。	検察はダーストが黒人を殺したのは黒人になりすますためだと主張しています。
この異議申し立ては、peoplesoftの取締役会がOracleのオファーを拒否する際に引用された。	peoplesoftの取締役会は、株主にこの提案を拒否することを推奨しています。
民主党の黒人指導者たちは、レイオフについて民主党のテリー・マウリフ議長と会談を持とうとしていた。	民主党の幹部は、党本部の少数派職員10人の解雇について、民主党全国委員会のテリー・マウリフ委員長との会談を手配しようとしていた。
ジュネーブに本拠を置く組織の事務局長であるジョバンニ・ビシニャーニは、声明の中で「私たちの業界にとって暗黒の時代だ」と述べています。	ジュネーブに本拠を置く国際航空運送協会のジョバンニ・ビシニャーニ事務局長は、「我々の業界にとっては暗黒の時代だ」と述べた。
このイニシアティブに参加している他の7カ国は、イギリス、ドイツ、イタリア、オランダ、ポーランド、ポルトガルとスペインです。	超能力に関与している他の国には、ドイツ、イタリア、オランダ、ポーランド、ポルトガル、スペイン、イギリスが含まれます。
ドルは円に対して116.92円で、セッションでフラット、そしてスイスフランに対して1.2891で、またフラットでした。	ドルは116.78円で、ほぼ横ばい、スイスフランに対しては1.2871で、0.1％下落した。
イタリアを訪れる外国人旅行者の40％以上がドイツ人である。	ドイツ人は、イタリアを訪れる外国人旅行者の4分の1以上を占め、ホテル予約の40％を占めています。
モスルでは、反乱軍が連合を支持するイスラム教の部族長を暗殺しました。	北部のモスルのモスクの近くで、反乱軍が連合を支持するイスラム教スンニ派の部族指導者も暗殺した。
平均的なアメリカ人は1日に4回、45％が買い物や用事のために移動しています。	約半数の45％が買い物や用事で利用している。
ブッシュ氏は、彼の論文を父親の大統領図書館に保管しようとしたが、そこでは半世紀にわたって秘密が保たれるはずだった。	テキサス州では、公共監視団体がブッシュ氏の論文を父親の大統領図書館に保管することに反対し、そこで半世紀にわたって秘密が保たれることになる。
1999年、ビルの所有者であるニューヨーク・ニュージャージー港湾局は、耐火材を1インチの厚さに改良するようガイドラインを発表しました。	NISTは、1999年に港湾局が耐火材を1.1/2インチの厚さに改良するガイドラインを発行していることを発見した。
ナイトライダーがグーグルのサービスにサインするオプションを持っていたことを考えると、これはオーバーチュアにとって戦略的勝利でもある。	また、ナイトライダーがグーグルの広告サービスを利用していたことから、オーバーチュアにとっても戦略的な勝利となる。
処刑までの数週間、フロリダ州当局者の何人かは匿名の脅迫状を受け取りました。	フロリダの関係者数名が脅迫状を受け取っており、ライフルの弾丸が添えられています。
これは合理的なPurifyplusと統合され、開発者はサポートされているバージョンのJava、Visual C＃、Visual Basic .netで作業することができます。	IBMによると、Rational製品はRational Purifyplusとも統合されており、開発者はJava、Visual C＃、VisualBasic .netで作業することができるそうです。
フリーマンの民事審理は、表面的には、運転免許証についてかもしれません。	フリーマンは、運転免許証を持っていないことが負担になっていると言っています。
デモ参加者は、国の強硬な体制に終止符を打ち、ハメネイ最高指導者の死を求めていた。	デモ隊は、国の最高指導者である強硬派のアヤトラ・アリ・ハメネイを非難した。
hoyは火曜日、女性の年齢を確認し、彼女は家族と一緒に休暇に出発したと述べた。	hoyは火曜日に女性の年齢を確認し、彼女は家族と一緒に休暇中であると述べたが、今週中に戻る予定である。
ボストンのカトリック大司教区は、500以上の聖職者の性的虐待の訴訟を解決するために5500万ドルを提供しています , 関連プレスによって得られた文書によると.	アメリカのボストン・ローマカトリック大司教区は、神父が関与する500件以上の性的虐待の訴訟を解決するために5500万ドルを提供した。
3時間分の録音には、警察、消防士、その他の救急隊員との会話や、メディアからの問い合わせが含まれています。	その中には、警察や消防などの救急隊員との会話や、メディアからの問い合わせも含まれています。
30年債のus30yt = rrは20 / 32にジャンプし、その利回りは4.18パーセントから4.14パーセントになりました。	30年債us30yt = rrは4.23パーセントから4.26パーセントの利回りのために14 / 32を浸漬した。
しかし、彼はこれまで全国労働者の支持を獲得している唯一の候補者であり、火曜日にアメリカ連合鉄鋼労働者が彼を支持したことで、11番目の組合を選んだのです。	しかし、彼はこれまで全国的な労働者の支持を獲得している唯一の候補者であり、火曜日に11番目の支持を獲得した。
オラクル社の株価は27セント（2％）下がり、13.09ドル。	オラクルの株式はまた、ニュースで上昇し、ナスダックで$ 13.51に15セントアップ。
北米の先物は、火曜日、投資家が四半期収益の最初の味を得る準備ができているとの取引のサブパー開始を指摘した。	火曜日、北米の株式市場は、投資家が四半期ごとの収益を初めて経験することになるため、スロースタートとなった。
スペインの精製会社セプサ・サが購入した100万バレルは、スペインのタンカー、サンドラ・タピアスに積み込まれる予定だった。	スペインのタンカー、サンドラ・タピアス号には、スペインの精製会社セプサ・サが購入した100万バレルが午後にも積み込まれる予定だった。
シンガポールはすでに米国で12番目の貿易相手国であり、双方向の貿易額は340億ドル以上に達しています。	小さな都市国家でありながら、シンガポールは米国の第12位の貿易相手国であり、昨年の貿易額は334億ドルでした。
ドルは最後に1.1149ドル/ユーロで、4月30日以来最も強いレベルに近かった。	ドルは取引開始時に1ユーロ＝1.1115ドルまで上昇し、火曜の1％上昇を延長して4月30日以来最も強いレベルを記録した。
市場全体の指標も大きく上昇し、4週連続の上昇となりました。	市場全体も4週連続で上昇した後、後退しました。
ジム・フューリックは、ゴルフのメジャー大会で初優勝し、父親として初めての父の日を祝いました。	父親として初めての父の日、チャンピオンとして初めてのメジャー大会。
2001年にレメルソン医療・教育・研究財団リミテッド・パートナーシップを経て、シンディアに譲渡されました。	その特許は2001年にレメルソン医療・教育・研究財団リミテッド・パートナーシップを通じてシンディアに譲渡されたと「言われている」そうです。
SIAによると、ドラマ市場は2003年に2.9％増の157億ドル、2004年には43％増の225億ドルになると予想されています。	米国市場は、2003年には2.1％減の306億ドル、2004年には15.7％増の354億ドルになると予測しています。
モリルの妻エリーは、葬儀の間、泣きながらボンデソンの義姉を抱きしめていました。	モリル未亡人のエリーは、人々が彼女を慰める中、泣きながらボンデソンの義理の姉を抱きしめた。
コノリー氏によると、9月11日以降、捜査官は何千時間もかけてアル・バユミを調査した。	コノリー氏によると、サンディエゴと海外のFBI捜査官は、アル・バユミの調査に数千時間を費やしたそうです。
カルビン・ホリンズ・ジュニア氏の弁護士であるトーマス・ロイス氏は、依頼人はE2を所有・運営していた会社とは何の関係もないと繰り返し述べている。	ホリンズJr.の弁護士であるトーマス・ロイスは、彼のクライアントがE2を所有・運営していた会社とは何の関係もないと言っています。
ユーロは135.13円まで上昇し、1999年1月のユーロ発足直後に記録した高値に並んだ。	単一通貨は135.26円まで上昇し、1999年1月の単一通貨導入以来の最高値となりました。
ニューキャッスル郡の女性が、デラウェア州で今年初めて西ナイルウイルスに感染したと、同州保健省が報告した。	西バビロンの62才の男性が西ナイルウイルスに感染しました サフォーク郡では今年初めての感染者です
グラスリー氏とボーカス氏は、薬剤給付の格差について否定した。	グラスレイとボーカスは、自分たちの計画ではそのようなアプローチは拒否していると言っていた。
また、北朝鮮の核危機を平和的に解決したいとの意向を再確認した。	しかし、北朝鮮の核問題は、彼の任期を支配してきた。
前年同期比では、11.4億ドルの売上に対し、1620万ドル、1株当たり15セントの利益を計上しました。	昨年の第2四半期には、1620万ドル（1株当たり15セント）の利益を計上しました。
PG＆E社の株式は、火曜日のニューヨーク証券取引所で15.59ドルで、39セント（2.6％）上がった。	pg＆eの株式は、ニューヨーク証券取引所での火曜日の取引の間に$ 15.44に24セント獲得した。
ナスダックは週足で17.27ドル（1.2％）上昇し、金曜の終値は1,520.15ドルでした。	技術系のナスダック総合株価指数（IXIC）は30.46ポイント（2.04％）上昇し、1,520.15となった。
「この決定は明らかに間違っている」とFTC会長のTimothy Murisは文書で述べている。	この決定は「明らかに間違っている」とFTCのティム・ムリス委員長は述べています。
捕らえられた反乱軍は、2,000人以上の反乱軍が攻撃に関与していると述べた。	捕虜となった反乱軍の兵士は、2,100人の戦闘員が攻撃に参加したと述べている。
「それは、人々を保留地に留めておくための大胆な脅迫であった」と、出席した共和党員は語ったが、名前は伏せた。	この会合に出席した共和党の議員は、「大胆な脅迫行為だ」と述べた。
告発は発表されなかったが、声明によると法的手続きは月曜日に行われる予定である。	FBIの声明によると、月曜日にはボルチモアの連邦裁判所で法的手続きが行われる予定です。
死んだ女性は、指輪とカルティエの時計も身につけていた。	「それは彼女の手首にカルティエの時計を身に着けているブロンドの髪の女性だ、 " ソースは言った。
ハイテク企業の多いナスダック株式市場総合指数は、14.17ポイント（0.94%）上昇の1,517.05となりました。	技術系銘柄が多いナスダック総合株価指数は、最近18ポイントほど上昇した。
MDCのスポークスマンであるポール・テンバ・ニャティ氏は、アベニュー・クリニックが野党支持者を治療していたため、標的にされたと述べた。	MDCのスポークスマン、ポール・テンバ・ニャティは、アベニュー・クリニックが野党支持者を扱っていたため、標的にされたと述べた。
日本は、スーチー氏が解放されない限り、多額の経済援助を停止すると発表し、国際的な圧力を強めている、と国連特使は述べている。	日本は昨日、ビルマに対する国際的な圧力を強め、軍事政権が民主化運動指導者のアウンサンスーチーを解放しない限り、多額の経済援助を停止すると脅した。
しかし、このコンセプトが非現実的に見えるのは、このコンセプトに対してほとんど努力が払われていないからだという。	「この提案は、宇宙計画と比べると控えめなもので、ほとんど努力が払われていないため、非現実的に見えるかもしれません。
しかしFBIは、アル・バヨミがサウジアラビアの諜報員であるという情報を入手していたにもかかわらず、それを監視することはなかった、と文書にはある。	しかし、アル・バヨミがサウジの秘密工作員であるという情報を事前に入手していたにもかかわらず、FBIはアル・バヨミを監視していなかった、と報告書は述べている。
エルモンテのチームスターズ・ジョイント・カウンシル42の会長であるジム・サンタンジェロは、「それは起こることだ」と言った。	エルモンテのチームスターズ・ジョイント・カウンシル42の会長であるジム・サンタンジェロは、「これは企業に大きな影響を与える」と述べている。
ウォルマート、コールズコーポレーション、ファミリー・ダラー・ストア・インコーポレイテッド。を、また、ファミリー・ダラー・ストア（FD）、ビッグ・ロット（BL）などを含む。そして、Big Lot Inc.は、5月の売上高がウォール街の控えめな予想を下回った商店の一つである。	ウォルマート、コールズコーポレーション、ファミリー・ダラー・ストアー・インクを、また、ファミリー・ダラー・ストア（FD）、ビッグ・ロット（BL）は、5月の売上高がウォール街の予想を下回った。は、5月の売上高がウォール街の控えめな予想を下回る結果となった。
彼は300万ドルの保釈金で釈放され、すぐにラスベガスに戻り、そこでビデオ撮影をしていた。	300万ドルの保釈金を払った後、ジャックソンはラスベガスに飛び、そこでビデオ制作に取り組んでいたのです。
ガートナーのアナリストによると、企業はまだ企業のPCをアップグレードする自信がないようです。	さらに、企業は古いPCを買い替えるほどの自信がないと、アナリストは述べています。
エディントン氏は昨日、航空会社の将来は「交渉担当者の手にかかっている」と警告した。	「BAの将来は交渉担当者の手に委ねられている」と、エディントンは日曜日に英国放送協会（BBS）のテレビ番組で語った。
火曜日現在、約250人の医療従事者が隔離されている。	さらに、6,800人が検疫を受け、数千人の医療従事者が作業検疫を受けています。
「この2人の子供たちは今、素晴らしい体調にあります」と、病院での記者会見で語った。	「この2人の子供は今、素晴らしい体調です」と、モンテフィオーレ小児病院の小児脳神経外科のディレクターでもあるグッドリッチは言った。
ブライアン・ブラバゾンは、彼の息子は動揺していたが、その後、彼を愚弄する人たちと仲良くなるのだと言った。	息子は怒ったけれども、その後、彼を非難する人たちと仲良くなるのだと、母親は言っています。
技術系が多いナスダック株式市場総合指数は、1.16ポイント増の1,504.04。	技術系銘柄が多いナスダック総合指数は、最近18ポイントほど上昇した。
テクノロジー系のナスダック総合指数は0.08ポイント低下の1,646となりました。	技術系のナスダック総合指数< .ixic >は1.92ポイント（0.12%）上昇し、1,647.94となりました。
昨日、マンハッタンにあるニューヨーク郡の最高裁判所に提訴しました。	この訴訟は、ニューヨーク郡最高裁判所に提出されました。
彼は陪審員にスタッブスは "冷酷で計算高い殺人者 "だと言った。"	ルパス地方検事はスタッブスが "冷酷で計算高い殺人者 "であることを陪審員に思い出させた。
同様に、30年債< us30yt = rr >は4.30パーセントから4.38パーセントの利回りのために1-11 / 32をスライドさせました。	30年債のus30yt = rrは20 / 32にジャンプし、その利回りは4.18パーセントから4.14パーセントになりました。
7人目の犠牲者である女性が火曜日の夜、アクロンのChildrens Hospital Medical Centerの火傷病棟で死亡しました。	7人目の21歳の女性は、アクロン子供病院の火傷病棟で危篤状態である。
マラウイ情報当局者が匿名を条件に語ったところによると、彼らはすぐにマラウイ航空のチャーター便で近くのボツワナに運ばれた。	彼らはマラウイ航空の飛行機で近くのボツワナに飛んだという。
アトキンソンの現在の年俸361,400ドルから、年俸395,000ドルにアップします。	ダインズの年俸は395,000ドル、アトキンソンの年俸は361,400ドルである。
が細胞表面に現れると、他の細胞によって異物が認識され、感染していると認識され、死滅します。	他の細胞に認識され、感染していると認識され、殺される。
それと引き換えに、北朝鮮は核兵器開発を中止するよう要求されるだろう。	「その見返りとして、我々は北朝鮮が核兵器を放棄することを期待している。"
「我々は、米国が率いる統治評議会を非難し、糾弾する」とモクタルダ・アル＝サドルは述べた。	サドル師は、ナジャフ近郊のクーファ・モスクでの激しい説教の中で、「我々は、米国が率いる統治評議会を非難する」と述べた。
sendmailによると、ビジネスだけの利用を許可するように設定することもできるそうです。	この製品は、ビジネスでの使用のみを許可するように指示することができます。
娘のニナ・アクセルロッドさんが語ったところによると、彼は寝ている間に亡くなったそうで、どうやら心不全が原因のようです。	アクセルロッドは心不全のため睡眠中に死亡したと、娘のニナ・アクセルロッドさんが語った。
この悪用は、サービスパック3および4のパッチを適用していないWindows 2000マシンで機能します。	CounterpaneとIdefenseの両社は、この脆弱性がサービスパック3および4を実行しているWindows 2000システムに対して有効に機能すると主張しています。
さらに曲線の外側では、ベンチマークとなる10年債のus10yt = rrが25 / 32の価格を流し、その利回りを3.17%から3.26%に引き上げた。	水曜日の初めに、ベンチマーク10年US10yt = RRは、16 / 32価格を失っていた、その利回りは3.26パーセントから3.33パーセントに火曜日遅くまで駆動します。
ハイテク株は、サンマイクロシステムズの業績予想が悪化し、今後の四半期決算の前兆と見なされた。	Sun Microsystems Inc.の業績予想が悪化したため、四半期決算を控えたウォール街にさらなる圧力がかかった。
昨日、Loralの取引は停止されましたが、月曜日には$ 3.01で取引を終えました。	ニューヨーク証券取引所は、金曜日に3.01ドルで取引を終えたLoralの昨日の取引を一時停止しました。
コークスの株式は、ニューヨーク証券取引所の水曜日の午後の取引で44.42ドルで6セント増加しました。	コークスの株式は、ニューヨーク証券取引所で44.10ドルでクローズするために26セントダウンしていた。
アーンスト・アンド・ヤングは、いかなる不正行為も否定し、この疑惑に対抗する予定です。	アーンスト・アンド・ヤングは証券取引委員会の主張を否定し、その勧告を「無責任」であるとした。
軍事行動も大規模な贈収賄も、北朝鮮問題を解決することはできない、とウォルフォウィッツは言う。	実際、ウォルフォウィッツは土曜日に、軍事行動も「大規模な贈収賄」も問題解決にはならないことを認めた。
運転手のユージン・ロジャーズは、バスから子供たちを連れ出すのを手伝ったという。	事故現場では、運転手は「血まみれ」だったが、子供たちを連れ出すのを手伝ったと、木は言った。
スタンダード＆プアーズ500指数< .spx >は9.69ポイント（0.98%）上昇し、994.53となりました。	技術系のナスダック総合指数 < .ixic > は18.35ポイント（1.13%）上昇し、1,646.02となりました。
ノックス郡保健所は、国立疾病対策予防センターのプロトコルに従って、感染を抑制しています。	保健省の広報担当者は、同省は疾病管理センターのプロトコルに従っていると付け加えた。
ギダント社の株式は、ニューヨーク証券取引所での取引で急落し、正午過ぎにニュースストップがかけられました。	ギダントの株式は、ニューヨーク証券取引所の午後の取引で40.92ドルで5.3％減少した。
ワシントンD.C.地域の狙撃事件から約1年後の月曜日、「3 weeks in october」が発売されます。	ムースの本が月曜日に発売されます。ワシントン地区での狙撃事件からほぼ1年。
2002年の交通事故死者数のうち、ロールオーバー事故による死者は82％を占めたという。	2002年の死亡事故は、ロールオーバー事故が82％を占めたとNhtsaは述べている。
世帯を対象とした別の調査によると、8月の失業率は6.2%から6.1%に低下しました。	労働省のアナリストは、8月に6.2%から6.1%に低下した全米失業率のわずかな改善を割り引いている。
ポンドはまた、ドルに対して進歩した、1.6789ドルで新たな3年間の高さに達した。	英国ポンドは、ドルに対してその筋肉を曲げ、最後に1.6672ドルで1％上昇した。
学校長のジョエル・クラインは、より高い水準と説明責任の推進が「結果を出している」と述べた。"	学校長のJoel Kleinは、その結果に満足していると述べた。
ノルウェーとスウェーデンでは、1950年代から皮膚がんの発生率が3倍になっているとのことです。	また、ノルウェーとスウェーデンでは1950年代以降、皮膚がんが3倍近くに増加していることも明らかになった。
目撃者の一人は、飛行機がまだ空中にあるときに燃えているのを見たとアナトリアンに言った。	目撃者の一人は、飛行機が空中で燃えているのを見たとアナトリア・ニュースエージェンシーに語った。
また、裁判官は9月29日の公判期日を延期することを拒否しました。	オーバスはまた、9月29日の公判期日を延期するとの弁護側の申し立てを却下した。
野党は抗レトロウイルス治療に関する閣議決定を歓迎しているが、マント・ツァバララ・ムシマン保健相は展開計画を主宰するのに適していないとする意見もあった。	一部の野党によると、manto-tshabalala msimang保健相は、抗レトロウイルス治療の展開計画を主宰するのに適していないとのこと。
米国レコード協会によると、来月には曲の売買業者を訴える予定だそうです。	それは、アメリカのレコード産業協会がそれについて何か言うことがあればの話ですが。
チーフマーチャンダイジングオフィサーは、商品の買い付けと開発を監督し、会社のマーチャンダイジングの方向性、つまり基本的に何を表すべきかを決定します。	その人は、会社のマーチャンダイジングの方向性、つまり、基本的に会社の象徴となるべきものを決めているのです。
大司教区のスポークスマンであるクリストファー・J・コイン牧師は、金曜日にはコメントしなかった。	大司教区のスポークスマンであるクリストファー・コイン牧師は、コメントを求めるいくつかの電話にすぐに応答しなかった。
スタンダード＆プアーズ500指数< .spx >は7.57ポイント（0.76％）下がり、990.94となった。	テクノロジー系のナスダック総合指数は25.36ポイント（1.53％）安の1,628.26だった。
オーストラリア人の犠牲者の親族が何人も法廷に現れ、裁判を傍聴していたが、バリ人はほとんど出席しなかった。	オーストラリア人の犠牲者の親族が何人も法廷の最前列に座っていたが、バリ人はほとんど裁判に出席しなかった。
7月10日、シンガポールの警察官32人のチームがバグダッドに派遣された。	7月、シンガポールの警察官32人がバグダッドに派遣され、イラク警察の訓練を手伝い、先月帰国した。
ユーロ<ユーロ= >は1.1784ドルでドルに対して0.67パーセント上昇した後、上記のセッションで3ヶ月の高さに上昇した1.18ドル 。	初期の米国での取引では、ユーロ<ユーロ= >は1.1860ドルの4ヶ月の高さに上昇した後、1.1741ドルに0.6パーセント減少していた。
以前は、1,200万ドルの利益、または1株当たり0セントを報告していました。	以前は、1,200万ドルの小さな利益、あるいは1株当たりの損益分岐点を報告していました。
木曜日、PeopleSoftはOracleからの入札を正式に拒否した。	木曜日の朝、Peoplesoftの取締役会はOracleの買収提案を拒否した。
過激派の全国学生団体を含む運動団体の連合が、裁判所の禁止命令に反してNLCが呼びかけた抗議行動を支持している。	過激派の全国学生団体を含む運動団体の連合は、この行動を支持し、抗議行動に動員している。
同社は、新しいメインフレーム・アプリケーション環境（Eae）に、.netとj2eeのサポートが追加されたことを強調しています。	また、エンタープライズ・アプリケーション環境の開発ツールセットに、.netとj2eeのサポートを追加する予定だという。
彼は、フィリバスターを克服するために必要な票数をどんどん少なくしていくシステムを提案した。	フリストは、司法承認の最終投票を妨げるフィリバスターを克服するために、徐々に少ない票数で済むようにするプロセスを提案した。
1971年に起用されて以来、45件の事故を記録し、393人が死亡している。	47件の事故で668人が死亡するなど、安全性に問題がある。
フロリダ州ダニーデン高校出身の外野手、ライアン・ハーベイがシカゴ・カブスから6位で指名された。	フロリダの高校生外野手、ライアン・ハーベイがカブスに6位で指名されました。
グローバーは、犠牲者の親族20人ほどが出席した記者会見で、次のように述べた。	記者会見には、犠牲者の家族約20人が招待された。
6月に起訴された他の4人は、すでに有罪を認めています。	被告人のうち4人は武器使用などの罪状を認めた。
両論文は、本日、NEW ENGLAND JOURNAL OF MEDICINEに掲載されました。	この研究は、本日、NEW ENGLAND JOURNAL OF MEDICINEに掲載されました。
ハリケーン「イサベル」の影響で、連邦政府と地方政府は大部分が閉鎖され、学校も閉鎖され、地域の交通網の大部分に遅れが生じました。	ハリケーン「イサベル」の余波で、連邦政府と地方政府は依然として閉鎖され、学校や多くの企業も閉鎖されたままです。
エストロゲンとプロゲスチンを組み合わせたホルモン補充療法は、女性の乳がんのリスクを2倍にする、100万人以上の女性の英国の研究が発見されました。	英国の大規模な研究により、ホルモン補充療法は乳がんのリスクを高めるという証拠が追加されました。
彼は、昨日支持を表明したアメリカ鉄鋼労組に、驚くほど熱のこもったスピーチをしました。	火曜日、彼はアメリカ鉄鋼労組の支持を得た。
10月1日に施行される予定だったこのリストには、約5,000万件の電話番号が登録されています。	FTCは5000万件の電話番号をリストに登録し、10月1日に発効する予定だった。
「そして、約8〜10秒後に、私は.	"私は8秒ほど水に浸かっていました。
しかし、アドラ・オビ・ヌウェズNAACP州会長は、州は殺人の可能性を考慮するのではなく、自殺の結論を証明しようとしただけだと述べた。	NAACPのアドラ・オビ・ヌウェズ州代表は、州は殺人の可能性を考慮することを拒否していると述べた。
専門家は、河北でどれくらいの患者が農村部にいるのか言わなかった。	河北は、191例と8死亡を報告している、しかし、誰が専門家は、農村部であったいくつかを言わなかった。
活動家たちは、この集会が、飢餓に苦しむ国々に生物工学的作物を押し付けようとする企業農業の試みであると懸念している。	しかし、彼らはこの会議が、農業とバイオテクノロジーの企業が新しい市場に参入しようとする試みであることを危惧している。
彼らの契約は、日曜日の午前12時1分ではなく、水曜日の午前12時1分に切れると、united food and commercial workers local 700の組織ディレクターであるRian Wathenは言った。	「と、食品・商業労組700支部長であるライアン・ワテン氏は語った。
テクノロジーが盛んなナスダック総合指数（IXIC）は、火曜日に2％以上下落した後、39.39ポイント（2.2％）上昇の1,826.33となりました。	ダウ平均株価は、前日1％以上下落した後、194.14ポイント（2.09％）上昇し、9,469.20となりました。
オクラホマ・ガス・アンド・エレクトリック社は、この地域で約14,000人の顧客が停電していると発表した。	オージ・エネルギー社の顧客約38,000人が停電していると、同社はウェブサイトで発表した。
そして今、ブランカのアメリカ人の夫、63歳のロジャー・ローレンス・ストランクが、フィリピン政府によって2月に出された殺人事件の起訴状に直面しており、彼が第一容疑者であると述べているのです。	現在、ブランカの夫でトレイシーの63歳のロジャー・ローレンス・ストランクは、2月にフィリピン政府によって出された殺人事件の起訴に直面している。
バルビーニ氏のコメントは、農業科学技術に関する閣僚会議と博覧会の2日目である火曜日に発表されました。	米国農務省のアン・ヴェネマン長官は、3日間の農業科学技術に関する閣僚会議と博覧会を月曜日に開幕させました。
昨日、株式は29セント、または0.54パーセント、54.32ドルでクローズアップ。	amazonの株式は昨日、ナスダック株式市場で$ 54.32で閉じた 、最大29セント。
王子はサンフォード・サンディ・ヴァイルの後任として、シティグループの会長にとどまる予定です。	サンフォード・ワイルの後任として、シティグループのグローバル企業・投資銀行を率いる王子がCEOに就任する。
営業収入は14億5,000万米ドルで、前年同期の13億8,000万米ドルから増加しました。	営業利益は、前年の13億8,000万米ドルから14億5,000万米ドルに増加しました。
スポット金は、369.50ドルに上昇した後、1000 GMTで1オンス367.90 / 368.60ドルで提示された - 2月10日以来のレベル。	スポットゴールドは358.65 / 359.15ドルで0500 GMTに提示され、359.25ドルの高さに飛び込んだ - 2月25日以来のレベルです。
カナダでは、好調なドルが75セント（米国）を上回ろうとするため、再び注目される。	カナダでは、急騰したドルが再び注目され、75セント（米国）を上回ろうともがき、わずかに届かなかった。
しかし、判事たちは、マルティネスに繰り返し質問をした警察の上司は、その際に憲法修正第5条の権利を侵害しなかったと判決を下した。	しかし、判事たちは、痛みに悲鳴を上げるマルチネス氏に繰り返し質問をした警察の上司は、彼の憲法修正第5条の権利を侵害しなかったと判決を下したのです。
ロート製薬は、フロリダの刑務所制度における最初の信仰に基づくプログラムではありません。	しかし、ローティはその道を歩む最初の刑務所全体なのです。
「この証人には立ち会いたくない」と、スタニスラウス郡上級裁判所のアル・ジロラミ判事に告げました。	「この証人には立ち会いたくない」ピーターソン（31歳）は、独房に戻される際、冷静に裁判官にそう告げた。
ダウ平均株価は5日連続で上昇した後、44ポイント（0.47％）安の9,543ドルになりました。	ダウ平均株価は18.25ポイント（0.19％）上昇し、9,586.71となりました。
同センターの社長ジョセフ・トルセラは頭を打ったが、歩いて救急車に乗ることができた。	国立憲法センターのジョセフ・トルセラ総裁は頭を殴られ、膝をつきました。
この報告書は、雇用、マーケティング、調達、地域社会への再投資、慈善寄付を基準に、大企業45社をランク付けしています。	大企業45社の雇用、マーケティング、調達、地域社会への再投資、慈善寄付に関するランキングに回答したのは、このうちディラード社だけでした。
「今話している人が、別の機会に、ルールを守らない人になるかもしれない」とパリッシュは言った。	「今話している人が他の人になるかどうかはわからない」とパリッシュは言った。
ラフナー（45歳）は、殺人容疑でまだ弁護士を持っていないと、当局は言った。	ラフナー（45歳）は、殺人容疑について弁護士を持っていないと当局は述べた。
彼らは事件の捜査のため、入国管理法違反で拘束されています。	両名は入国管理法違反の捜査のために拘留されています。
1999年に可決されたが、施行されなかった。この法律は、バーやレストランの常連客がタバコを吸うことを違法とするものだった。	1999年に可決されたが、施行されなかったこの喫煙法は、バーやレストランの利用者がタバコを吸うことを禁止するものだったが、プライベートクラブは規制から除外されていた。
この取引により、ハンドスプリングの株主は、ハンドスプリングの普通株式1株に対して、0.09株のパーム（パームソース社の株式は含まず）を付与されることになります。	本取引の条件案では、Palmsourceのスピンオフ後、パームはハンドスプリングの株式1株に対して0.09株を交換することになります。
この報告書によると、カナダの薬局で販売されている医薬品は、カナダ保健省（FDA）の認可を受けた施設で製造されています。	この報告書によると、カナダの薬局で販売されている医薬品は、カナダ政府にとってFDAと同様の役割を果たすカナダ保健省が承認した施設で製造されているとのことです。
200人以上が死亡したバリ島のナイトクラブ爆破事件の容疑者の初公判が、インドネシアで今日開かれたとスカイニュースが報じた。	バリ島で200人以上が死亡したナイトクラブの爆破事件の主要な容疑者の一人が、厳戒態勢の中、月曜日に裁判にかけられた。
2040年には、フランス人の退職者が人口の5分の1から3分の1に増加すると言われています。	2040年には、退職者が人口の3分の1を占め、現在の5分の1から増加すると予想されています。
イラクの警察は、賄賂を支払ったとして仕事を与えるよう要求したデモ隊が警察署を襲撃した後、バグダッドのダウンタウンで発砲しました。	イラクの警察は、雇用を求めるデモ隊が警察署を襲撃し、警官に投石した後、水曜日のバグダッドのダウンタウンで発砲したと述べた。
ダウ平均株価は28ポイント（0.27％）高の10,557ドルで、21カ月ぶりの高値となった。	ダウ平均株価は49ポイント（0.47％）上昇し、10,578ドルとなりました。
前年同期比では、3億5,400万ドル、1株当たり72セントの利益を計上しました。	edsは、第1四半期に1億2600万ドルの損失、または1株当たり26セントを報告しました。
マイクロソフトは、28.91ドルの木曜日の終値から27.45ドルにオープン前に5％下落した。	マイクロソフトの株式は$ 28.91のナスダックの終値から$ 27.54に時間外取引で4.7パーセントを滑らせた。
CIBC WORLD MARKETSのアナリスト、マット・ゲラー氏は、「これは非常に速い」と述べた。	CIBC WORLD MARKETSのアナリスト、マット・ゲラー氏は「今年はベルケイドの売上高を記録することになるだろう」と述べた。
この巨大な岩は、ニューメキシコ州ソコロにあるリンカーン近地球小惑星研究プログラムによって、8月24日に初めて観測された。	この岩は、リンカーン近地球小惑星研究プログラム（通称リニア）によって初めて観測された。
和平合意にもかかわらず、反政府軍と政府軍の両方がリビアの田舎で村の略奪を行ったと非難されている。	和平協定にもかかわらず、反政府軍と政府軍の両方が、リビアの田舎で村の略奪を行ったと非難されている。
マイクロソフトは、インスタントメッセージにおいて、通信相手がメッセージを入力する際にユーザーに警告する機能に関する特許を取得しました。	マイクロソフトは、会話の相手側がメッセージを入力しているときにユーザーに表示する人気のインスタントメッセージの機能に関する特許を取得しました。
オニール氏の後任が誰になるかは不明である。	ヒュンダイではオニール氏の明確な後継者はいない。
「古い習慣を変え、いつものビジネスを真剣に考え直す必要がある。"	そして、「自己満足に陥らないように」、「古い習慣を変え、いつものビジネスを真剣に見直すように」と社員に呼びかけました。"
この逮捕によって、セレンスキーのマウントオリベットロードの自宅での4ヶ月に及ぶ捜査について、新たな詳細が明らかになりました。	6月5日、セレンスキーのマウント・オリベット・ロードの自宅でケルコウスキーとファセットの死体が発見された。
我々は精力的に控訴するつもりであり、最終的に正当性が認められると期待しています。	私たちは、これは悪法だと考えており、最終的に正当性が証明されることを期待しています。
「これらの卑劣な行為は、憎しみだけを信条とする殺人者によって行われた」とブッシュは述べ、米国は殺人者を見つけると付け加えた。	これらの卑劣な行為は、憎しみだけを信条とする殺人者たちによって行われた。米国は殺人者たちを見つけ出し、彼らが米国の正義の意味を学ぶことになるだろう。
カンザス州の法律では、16歳未満の子供が性的関係を持つことは違法です。	意見では、クラインは、それは性的関係を持っているためにその若い子供のために違法であることを指摘した。
この買収により、カレボー社の消費財事業の売上高は23%から45%に拡大します。	この買収により、カレボー社の消費財事業の売上高は約45％拡大し、売上高全体の約3分の1を占めることになります。
インドネシア軍は、ガムの独立のための戦いでしばしば人権侵害で非難されてきたが、分離主義者の権利侵害を非難する一方で、一般的に否定してきた。	インドネシアの軍隊は、以前ゲームとの戦いの際に人権侵害で非難されたが、一般的に否定している。
イラクの経済は、サダム・フセイン元大統領による1990年のクウェート占領をめぐる長年の国連制裁と、4月に終結した同大統領を追放するための米国主導の戦争で荒廃した。	イラクの経済は、サダム・フセイン前大統領の時代と、4月に終結した同大統領を追放するための米国主導の戦争によって破壊された。
また、英語/トルコ語の辞書で難民という単語を指している人もいました。	一人の男が英トルコ語辞典を手に、「難民」という単語を指さした。
資金の大部分は、約650億ドルで、イラクとアフガニスタンでの軍事作戦に使われます。	法案の大部分（647億ドル）は、主にイラクとアフガニスタンでの軍事作戦のために使われます。
米国憲法では、議会のもう一つの議会である下院は、外国との同盟について投票することはありません。	米国議会のもう一つの議会である下院は、条約について投票することはありません。
コロラド・スプリングスのドロレス・マホイ（68歳）。は、議会で審議中の法案によって助けられるかもしれない人です。	コロラド・スプリングスのドロレス・E・マホイさん（68歳）は、まさに議会で審議中の法案に助けられるかもしれない人たちです。
証券取引委員会もコークスの非公式な調査を開始しました。	その連邦政府の調査は、証券取引委員会による非公式な調査とは別のものである。
ニューヨーク証券取引所では、前進する銘柄が後退する銘柄を約8対5で上回った。	ニューヨーク証券取引所では、下落銘柄が上昇銘柄を3対1でわずかに上回った。
には、659人の女性が在籍しているという。	調査時点で659名の女性が在籍していました。
これは、事実上すべてのアメリカ人に関わる国家的な問題である」とエイブラハムは述べています。	天然ガス不足の影響は「事実上すべてのアメリカ人に及ぶ」とエネルギー省のスペンサー・エイブラハム長官は昨日警告した。
来週イタリアで開催されるビューティー・コンテストは、ピクセル・パーフェクト・ピンナップとしては初めてのものになるかもしれません。	来週イタリアで開催される新しいビューティーコンテストでは、ピクセルパーフェクトなピンナップが、セクシーなソフィアのセックスシンボルの地位を奪うチャンスが与えられます。
米国では、全女性の20.7％が喫煙しています。	ネバダ州は、女性が最も多く喫煙する州であり、その割合は28％です。
トムソン・ファースト・コールのアナリストのコンセンサス予想は、一過性の項目を除いて、1株当たり2.08ドルの損失でした。	トムソン・ファースト・コールが調査したアナリストの予測では、1株当たり2.75ドルの損失を予想していました。
5ホールを残してトップタイだったリー・ジャンゼンは68でフィニッシュし、6位タイとなった。	リー・ジャンゼンは、残り5ホールで首位に並びましたが、68でフィニッシュし、ボブ・クレーン（67）と同ポイントの269で6位タイとなりました。
テネットは、11月に元最高経営責任者のジェフリー・バーバコフが、同社が積極的な価格設定を行って、最も病気の多いメディケア患者への支払いを高くしていたと発言して以来、監視の対象となっている。	11月、当時の最高経営責任者であったジェフリー・ブラバコウは、同社が最も病気のメディケア患者に対してより高い支払いを受けるために、積極的な価格設定を行っていたと述べました。
ボーイング社の取締役会は、12月の会合で、航空機を航空会社に販売するかどうかを決定する予定である。	ベア社が航空会社に飛行機を販売することを正式に承認することが広く期待されている。
ブッシュは、米国の駐留に敵対する抵抗勢力が「そこで我々を攻撃できるような状況になっていると感じている」と述べた。	このような状況であれば、我々を攻撃することができると思っている人たちがいるのです。
誤差はプラスマイナス4％ポイントです。	この世論調査は、有権者数712人、サンプリング誤差はプラスマイナス3.7％ポイントです。
弁護団は、裁判前の大規模な広報活動によって陪審員団が依頼人に不利になるため、会場の変更が必要であると述べていた。	弁護団は、裁判前の大規模な広報活動によって陪審員が依頼人に不利な状況に置かれていると主張し、会場の変更を要求していた。
1996年に設立されたlendtree exchangeは、200以上の銀行、貸し手、ブローカーで構成されています。	lendingtreeは、インターネットを介して、200以上の住宅ローンブローカー、銀行、その他の金融業者と借り手をマッチングします。
ほとんどの納税者は、7月1日から週に4ドルから11ドルの減税を受けることになります。	オーストラリアの900万人の所得税納税者は、昨夜、ピーター・コステロ財務長官から週3ドルから11ドルの減税をサプライズで受けた。
monyの株式は2.57ドル、または9％を獲得していた31.90ドル、時間外取引でinstinetの 。	ニューヨークの時間外取引で、モニー社の株価は8.76％上昇し、31.90ドルになった。
地元の災害対策本部長であるジョルジ・ヘイズラー氏によると、このバスには38人の乗客が乗っていた。	地元の災害対策本部長であるGyorgy Heizler氏によると、バスの運転手は赤信号を無視したとのこと。
今年の4年制私立大学の授業料は平均19,710ドルで、2002年から6％上昇しました。	今年度、公立大学の授業料は平均 4,694 ドル、前年度より約 600 ドル上昇しました。
州全体の失業率は6.4%に低下し、8月の6.7%（改定値）から低下しました。	サンホーキン郡の失業率は先月8.5%に低下し、8月からほぼ1%ポイント低下しました。
ダイアナは自分を狙った陰謀だと ポール・バレルに手紙を書いたとき 最悪な状態だったんです	バレルによると、ダイアナは1996年10月に、自分を殺す陰謀があると主張する手紙を書き、保険として彼に渡したそうです。
セキュリティライトも設置され、警察は敷地内にブービートラップがないかを監視しています。	また、正門近くの納屋にはセキュリティライトも設置しました。
しかし、米軍は敵の位置が特定できれば、襲撃や攻撃も辞さないだろう。	しかし、アメリカ軍は、敵の位置が特定できる場所での襲撃も辞さないでしょう。
火曜日、ムーアはすぐにコメントを出せなかった。	火曜日、ムーアは即答できなかった。
8月8日、裁判官はその子を州の保護下に置くよう命じました。	8月8日、少年裁判所のロバート・イーツ判事はパーカーを保護拘置にするよう命じた。
GillespieはCBSの社長Leslie Moonvesに手紙を送り、歴史的なレビューや免責事項を求めた。	共和党全国委員会のエド・ギレスピー委員長は金曜日、CBSテレビのレスリー・ムーンベス社長に書簡を出した。
しかし、ホワイトハウスのフライシャー報道官は昨日、「イラン側が主張するアルカーイダを捕捉するための措置は不十分である」と述べました。"	「イランが主張するアルカイダ捕捉のための措置は不十分である。
ドットソンは月曜日、生まれ故郷のメリーランド州で逮捕され、殺人罪で起訴されました。	その後、21歳のドットソンがデニー殺害の罪で起訴された。
また、この買収提案は、2003年9月30日までにドラックスの上位銀行、上位債券保有者、ヘッジ銀行が合意することが条件であるとも述べています。	また、ゴールドマンは9月30日までにDRAXの上位銀行、上位債券保有者、ヘッジ銀行と契約を締結することが条件となる。と述べています。
この結果は、火曜日にシアトルで開催されたアメリカ胸部学会で発表され、木曜日のnew england journal of medicineに掲載される予定です。	この研究結果は、シアトルで開催された米国胸部学会で発表され、明日のNew England Journal of Medicineに掲載される予定です。
彼の反対意見には、ウィリアム・H・レーンキスト最高裁判事とクラレンス・トマス最高裁判事が賛成しました。	ウィリアム・H・レーンキスト裁判長、アントニン・シェリアとクラレンス・トーマスは反対しました。
ユナイテッドはすでに、雇用目標の第一ラウンドを達成できなかったとして、市に3400万ドルの違約金を支払っている。	ユナイテッドは、雇用目標を達成できなかったとして、3400万ドルの違約金を支払った。
シェリーの事務所によると、575,926人の署名が報告されたそうです。	シェリー事務所は金曜日遅くに署名の数を発表し、各郡がこれまでに575,926人の署名を数えたと報告した。
ブッシュは「パイロットが見たのと同じように航空機の着陸を見たい」と思っていた、とホワイトハウスのアリ・フライシャー報道官は昨日語った。	火曜日、バードの演説の前に、フライシャーは、ブッシュが「パイロットが見たのと同じように、航空機の着陸を見たい」と言った。
刑務所の門から150ヤードほど離れたところに、ロックランド郡パトロールマンズ慈善協会のブレント・ニューバリーが記者やカメラマンと一緒に立っていた。	「と、ロックランド・カウンティ・パトロールマンズ・ベンシャント・アソシエーションのブレント・ニューバリーは嘆いた。
"彼らは残酷に殴られた" "この事件でポーチャが唯一の死者であることは本当に不思議だ。"	「この事件で死亡したのがポルチアだけだったのは不思議だ」とサックスは付け加えた。
「と、ユニファイ関係者のロブ・オニール氏は語った。	ユニフィアのオフィシャルロブ・オニール氏は、「グローブは外されている。
プラット＆ホイットニー社は、エンジン設備の75％をヨーロッパにアウトソーシングし、最終組み立てをドイツで行うと発表していた。	プラット＆ホイットニー社は、もし契約を獲得すれば、エンジン設備の75％をヨーロッパのサプライヤーに委託し、最終組み立てはドイツで行うと述べていた。
スタッフライターのセルウィン・クローフォードとコリーン・マッケイン・ネルソン、dallasnews.comのブライアン・アンダーソンがこのレポートに寄稿しています。	スタッフライターのBrandon FormbyとColleen Mccain Nelsonがこのレポートに貢献しました。
商務委員会は、このような取引にとって重要なハードルであっただろう。	ニュージーランド商業委員会は、ウェストパックとの取引を承認するかどうか、何の示唆も与えていませんでした。
検察はリー氏に死刑を求刑することを通知する動議を提出しました。	また、検察は死刑を求刑することになるだろうと付け加えた。
「6週間以上前から店頭に並んでいる」とカーニーは言う。	四季報は通常6週間から8週間店頭に並びます」とカーニーは付け加えた。
Peoplesoftの経営陣がどう考えているかは別として、OracleはPeoplesoftの顧客と製品を今後何年にもわたって完全にサポートするつもりです。"	エリソン氏は、Peoplesoftの経営陣の主張とは逆に、オラクルは今後何年にもわたって「Peoplesoftの顧客と製品を完全にサポートする」つもりであると述べています。
アメリカの巨匠たち：アーサー・ミラー、エリア・カザンとブラックリスト：罪なき者（wed .	アメリカン・マスターズ」シリーズのこの恐ろしい比喩の小見出し、「アーサー・ミラー、エリア・カザンとブラックリスト：罪なき者はいない」に注目してください。"
そのパッケージには、市の売上税と所得税の両方の増税が含まれていた。	また、このパッケージの消費税と個人所得税の増税にも反対している。
世界最大のソフトウェア会社は、複数のパッチが企業にもたらす困難を認識し、彼らがアップデートを適用するために容易にするために着手したと述べた。	世界最大のソフトウェア会社である株式会社エヌ・ティ・ティ・ドコモは、複数のパッチを適用しようとする企業にとって困難であることを認識していると述べています。
しかし、価格の下落率は過去2四半期、前年同期比30％未満にとどまっている、とIdCのアナリスト、ジョン・マッカーサーは述べています。	mcarthurはinternetnews.comに、価格の下落は緩やかになり、過去2四半期は前年比30％以下にとどまったと語った。
プーチン大統領は、サウジアラビアを「最も重要なイスラム国家の一つ」と賞賛した。	会談の前にプーチンは、ロシアはサウジアラビアをイスラム教の重要な国家と見なしていると述べた。
曲は、それぞれ99セント、またはアルバムのための9.99ドルのために提供されています。	は、楽曲を99セント、アルバムを9.95ドルで提供する予定です。
「確かに、私たちが知っていることは、彼らが言っていることを非常に真剣に受け止めるべきだということを示唆している」 と彼は付け加えた。	「というのも、私たちはすべてを知っているわけではありませんが、私たちが知っていることは、彼らが言っていることを真剣に受け止めるべきであると示唆しているからです。
メキシコの法律では、賞金稼ぎは誘拐の一種と考えられています。	賞金稼ぎはメキシコでは違法であり、賞金稼ぎは誘拐の罪に問われた。
ジレットの株式は1.45ドル、4.5パーセント上昇し、午後のニューヨーク証券取引所の取引で33.95ドル。	ジレットの株式は、ニューヨーク証券取引所で水曜日の取引で$ 33.70で45セントダウンして閉じました。
ニューヨーク証券取引所で、サンディエゴに本社を置くジャック・イン・ザ・ボックスの株価は21.49ドルで、78セント（3.8％）上昇しました。	タンパに本拠を置くアウトバックステーキハウス社の株式は、ニューヨーク証券取引所で44.50ドル、1.78ドル、4.2％増で引けました。
ダウ工業株は140ポイント以上上昇し、12月以来初めて9,000ドルの大台に乗せました。	ダウ工業株は12月以来初めて9,000ドルの大台を一時的に突破した。"
アムステルダムで開催された国際放送会議(IBC)で発表されました。	提出は月曜日でしたが、発表は金曜日にアムステルダムで開催された国際放送会議で行われました。
全米の控訴裁判所は、この問題に関して異なる判決を下しており、あるケースでは十戒の公開展示を認め、別のケースでは禁止しています。	下級審では、十戒の描写を認める場合と認めない場合があり、この問題で意見が分かれています。
国土安全保障省は火曜日、肩撃ちのミサイル攻撃から民間航空機を守る計画を策定するため、3つの企業を選んだと発表した。	国土安全保障省は火曜日、米国の民間航空機に対する肩撃ちのミサイル攻撃を阻止する方法の研究を継続するため、3社を選定したと発表しました。
タミル・パーティーは、これらの殺害をタミル・イーラム解放の虎（LTTE）のせいにしている。	政府は、タミル・イーラム解放の虎（LTTE）との協議を再開し、暫定的な構造について議論することを望んでいた。
グラスゴー出身のサンディ・ミッチェルとグラスゴー生まれのウィリアム・サンプソンという2人の英国人が死刑に直面しています。	グラスゴーのカーキンティロック出身のサンディ・ミッチェル（44）とグラスゴー生まれの英国人ウィリアム・サンプソン（44）は、公共の場で斬首刑に処されることになった。
彼は、電話勧誘電話の約80％をブロックすることを意図しているサービスを熱望するアメリカ人の忍耐を促した。	この無料サービスは、もともと電話勧誘電話の約80％をブロックすることを目的としていました。
全国的な捜査の結果、火曜日の夜、アトランタ北西部のタイヤショップで逮捕されました。	彼は月曜の夜、ジョージア州アトランタで警察に逮捕されました。
教皇の私設弁護士であるジョーダン・グリーンは、ノーコメントであると述べた。	オブライエンの弁護士、ジョーダン・グリーンはコメントを控えた。
新しいパートナーと子供を得たハドレー氏は、「本当にうれしい。	彼の弁護士によって出された声明の中で、ハドレー氏は次のように述べています：「私は手続きの結果を心から喜んでいます。
この火災は、2週間前に発生し、すでに7万エーカーを焼失したサンタ・カタリナ山地の3つの地域の1つであるウィローキャニオンで、夜間に発生しました。	この火災は、サンタ・カタリナ山地にある3つの地域の1つ、ウィローキャニオンで一夜にして発生しました。
「クレジットカードによるリンチを傍観するようなことはしたくない」と、メジャー・オーウェンズ議員（民主党）は宣言した。	「クレジットカードのリンチを傍観するようなことはしたくない」と彼は言った。
この取り組みは、政府サービスにおける宗教団体の役割を拡大しようとするブッシュ政権の最新の取り組みである。	7月10日-政府サービスにおける宗教団体の役割を拡大しようとするブッシュ政権の最新の努力は、反麻薬プログラムに教会を基盤とする青少年グループを参加させることだ。
しかし、2.6.0カーネルの商用利用は、ほとんどのお客様にとって、まだ数カ月先の話です。	主要なLinuxディストリビューターによる2.6カーネルの商用リリースは、まだ数ヶ月先です。
より広範なスタンダード＆プアーズ500インデックス.spxは2ポイント（0.24%）上昇し、977となりました。	ナスダック総合株価指数（IXIC）は、6.52ポイント（0.39％）安の1,645.66となった。
当初は、21州61店舗で約300人の従業員が逮捕されたと発表していた。	しかし、その後、この数字は修正され、約60店舗で約250人が逮捕されたと発表された。
「この取引は両社にとって意味のあるものです」とハラは声明を発表しました。	Natsemi社のCEOであるBrian Halla氏は、この取引は両社にとって意味があると主張した。
24人の共和党議員を含む57人の上院議員がこの書簡に署名しています。	署名した人のうち、57人は上院議員で、そのうち24人は共和党員である。
ブルームバーグのデータによると、4月末時点でターナー氏が保有していた1億1590万株の半分以上を占めています。	この売却は、4月末時点でターナー氏が保有していた1億1590万株の約52%に相当します。
水曜日、メサ郡保健所からさらに5人の西ナイルウイルス感染者が報告された。	今週の時点で、45の郡で103人の西ナイル感染者が保健省に報告されています。
マタモロスとブラウンスビルを結ぶ橋を歩いて渡り、アメリカに入国しました。	マヌエルと彼のグループは、毎日何千人もの人々がするのと同じ方法で、マタモロスとブラウンズビルの間の橋を歩いて渡ってアメリカに入国しました。
NASDの規則では、ヤング氏はNASDのパネルに対して反論を提出し、聴聞を要求することができます。	すでにメリルから解雇されたアナリストは、NASDパネルでのヒアリングを要求することができます。
そのキーワードは中国語のウェブポータルでサポートされています。	中国語のウェブポータルも3721のキーワードをサポートすると、ウェブサイトは述べています。
大統領は演説の冒頭で、7人の米国人を含む少なくとも29人が死亡したサウジアラビアのテロ攻撃を認めました。	しかし、ブッシュは、サウジアラビアで少なくとも29人のアメリカ人を含む死者を出した爆弾テロ事件にも怒りをあらわにした。
シリウスはナショナル・パブリック・ラジオを放送していますが、"all things considered" や "morning edition" などの人気番組は含まれていません。"	シリウスは最近、ナショナル・パブリック・ラジオの放送を開始したが、「all things considered」や「morning edition」といった人気番組が含まれていないため、xmに嫌われた。
火曜日の住民投票の集計後、ジョン・バルダッチ州知事は「この州の市民をとても誇りに思う」と述べた。	「私はこの州の市民をとても誇りに思っている」と、カジノ反対派のジョン・バルダッチ州知事は語った。
三大候補の中では、シュワルツェネッガーが無党派層やクロスオーバーの有権者の争いに勝っている。	シュワルツェネッガーは、バスタマンテよりも無党派層やクロスオーバーの有権者を多く獲得している。
4月23日に辞任を発表したロン・ディテモアの後任となる。	ディテモアは4月23日に辞任することを発表した。
セレンスキーは以前、銀行強盗の有罪判決で7年間服役していた。	セレンスキーは銀行強盗で7年間ほど服役していた。
87歳のマドックスは、10日ほど前に腸の手術から回復した老人ホームで転倒し、肋骨2本にヒビが入ったという。	1983年から癌と闘っていたマドックスは、今月初め、手術から回復した介護付き老人ホームで転倒し、肋骨2本にひびが入った。
大統領候補であるグラハムは、共和党の議員たちから「報告書を政治利用している」と批判された。	調査の共同議長を務めたグラハムは、大統領候補である。
2002年、リンクシスはシスコシステムズを抜いて無線機器のトップベンダーとなり、売上高の14.1％を占めた。	ロルフ氏によると、昨年、リンクシスはシスコシステムを抜いて、無線LAN機器の主要サプライヤーになったそうです。
3年連続で州の目標を達成できなかった学校は、編入学に加えて個人指導を行わなければならない .	2年連続でテスト目標を達成できなかった学校は、転校を申し出なければならない。
薬の改ざんは非常に儲かるので、逮捕者の多くは100万ドルの家に住んでいた。	薬品の改ざんは儲かるので、容疑者の多くは100万ドルの家に住んでいる、と捜査官は言った。
トムソン・ファースト・コールが調査したアナリストのコンセンサス予想では、1株当たり1.70ドルの利益を見込んでいました。	ロイター・リサーチ、ロイター・グループplcのユニットによって投票されたアナリストは、平均して1株当たり1.69ドルの利益を予測した。
最初の検死報告によると、死因は脱水症、高体温症、窒息死であった。	その後、さらに2人が死亡し、最初の検死報告によると、脱水、低体温、窒息が原因であった。
ハワード氏は、ヒックスを裁判にかけることができる制度にも信頼を寄せていると述べた。	ハワード氏も昨日、ヒックスは公平に扱われると述べ、米国の司法制度を信頼していると語った。
マフムードはサダムに近親者以外が近づくことを禁じていた、と国防総省当局が発表した。	マフムードはサダムへの接近をコントロールし、頻繁に彼の側にいた。
バンに乗った密輸業者は、他の密輸業者や不法移民を乗せたピックアップとSUVを追いかけたと、ピナル郡保安官ロジャー・ヴァンダープールは語った。	バンに乗った人々が不法移民を運んでいると思われるピックアップとSUVに発砲したとピナル郡保安官ロジャー・ヴァンダープールが言いました。
125人の証人が登場するこの裁判は、2004年の初めまで続く可能性があります。	2004年初頭まで続くかもしれないこの裁判は、金曜日に125人の目撃者のうち最初の人の話を聞くことが期待されています。
このコンピュータは、米国、カナダ、南朝鮮に設置されていると報告されています。	PCは、米国、カナダ、韓国に分散しています。
この脆弱性は、Windows NT 4.0, NT 4.0 terminal services edition, xp, 2000, Windows Server 2003 に影響を及ぼします。	マイクロソフトは、Windows NT 4.0、Windows NT 4.0 terminal services edition、Windows 2000、Windows XP、Windows Server 2003に影響を与える脆弱性に対してパッチを発行しました。
この追加拠出により、今年の米国の北朝鮮への食糧支援は合計10万トンとなりました。	この6万トンの寄付により、米国からの寄付は年間10万トンとなりました。
欧州連合（EU）は1998年に遺伝子組み換え食品の輸入を禁止したが、米国は現在、EUに禁止をやめるよう要求している。	米国では、多くの消費者が健康被害を懸念したため、1998年に遺伝子組み換え食品の輸入が禁止されました。
今後5年以内にバンダープールが発売されると予測しています。	ヴァンダープールを使った商品は、5年以内に発売される予定だそうです。
アニカ・ソレンスタムは、今週のマクドナルドLPGAチャンピオンシップで、その目的を試す最初の機会を得ることになる。	前菜を食べ尽くしたアニカ・ソレンスタムは、今週のマクドナルドLPGAチャンピオンシップのメインディッシュへと進みます。
より広範なスタンダード＆プアーズ500インデックス.spxは3ポイント（0.39パーセント）上昇し、924となりました。	技術系のナスダック総合指数< .ixic >は6ポイント（0.41%）上昇し、1,498となりました。
2000年の国勢調査によると、ロングビーチのヒスパニック系またはラテン系の人口は35.8％であった。	国勢調査局によると、ヒスパニック系の人口は2000年4月の国勢調査の数字から9.8％増加しています。
コンビニエンスストアの前で3人が死亡した狙撃事件で、当局は金曜日、市民に対し、解決の糸口となる情報を提供するよう呼びかけました。	チャールストン近郊のコンビニエンスストアで3人が狙撃された事件で、当局は昨日、市民に事件の解決を呼びかけました。
1994年の番組開始以来、ジョン・カーター博士を演じてきた俳優のノア・ワイルが、2004-2005年シーズンまで契約を延長しました。	1994年のシリーズ開始以来、ジョン・カーター博士を演じてきたノア・ワイルが、プロデューサーのワーナー・ブラザースTVと1年間の契約延長に合意した。
シスコは、At & T Corp. T.N、SBC Communications Inc. SBC.N、Sprint Corp. Fon.N と同様の契約を結んでいます。	シスコは、ベルサウスの競合会社であるSBCコミュニケーションズ、アットアンドティー、スプリントコミュニケーションズと同様の関係を持っています。
今回のケースは、SARSのプロファイルに合致せず、公衆衛生上の懸念はないとしています。	WHOは、シンガポールのケースはSARSのプロファイルに合致せず、「国際的な公衆衛生上の懸念ではない」と述べています。"
ハリスとクレボルドは、1999年4月20日に12人の生徒と教師を殺害し、その後自殺した。	ハリスとクレボルドは学校で12人の生徒と教師、そして自分たちを殺しました。
「我々は米国が率いる統治評議会を非難する」とムクタダ・アル・サドルはモスクでの説教で述べた。	「我々は、米国が率いる統治評議会を非難し、糾弾する」とモクタルダ・アル＝サドルは述べた。
第二は、hp（ 29億ドルで27％、わずか0.4％増）を付属しています。	hpはサーバーの売上が0.4％増の29億ドルで2位に転落しました。
金曜日に配布された声明の中で、28のチェチェンの非政府組織は、投票をボイコットすると述べた。	今日配布された声明の中で、28のチェチェンの非政府組織は、投票をボイコットすると述べ、有権者に不正行為を予期するよう警告した。
2000年の国勢調査によると、同州の人口は6,080,485人である。	しかし、1960年から2000年の間に、州の人口は30.4％増の6,080,485人となった。
7月18日：ハールバートはブライアントに対し、性的暴行の重罪を申請した。	ブライアント（24歳）は性的暴行の罪で起訴されました。
セント・ポール社の会長兼CEOであるジェイ・S・フィッシュマン（51）は、統合会社のCEOに就任する予定です。	セント・ポール社の会長兼最高経営責任者であるジェイ・フィッシュマン（51）が合併会社の最高経営責任者に就任する予定です。
米軍は最近、シリア国境付近で外国人武装勢力の容疑者約40人を逮捕し、現在尋問を行っている。	第3装甲騎兵連隊は最近、シリア国境付近で約40人の戦闘員容疑者を逮捕したと当局が発表した。
その代わりに、ワイダはミースターがレイプ、ソドミー、強制猥褻、未成年者へのアルコール提供の容疑で軍法会議にかけられることを決定した。	ダグラス・ミースター、20歳は、レイプ、ソドミー、強制猥褻、未成年へのアルコール提供の罪で起訴されました。
これは、前年同期の13億9,000万ドルの売上に対して、100万ドルの利益、または損益分岐点と比較したものです。	第2四半期の総収入は14億8,000万米ドルで、前年同期の13億9,000万米ドルから7％増加 しました。
ヒューストンでも別の機体で同様の発見があったと、ダラスに本社を置くサウスウエスト社は発表した。	航空会社によると、同様の発見がヒューストンの機内でもあったとのことです。
ローゼンタールは火曜日、ギャレットの状況についてコメントを避けたが、声明の中で「我々は大きな契約交渉をしていた」と述べている。	番組の制作者兼エグゼクティブプロデューサーのフィル・ローゼンタール氏は、声明の中で次のように語っています：「私たちは大きな契約交渉をしていました。
金曜日の朝、電力が回復したため、州の職員は仕事に戻りました。	パタキ氏は、電力が回復すれば、州職員は金曜日の朝に仕事に戻ると述べた。
ボリビアでは、大統領に対する民衆の蜂起が広がる中、食料不足の首都に流れ込む抗議者の列を止めるため、軍が戦っています。	ボリビアの軍隊は、ダイナマイトを振り回す鉱山労働者の列が包囲された首都に流れ込むのを止めようと戦い、大統領に対する民衆の反乱が広がる中、2人の死者を出した。
ナスダックは月間で約1.3％下落し、7カ月続いた連勝を止めた。	ナスダックは今月約0.4％下落し、7カ月連続の上昇を止める勢いだ。
10月23日、調査とは関係のない古い3連バインダーに挟まれた報告書が発見されました。	先週、ヒックスが持っていたトレーニングマニュアルの中に入っていた報告書が発見されました。
米軍はアフガニスタン南部で攻撃を受け、タリバンの武装勢力とみられる約22人を殺害しました。	米軍兵士がアフガニスタン南部でタリバンの武装勢力とみられる約二十人を殺害したと軍が日曜日に発表した。
a920は89ドルでプリンタ、スキャナ、コピー機が付属しています。	デルのパーソナルオールインワンA920は、プリンタを組み合わせたエントリーレベルのデバイスです , スキャナとコピー機機能 $ 89 .
土曜日、赤十字国際委員会は、バグダッドとバスラの事務所を一時的に閉鎖すると発表した。	赤十字国際委員会は、イラクで活動するスタッフの安全を懸念し、バグダッドとバスラの事務所を一時的に閉鎖することを発表した。
オ・ムイレガイン氏がメンバーであったアイルランド・パレスチナ連帯キャンペーンは、彼の釈放を歓迎した。	彼がメンバーであるアイルランド・パレスチナ連帯キャンペーンは、学校交流プロジェクトを研究していると述べた。
グラバーは、犯人が犠牲者の首を絞めるのに使った結紮具に「奇妙なスリップノット」を使っていたと述べた。	グローバーは、犯人は同軸ケーブルと延長コードを含む「特殊なスリップノット」を使って、犠牲者の何人かを絞め殺したと語った。
ジェーン・ドウの弁護士がベライゾンに彼女の名前を伏せるように頼んだのは、彼女が召喚令状に異議を唱えるつもりだったからだと彼女は言った。	ジェーン・ドウは召喚令状と戦うことを決意し、ベライゾンに自分の名前を伏せるように頼みました。
それは彼の個人的なレーダースクリーンに上がったこの先週、私は彼に私のピッチを与え、彼は非常に支持された、 "彼は言った。	「先週、彼の個人的なレーダースクリーンに映し出され、私は自分のピッチを手に入れなければならなかったのです。
9月、27歳のシンガポールの研究者が、研究室での作業中にSARSに感染した。	8月にシンガポールの27歳の研究所員がSARSを発症した事例があります。
50を下回る数値は製造業の収縮を、上回る数値は拡大を示しています。	50を超える数値は成長を、それ以下の数値は縮小を表しています。
建物から十戒の記念碑を撤去することを阻止するために、訴訟が起こされている。	支持者は月曜日、連邦裁判所にアラバマ州の司法ビルから十戒の記念碑の撤去を阻止するよう要請した。
ブリッツの給与、賞与およびその他の報酬は377万ドル、キニーの報酬は376万ドルでした。	ジョンストンは、2001年に社長として580万ドルの給与とボーナスを得ており、2002年には非常勤顧問として100万ドルを得ている。
そのトラックはキャンベルズクリークで目撃されており、その記述と一致するとモリスは言った。	黒いピックアップトラックがキャンベルズ・クリーク地区で目撃されたそうです。
しかし、若い選手がリングに上がってから最初の30秒で、家族はそれが不均衡な試合であることを知った、とマイヤースは言った。	しかし、最初の30秒で、家族は、それが不均衡な試合であることを知っていた、とジョディ・マイヤーズ（ステイシー・ヤングの妹）は言った。
水曜日の公聴会でのマイケル・パウエル委員長とFCCの同僚たち。	FCC長官マイケル・パウエル、月曜の公聴会を主宰 .
ダウ平均株価は0.3％高の9,886.75ドル、ナスダック総合株価指数は0.4％高の1,986.97ドル。	ウォール街では、ダウ平均が0.5％上昇の9,905.8、ナスダック総合が0.7％上昇の1,995.1でした。
テヘランは、西側の民生用原子力技術の輸入が禁止された場合のみ、このような査察を導入する追加議定書に署名すると明言した。	テヘランは、西側の平和的な核技術の輸入が解禁された場合のみ、議定書に署名すると明言している。
議会は過去に2度、同様の規制を可決したが、ビル・クリントン大統領が拒否権を行使した。	議会は同様の法案を2度可決したが、当時のクリントン大統領は2度とも拒否権を行使した。
しかし、私は低水準よりも高水準について話したいと思っています。"	"私はむしろマイナスではなく、プラスの数字について話しています。
このプログラムでは、米国当局が外国の港湾当局と協力して、リスクの高い貨物を特定し、ターゲットを絞って捜索します。	このプログラムでは、米国当局が外国の港湾当局と協力して、米国に到着する前に危険性の高い貨物を探し出すことができます。
ニールスは1999年、インタビューに答えて、この老人は自分より何年も長生きすると思っていたと語った。	ニールセン氏は、亡くなる2年前の1999年、インタビューに対して、この岩肌は自分より何年も長生きすると思うと答えている。
木曜日もダグ・マクドナルド隊長は危篤状態で入院している。	20歳の妹、アリソンも大やけどを負い、重体で入院している。
水曜日の時点で、全世界で招集された州兵と予備兵の総数は154,603人であった。	昨日の時点で、世界中で招集された州兵と予備兵の総数は154,603人である。
約10年の間に、電話勧誘の仲間は700万ドル以上を集めました。	ヴィートナウが雇ったテレマーケティング・アソシエイツは、1987年から1995年にかけて710万ドルを集めました。
インバーカーギル出身のウォーレン・キャンベルさん（32）と登山仲間のジョナサン・スミスさん（47）の遺体が昨日深夜、ダーチャック山麓から収容された。	ウォーレン・デビッド・キャンベル（32）と登山仲間のジョナサン・スミス（47）が火曜日、マッケンジー地区のダーチャック山での登山から予定通り戻らなかった。
ゲーガン氏は、4月3日に刑務所に移送されて以来、保護拘置所で生活していた。	彼は4月にソウザバラノウスキーに移されて以来、保護拘束されていたと当局が発表した。
その株式は、時間外取引で71セント（3.5％）下落し、19.55ドルでした。	株式は63セント（3％）上昇し、通常セッションのナスダック取引で20.26ドルで取引を終了した。
シンガポールでは水曜日、SARSの疑いのある患者は報告されなかったが、当局は台湾の患者と接触した70人を隔離した。	それでも、シンガポールは、この科学者と密接に接触していた70人を隔離した。
元ニューヨーク州知事候補の彼は、より良いコーポレート・ガバナンスの提唱者と自称していた。	マッコール氏は、2002年のニューヨーク州知事選に出馬して落選し、より良いコーポレート・ガバナンスの提唱者と自称していた。
何百人もの記者やカメラマンが、全国ケーブルネットワークで生中継された公聴会の前に、裁判所の敷地に押し寄せた。	何百人もの記者やカメラマンが街に押し寄せ、5回のオールスターに選ばれた彼の短い審理は、全米ケーブルネットワークで生中継されました。
amdのチップ売上高は前年同期比7％増の4億200万ドルとなりました。	第2四半期の売上高は、2002年の6億ドルから7％増の6億4,500万ドルになりました。
下流のマウントバーノンでは、スカジット川の水位は36フィート、洪水時の水位より8フィート高くなると予想されているそうです（バーク氏）。	スカギットは夜間、マウントバーノンで38フィートに達し、洪水時の水位より10フィート高くなると予想されている、と全米気象局が伝えた。
米連邦捜査当局は木曜日、4大会計事務所のアーンスト・アンド・ヤングの元パートナーを連邦捜査妨害の刑事容疑で逮捕したと発表した。	会計事務所アーンスト・アンド・ヤングの元パートナーが昨日、連邦捜査妨害の容疑でFBI捜査官に逮捕されました。
シェリア・チェイニー・ウィルソンは、ターナー・モニュメント教会の104周年記念式典の準備を手伝いに来たとき、興奮しているように見えたと、礼拝者たちは言っている。	ターナー・モニュメント・エイム・チャーチの信徒によると、シェリア・チェイニー・ウィルソン（43）は、市の東側にあるカークウッド地区の教会に来たとき、興奮していたそうだ。
彼は、米軍に支給されたイラクの逃亡者を描いたカードのパックで、ダイヤのエースだったのです。	彼は、最も指名手配されているイラクの指導者の写真を載せたアメリカのトランプで、ダイヤのエースだったのです。
モンテネグロ自由同盟のミオドラグ・ジブコビッチ氏が31％、無所属のドラガン・ハイドコビッチ氏が4％の得票率だった。	独立派の急進派である自由主義同盟のミオドラグ・ジブコビッチ氏が31％の得票率で2位となった。
これまでのところ、ジョージア州は送金した金のうち7万ドル以外を返還されています。	ジョージア州はFBIの協力で7万ドルを除くすべての資金を取り戻しました。
イエーガーは、標的の攻撃の容疑者が前科者である傾向を示したと述べた。	イエーガーは、事件は単独で起こったように見えたが、容疑者は前科者である傾向を示したと述べた。
5月22日には1日の記録として65件、5月23日には55件が報告され、台湾の疫病は世界で最も急速に拡大している。	台湾では、5月22日に65件、23日に55件の新規感染者が報告され、世界で最も急速に感染が拡大している。
カブスのサミー・ソーサ外野手は、コルク入りバットを使用したとして、金曜日にメジャーリーグから8試合の出場停止処分を受けた。	サミー・ソーサはコルク栓付きバットの使用により、金曜日にメジャーリーグから8試合の出場停止処分を受け、彼はすぐにその決定を不服として訴えた。
半数の女性に1日1回投与し、半数にはプラセボを投与した。	半数の女性にはエストロゲンとプロゲスチンの組み合わせの錠剤が毎日投与され、残りの女性にはプラセボが投与されました。
月曜日、ダウは5.25ドル（0.1％）下落の8,983.80ドルとなり、先週2.3％下落しました。	取引開始直後、ダウ平均株価は39.94ドル（0.4％）安の8,945.50ドルで、月曜日に3.61ポイント下落した。
30年債us30yt = rrは4.23パーセントから4.26パーセントの利回りのために14 / 32を浸漬した。	30年債のus30yt = rrは16 / 32を失い、その利回りは4.18%から4.20%になりました。
負傷者はジェファーソン・シティと北に30マイル離れた大学の町コロンビアの病院に運ばれた。	負傷者は約48キロ北のジェファーソン・シティとコロンビアにある病院に運ばれたが、容態はすぐに判明しなかった。
警察が4人を家から連れ出したとき、彼らの体重は合わせて136ポンドだった。	10月10日に施設から連れ出されたとき、それぞれの少年の体重は50ポンド以下でした。
ドルは日本の通貨に対して117.85円で、0.1％上昇した。	対スイス・フランでは、ドルは1.3289フランで、その日のうちに0.5％上昇しました。
イブラヒム族の分離手術は1回だが、グッドリッチとデービッド・スタッフェンバーグ医師は、アギレス族に3回ほど、それぞれ数週間の間隔を空けて手術を行う予定だそうだ。	グッドリッチとデービッド・スタッフェンバーグ医師は、双子を分離するのに1回の長い手術ではなく、それぞれ数週間の間隔をあけて3回ほど行うことを計画しています。
同社は、購入者向けの決済サービスなど、その他のサービスの提供にも事業を拡大しています。	同社は、これらの基本的なサービスを拡大し、支払い、さらには融資を提供しています。
この爆発で2人が死亡、150人以上が負傷した。	アトランタのオリンピック大会の攻撃で、女性1人が死亡し、100人以上が負傷した。
2001年、ブッシュ大統領はキャシー・グレッグを学生ローンマーケティング協会の理事に任命しました。	2001年、ブッシュ大統領は彼女を、米国最大の学生向け融資機関である学生ローンマーケティング協会に任命した。
ボストン大司教区はスキャンダルの波に直面し、被害者の擁護者だけでなく、教区の住民や一部の神父を怒らせている。	スキャンダルの波は、被害者の擁護者だけでなく、教区民や一部の司祭を怒らせ、法律はもはや大司教区を運営できないほどであった。
フォートローダーデールの連邦判事から保釈金なしで拘束するよう命じられました。	ズッカリーニは、フロリダ州フォートローダーデールの連邦判事によって、水曜日に保釈なしで拘束されるよう命じられました。
同省の見解は、アシュクロフト氏とブッシュ大統領に強い政治的支持を与えてきた社会的保守派を遠ざける恐れがある。	同省の姿勢は、中絶反対派を失望させ、アシュクロフトとブッシュ大統領に強い政治的支持を与えてきた社会保守派を疎外する恐れがある。
南アフリカは、HIVやエイズに感染した人が470万人と、世界で最も多い国です。	南アフリ カのHIV/エイズ感染者数は470万人で、エイズ患者数 は世界一である。
エライアスは、EMCの社長兼CEOであるジョー・トゥッチの直属の部下になります。	エライアスは、新規事業担当執行副社長として、EMCの社長兼CEOであるジョー・トゥッチに直属します。
新しい陸軍司令官は、マサカ機甲旅団司令官のアロンダ・ニャカイリマ准将で、現在は少将に昇進しています。	ヨウェリ・ムセベニ大統領は、アロンダ・ニャカイリマ准将を少将に昇格させ、陸軍司令官に任命した。
「あれが民主主義者でないなら、私は間違った会合に参加しているに違いない」と彼は言った。	そして、もしそれが民主党でないなら、私は間違った会合に参加しているに違いない」と述べ、彼の支持者から万雷の拍手を浴びた。
mailblocksは、webtvがマイクロソフトに4億2,500万ドルで買収された5年後に設立されました。	webtvは1997年に4億2500万ドルでマイクロソフトに売却され、現在ではmsn tvと呼ばれています。
「メイン州にとっての大勝利であり、他の州にとっての大勝利でもある。	メイン州のプログラムは、他の州のモデルになる可能性があります。
オコナーのほか、レーンキストの多数意見には、デイビッド・サウター、ルース・バーダー・ギンズバーグ、スティーブン・ブライアーの各裁判官が加わった。	また、同裁判官とともに、サンドラ・デイ・オコナー、デビッド・H・サウター、ルース・バーダー・ギンズバーグ、スティーブン・G・ブライヤーが多数意見を述べました。
首都圏交通局は、1.50ドルの運賃と古い通勤鉄道の料金を復元するために2週間を与えられたとヨークが宣言した。	控訴を予定しているメトロポリタン交通局は、5月28日までに地下鉄、バス、通勤鉄道の旧料金を復活させることを命じられた。
エンブラエルのジェット機は、2006年9月までに納入される予定です。	ボンバルディア社およびエンブラエル社の航空機は、2006年9月までにUSエアウェイズに納入される予定です。
「今日、私たちはこの問題をロシアのプーチン大統領とアメリカのブッシュ大統領に伝えようとしています。"	「今日、私たちはこの問題をロシアのプーチン大統領（ニュース - Webサイト）とブッシュ大統領（ニュース - Webサイト）に伝えようとしているのです。"
州はマクグラス村の近く、約1700平方マイルの地域でオオカミを殺そうとしています。	州はマクラスの近くの約1,700平方マイルでオオカミを殺し、ヘラジカの保育所を作ろうとしています。
ピーターソンは、クリスマスイブに一人でサンフランシスコ湾で釣りをし、誰もいない家に戻ったと警察に話した。	ピーターソンは、12月24日の午前9時半ごろに妻と別れて、一人でサンフランシスコ湾で釣りをしたと警察に話している。
連邦準備制度理事会（FRB）が発表した6月のエンパイア・ステート・サーベイは予想を大きく上回り、5月の10.6から26.8へと上昇し、過去最高となりました。	6月のエンパイア・ステート・サーベイが予想をはるかに上回る26.8となり、5月の10.6から過去最高となったとき、価格はオフショアの高値から引き戻されたのです。
「私は世界の超大国によって追放されたと言うことができる」と彼は言った。	「私は世界の超大国によって亡命を余儀なくされている」と、テイラーの自宅での演説をビデオに撮った。
ノーマン・マッキンレー警視総監は、「この地域に遺体または遺体があった証拠がある」と述べた。	捜査を指揮するノーマン・マッキンレー刑事部長は、「この地域に死体か何かがあったという証拠がある」と述べた。
捜査当局は、キャンベルの個人的および財政的な問題のほぼすべての側面を綿密に調べたと、キャンベルは認めている。	捜査当局は、キャンベルの個人的および財政的な問題の事実上すべての側面を調査し続けていると、前市長は述べている。
理事長のロバート・ベネットは火曜日、ミルズと同様、人事に関するコメントを避けた。	ミルズ氏は昨日、「人事について話すことはない」とコメントを避けた。
ジェフリー将軍は、ヤララムラで在任中の軍人の年金を慈善団体に寄付すると言った。	ジェフリー少将は、ヤララムラで勤務していたとき、軍人の年金を慈善事業に寄付すると言っていました。
タンパベイのルー・ピニェラ監督、ジョン・クラレンベンチコーチ、オーブリー・ハフ右翼手が、ハフが9回終了時にストライクでコールされた後、口論で退場させられました。	タンパベイのルー・ピニェラ監督、ジョン・マクラレンベンチコーチ、ハフの3人が9回の途中で退場させられました。
ロシアとウクライナに5つの製油所と2,100以上の給油所を所有しています。	tnk-bpは、6つの石油生産ユニット、5つの製油所、2,100の給油所を持っています。
と、リベスキンドは語っています。	リベスキンドは、「多くの変更は、当初の計画に対する改善である」と述べています。
は、前年同期の610.6百万米ドルから616.5百万米ドルに増加しました。	は、6億1060万ドルから6億1650万ドルへと微増しました。
スタンダード＆プアーズ500指数< .spx >は8.79ポイント（0.96%）上昇し、929.06となりました。	技術系のナスダック総合指数< .ixic >は26ポイント（1.78%）上昇し、1,516となった。
ピーター・ドイッチュ議員（フロリダ州選出）が、フロリダ州でのFDAの取り組みを批判。フロリダでのFDAの取り組みを批判した。	ピーター・ドイッチュ、フロリダ州選出 .FDAに祝辞を述べたいと述べた。
アイオワ州体育局長のブルース・ヴァン・デ・ベルデとモーガンからはコメントが得られていない。	アイオワ州のアスレチックディレクター、ブルース・ヴァン・デ・ベルデは、レボにオファーがあったことを確認しなかった。
6月6日の70件に対し、現在GTAで37件の有効なプロブレムケースが発生しています。	であり、全世界で活動中の推定患者数は573人に減少しています。
オスのワシは木曜日未明に動物園の飼育係に発見され、腹部にひどい刺し傷を負っていた。	21歳の鷲は、木曜日の早朝に動物園の飼育員によって発見され、彼の腹部と背中に重度の穿刺傷があったと広報担当者のジュリー・メイソンは言った。
アニューによると、ピネラス州は1995年に狂犬病の発生がゼロから30件になったとき、ベイト（餌）を撒くようになった。	それでも、ピネラス州の狂犬病患者は1996年に17人、1997年に3人と激減した、とアニューは言う。
ホワイトリーの弁護士であるマーク・ガーバーは、異なる見解を持っていた。	ホイットレイの弁護士であるマーク・ガーバーは、この判決を「大勝利」と呼んだ。"
bioreliance 'sの株式は、一株当たり47.98ドルで昨日2セントダウンして閉鎖した。	の株式は、2セントダウン、昨日の市場の終わりに$ 47.98で販売。
わずか5ヶ月前、ディーンは税金を受け取ることを約束し、そうしない民主党員を攻撃することを誓った。	わずか5ヶ月前、ディーンは納税者の金とそれに付随する支出制限を受け入れることを約束し、そうしない民主党員を攻撃することを誓った。
SARSは中国本土で296人が死亡し、5,200人以上が感染している。	中国本土では、300人が死亡し、5,270人以上が感染しています。
再設計されたファインダーは、検索、ドキュメントやプロジェクトをカスタマイズして整理するためのカラーラベル、Mac、Windows、UNIXファイルサーバーのネットワークの動的ブラウジングも備えています。	また、カラーラベルによる文書の整理や、Mac、Windows、Unixのファイルサーバーのネットワーク上でのダイナミックなブラウジングもサポートしています。
トーチ・コンセプトの代理人であるリッチ・マースデンは、何度電話をしても応答がありませんでした。	トーチ社とジェットブルー社の関係者は、マーキュリーニュースの再三の電話取材に応じず、コメントを求めました。
彼は2001年に自主的に去勢手術を受け、性的興奮を得る能力を失ったと主張している。	2001年8月に自主的に去勢手術を受けたデブリーズは、手術によって性的興奮を得る能力が失われたと述べている。
S&P/TSXコンポジットは87.74ポイント上昇し、TSXベンチャーエクスチェンジコンポジットは44.49ポイント上昇しました。	ダウ平均株価は11.56ポイント上昇、ナスダック株式市場は39.42ポイント上昇しました。
一方、Suse は java 2 standard edition のライセンスを取得すると同時に、java アプリケーションを実行するための Sun の java 仮想マシンを配布する既存の契約を正式に締結します。	ドイツ・ニュルンベルクに本社を置くSuseは、サンのJava 2 Standard Edition（j2se）のライセンスを取得し、サンのJava仮想マシンを同社のLinuxソフトウェア製品群に搭載する予定です。
アーティストたちは、この計画が、最も支援を必要としている人たち、つまりショーに出演するのが難しいパフォーマーに害を及ぼすのではないかと心配している。	アーティストたちは、この計画はフランスの文化に害を与え、最も助けを必要とする人々、つまり仕事を見つけるのに苦労しているパフォーマーたちを罰することになると言っています。
ガソリンスタンドの前には長い列ができ、人々は現金自動預け払い機からお金を手に入れようと殺到し、イスラエル人は国を麻痺させるほどのストライキを乗り切る準備をした。	日曜日にはガソリンスタンドの前に長い列ができ、人々は現金自動預け払い機からお金を手に入れようと殺到し、イスラエル人はストライキの影響に備えました。
ハイテク企業の多いナスダック総合指数は3.99（0.2％）下落の1,682.72で、2日連続で55.93の上昇を記録した後。	技術系のナスダック総合指数（IXIC）は8.52ポイント（0.51％）安の1,670.21となった。
マーティン（58歳）は、16歳のフレッド・バーラスを故殺した罪で、5年の刑期のうち3分の2を終え、本日釈放される予定だ。	マーティンはバラスの過失致死と フィーロンの傷害で 5年の刑期のうち 3分の2を服役した
SARSになるかどうかはわからない」と、オンタリオ州の公共安全コミッショナー、ジェームス・ヤング博士が述べた。	というのも、「私たちは超警戒態勢にある」と、オンタリオ州の公共安全コミッショナーであるジェームス・ヤング博士が語っているからだ。
の売上高は予想を上回り、前年同期比37％増の17億6,000万ユーロとなりました。	売上高は前年同期比37％増の17.6億円となり、予想を上回りました。
同社は、来月の第2四半期決算発表時に通期見通しの修正を発表する予定であると述べています。	同社は、7月中旬の第2四半期決算発表時に、2003年のガイダンスを更新する予定であると述べています。
アイデックの株主は合併会社の株式の50.5％を所有し、バイオジェンの株主は残りの49.5％を所有することになります。	両社は、アイデックの株主が合併会社の株式の約50.5％を所有することになると発表しました。
それでも、オープンソースの第一人者は、「この攻撃は間違っており、我々の目標にとって危険である」と主張した。"	「この攻撃は間違っていた、そして我々のゴールにとって危険だった」レイモンドは言った。
「白線を切れ目のないものにするか、点線のものにするかはまだ決めていないが、これは導入する価値のある実験だ」とICCのクリケットマネージャーであるデビッド・リチャードソン氏は述べた。	「白線を切れ目のないものにするか、点線のものにするかはまだ決めていない」とICCのクリケットマネージャーであるデーブ・リチャードソン氏は言う。
新関氏は、ベトナム戦争での戦闘やボスニアでの米国平和維持活動の責任者など、38年のキャリアを経て水曜日に引退する。	新関氏は、ベトナム戦争での戦闘やボスニアでの米国平和維持活動の責任者などの経歴を持つ。
また、同局は水と土壌のサンプルを州の衛生研究所に送りました。	の水のサンプルは、分析のために州の保健局に送られています。
「しかし、それは民間人を保護するために可能な限りのことをする義務からそれらをクリアするものではありませんし、それは我々が見ているものではありません。"	「しかし、だからといって、民間人の被害を最小限にするために可能な限りのことをする責任を免れることはできない。"
ローランドの弁護士であるロス・ガーバーは、火曜日、彼は会議に出席し、この問題について発言するよう求めると述べた。	ローランド氏の顧問弁護士であるロス・ガーバー氏は、知事はこのマンション取引について何もコメントしないと述べた。
本人の希望により、地区内で配置換えとなります。	地区管理者のJ・チェスター・フロイドは月曜日、マクラッキンが地区内で配置転換されると記者団に語った。
元クレジット・スイス・ボストン・テクノロジー投資銀行の第一人者であるフランク・クアトロンは、火曜日、司法妨害と証人詐称の罪で無罪を主張したと報じられています。	ニューヨーク - ( ダウ・ジョーンズ ) - 元スター投資銀行家のフランク・クアトロンは火曜日、司法妨害と証人詐称の刑事責任を認めました。
連邦控訴裁判所は火曜日、2001年9月11日以降に拘束された700人以上の名前を政府が非公開にする自由があるとの判決を下した。11 , 2001 .	連邦控訴裁判所は火曜日、米国政府は9月11日の調査の一環として拘束された人々の名前を非公開にすることができるとし、下級審の判決を覆しました。
それまでは、東ジャワのニヤニヤしたメカニックをテレビで見ていただけだった。	ヒューズ氏は、テレビでアムロジの顔を見たことがある。東ジャワのニヤニヤした整備士の悪名高い映像だ。
2年後、保険が始まる。	この合意により、メディケアは2006年から薬物給付の適用を開始することになりました。
NASAの衛星画像によると、北極の氷は10年間で約10％の割合で縮小している。	北極の海氷は、10年ごとに9％の割合で消滅していることが明らかになりました。
ダウ平均株価は86.56ポイント（0.94％）下落し、9,109.99となった。	ダウ平均株価は79.43ポイント（0.86％）下落し、9,117.12となりました。
「バイオテクノロジー製品は、むしろ、すべてのテストが行われているため、従来の製品よりも安全かもしれない」とフレリーは言い、18カ国がバイオテクノロジーを導入していると付け加えた。	モンサント社のロバート・フレーリー副社長は、「バイオテクノロジー製品は、むしろ従来の製品よりも安全である可能性がある」と述べた。
ダウ平均株価は10.89ドル安の9,837.94ドルで、水曜日の111.04ドルの上昇の後、その日を終えました。	ダウ平均株価は10.89ポイント（0.11％）下落し、9,837.94となりました。
時は3月18日午前4時、最初のピンポイント・ミサイルが首都に降り注ぐわずか数時間前だった。	この掌握は3月18日午前4時、アメリカによる最初の空襲のわずか数時間前に起こりました。
修士号を持ち、全国的に認定された教師であるケリーは、30年目で65,000ドルの給料を稼いでいる。	修士号を持ち、全米の教育委員会に認定されたケリーは、教師になって30年目で、6万5000ドルを稼ぎ出しています。
ウィーンでは、iaeiaeはエルバラダイが招待を受けると発表したが、まだ日付は決まっていない。	ウィーンで、国際原子力機関は月曜日、エルバラダイがイランの招待を受け入れたと発表したが、日付はまだ設定されていないと述べた。
技術系のナスダック総合指数< .ixic >は7.42ポイント（0.45%）上昇し、1,653.44だった。	より広範なスタンダード＆プアーズ500インデックス.spxは0.46ポイント（0.05％）低い997.02であった。
11月に中国本土の広東省で流行が始まったが、中国人民共和国は4カ月間、その広がりについて正直に報告することを拒否した。	中国での流行は11月に広東省で始まったが、共産党政府は4カ月間、その広がりについて正直に報告することを拒んだ。
ドルースは殺人容疑に直面するだろう、とコンテは言った。	ドルースは殺人罪で起訴されるでしょう
前年同期の3,518万ドル（1株当り24セント）に対し、当四半期は3,520万ドル（1株当り24セ ント）となりました。	は、前年同期の8百万米ドルの税法上の特典の影響を受けました。
EUの閣僚は会議に招待されたが、EUが農業改革に関する協議を打ち切っているため、キャンセルしたと、ワシントンのEU農業代表、ジェリー・キーリー氏は述べた。	ワシントンのEU農業代表、ジェリー・キーリー氏によると、EUの閣僚が招待されていたが、EUが農業改革に関する協議を打ち切っているため、キャンセルされたとのこと。
ジョージア州のヤングハリス短大の左腕、ニック・マーカキスは7位でオリオールズに入団した。	次に、ボルチモアはジョージア州のヤングハリス短大からニック・マーカキスという左腕投手と外野手を獲得した。
我々は、市が我々と協力し、この問題について誠意を持って議論することに同意することを希望しています。"	アルハート知事は、「市が我々と協力し、誠意ある話し合いを続けてくれることを期待している」と述べた。"
また、多くの女性が完璧な肉体を求めて美容整形に走ることを懸念している女性もいます。	また、完璧な体を求めて美容整形に走る人が増えている社会への懸念を表明する女性もいます。
この通知は金曜日に msnbc によって最初に報告されました。	msnbc.comは金曜日にCIAの要請を最初に報道した。
「今、他の男、彼は彼の党を恥じている、"ストリートは群衆の笑いに言った。	「もう一人の男、彼は自分の党を恥じている、そして私は彼を責めることはできない。
ペリーはその後、2回の臨時立法会議を招集し、区割り計画を強引に通そうとしている。	それ以来、テキサス州知事のリック・ペリーは、この法案を押し通すために2回の特別会議を招集している。
しかし、昨日ヘラルド紙が調べた6月号には、ピーター・ホリングワースの写真はありませんでした。	しかし、昨日ageが調べた6月号には、ホリングワース博士の写真はなかった。
新任のダインズ氏の収入は395,000ドルで、アトキンソン氏の361,400ドルより大幅に増加する。	ダインズの年俸は395,000ドル、アトキンソンの年俸は361,400ドルである。
"我々はこの件に関してサウジアラビアと協力し続けているが、この悲劇的な出来事が起こった時点で、彼らは我々が要求した追加の警備を提供しなかった"	「しかし、この悲劇的な出来事が起こった時点では、我々が要求したセキュリティは提供されなかった」とジョーダン氏は述べた。
8月22日までに提出された申告書や納付書は、8月15日を期限とするものとして取り扱われます。	同庁は、金曜日から8月22日までに提出される申告書や納付書が8月22日までに完成していれば、適時とみなすと発表しています。
デイの発表によると、グリーンは来週からローワーズ・モータースピードウェイで開催されるウィンストン・オープンで暫定的に運転を開始するとのこと。	また、デイル・アーンハート・インクの1号車は、来週のローワーズ・モータースピードウェイでのウィンストン・オープンから、パークに代わってグリーンが使用することが発表された。
コスタの準決勝の相手は、昨年の決勝で破ったスペイン人のフアン・カルロス・フェレロだ。	コスタは次の試合で、昨年の決勝の再戦となるファン・カルロス・フェレーロと対戦します。
医師は、体内のエストロゲンが細胞の損傷から守り、血流を改善すると推測している。	エストロゲンが細胞の損傷を防ぎ、血流を改善するという推測に基づいていたのです。
技術系のナスダック総合指数 < .ixic > は、8.27ポイント（0.51％）増の1,633.53。	より広範なスタンダード＆プアーズ500インデックス.spxは4.3ポイント（0.44パーセント）上昇し、980.52となりました。
民主党は現在、同州の議会で17対15の優位を保っている。	テキサス州議会は現在、17対15で民主党が優勢です。
連隊のスポークスマンであるマイケル・カルバート大佐によると、死傷者の中にアメリカ人は含まれていないとのことです。	連隊のスポークスマンであるマイケル・カルヴァート大佐によると、死傷者はいずれもアメリカ人ではない。
選ぶ権利があると思います。	エリソン氏は、「私たちは、peoplesoftのお客様には選ぶ権利があると考えています」と述べています。
「我々は決定的な証拠を見つけた」と、調査委員のスコット・ハバードが言った。	カリフォルニアにあるNASAのエイムズ研究所の所長であるハバード氏は、「我々は決定的な証拠を発見した」と述べた。
チャドリーは56日後に釈放され、フィジー軍は2001年9月の民主的選挙に勝利したカラセを中心とする全土人政権を発足させた。	フィジー軍は、2001年9月の民主的な選挙で勝利したカラセ氏率いる先住民族だけの政府を発足させた。
しかし、結局のところ、このワームが行ったのはポルノサイトの閲覧だけだったと、カリフォルニアのシマンテック・セキュリティ・レスポンスのセキュリティ・ディレクター、ヴィンセント・ウィーファー氏は語った。	しかし、シマンテック・セキュリティ・レスポンスのセキュリティ・ディレクターであるヴィンセント・ウィーファーは、ウイルスがしたことはポルノサイトを見ただけだと言った。
「この子は文字通り死ぬまで放置されていた」と、アームストロング郡地方検事スコット・アンドレアシは語った。	アームストロング郡検事スコット・アンドレアシは、家にある多くの家族写真にクリステンは写っていないと述べた。
マイクロソフトは金曜日、アップルコンピュータのサファリブラウザとの競合を理由に、同社のインターネットエクスプローラブラウザの将来のマッキントッシュ版の開発を停止すると発表した。	マイクロソフトは、マッキントッシュ・コンピュータ用のインターネット・エクスプローラ・ブラウザ・ソフトウェアの開発を中止し、アップルのサファリがアップルが必要とするすべてであると言う。
チャップマンはすぐに逮捕されず、7月3日に罪状認否に出頭する予定です。	逮捕されていないチャップマン氏は、来週の木曜日に罪状認否に出頭する予定であると、検察は述べている。
ブッシュ大統領はこの3ヶ月間で、26万2000人のアメリカ人から再選キャンペーンのために4950万ドルという記録的な寄付を集めたと、大統領の選挙委員長が火曜日に発表した。	ブッシュ大統領は、5月に再選キャンペーンを開始して以来、8390万ドルを集め、そのうちの7000万ドルを支出するために残っていると、彼のキャンペーンは火曜日に発表した。
オハイオ州、インディアナ州、ミシガン州の当局が遺体を捜索しています。	これまでのところ、当局はペンシルベニア、オハイオ、インディアナ、ミシガンの地域も捜索しています。
彼は、欧州の政府が「根拠のない、非科学的な恐怖のために、すべての新しいバイオ作物を阻止してきた」と述べた。	「彼らは、根拠のない、非科学的な恐怖のために、すべての新しいバイオ作物をブロックしている」とブッシュは言った。
国連による戦争承認に反対してワシントンを激怒させたフランスが、「賛成」票を投じるか、それとも棄権するかという問題である。	国連の戦争承認に反対し、ワシントンを激怒させたフランスもまた、変更を求めていた。
ルツェルン郡検事デイビッド・ルパスは月曜の記者会見で、当局がこの事件で重要な進展を続けていることを明らかにした。	しかし、ルツェルン郡検事デイビッド・ルパスは、当局がこの事件で「重要な進展を続けている」と述べた。
米国コンファレンスボードは、第1四半期の調査で53に低下した最新の景況感指数が60に達したと発表しました。	コンファレンスボードは、2003年第1四半期に53に落ち込んだ景況感の指標が、直近の第2四半期には60に改善したと発表しました。
憲法は、政府が「限られた状況下」でしか薬物を投与することを認めていない、と述べた。"	6対3の判決で、このような抗精神病薬は「限られた状況」でのみ使用することができると述べました。"
その法定代理人は先週から原告側弁護士と会談し、和解について協議しています。	大司教区と原告側の弁護士は先週、法廷外での和解を成立させるために会議を始めた。
その場合、高齢者は3,450ドルを上限として、薬剤費の50％を負担しなければならない。	それ以上になると、メディケアはすべての薬剤費の90％を負担することになります。
ベテランのマレーシアの外交官は水曜日、自宅軟禁されているヤンゴンの湖畔の家でスー・チー氏に会った。	ラザリ・イスマイルは、1991年にノーベル平和賞を受賞したスーチー氏と、自宅軟禁下にある湖畔の自宅で90分間会談した。
華やかな起業家は、ロンドンでオーストラリアの観光大臣ジョー・ホッケーと会談した後、この計画を打ち出しました。	リチャード卿は、ロンドンでオーストラリアの観光大臣ジョー・ホッケーと会談した後、次のように述べた。
火曜日、グリーンスパンが米国議会で「米国経済は長期的な成長期に入る可能性が非常に高い」と発言したことを受けて、国債が大きく売られた。	グリーンスパンは火曜日、米国議会で「米国経済は持続的な成長期に入る可能性が非常に高い」と述べた。
PCユーザーを意識した新しい合法的なダウンロードサービスを開始 .	buymusicは、PCユーザー向けの初の定額制有料ダウンロード音楽サービスです。
キャシー・ニコロ（ジェニファー・コネリー）にとって、この家は安定と家族を意味する。	キャシー・ニコロ（ジェニファー・コネリー）は、自分の人生が崩壊したことを家族に知られないようにと必死だ。
30年債US30YT = RRは22 / 32を上昇し、4.31パーセントの利回り、対して水曜日の終値で4.35パーセント。	30年債US30yt = RRは1-3 / 32を成長させ、4.30パーセントの利回りで、水曜日後半の4.35パーセントから低下した。
4月の米国供給管理協会の非製造業活動指数は予想外に上昇したと報道されました。	米国供給管理協会が発表した3月の非製造業景況指数は47.9から50.7に上昇した。
先週、彼の弁護士はマーク・R・ワーナー州知事に慈悲を与えるよう求めたが、州知事は介入を拒否した。	先週、彼の弁護士は、新たな判決公判につながるであろう特定の条件の下で慈悲を付与するためにワーナーに尋ねた。
広報担当のマリア・チェンもこれに同意し、「孤立した出来事のように見えます」と述べています。"	世界保健機関（WHO）の広報担当者、マリア・チェン（Maria Cheng）は、「これは孤立した出来事のように見える」と述べた。
警察によると、彼女の2人の子供は最大で2日間、アパートで一人だったそうです。	警察によると、彼女が死んでいる間、2人の小さな子どもは最大で2日間、そこに一人でいたそうです。
司祭であるジョン・F・ジョンストン牧師(64)(ジャクソンハイツ35番街)は、悪化した嫌がらせと武器の犯罪的所持で告発されました。	警察の発表によると、ジョン・ジョンストン牧師（64歳）は、電話事件における加重ハラスメントと、武器の犯罪的所持で起訴されました。
リンダ・リングル州知事と彼女のスタッフは、海軍基地で打ち上げを見守った。	リンダ・リングル州知事や他の要人も基地で打ち上げを見守る予定です。
この和解案には、410万ドルの弁護士費用および経費が含まれています。	原告側の弁護士は、和解金のうち410万ドルを手にすることになる。
3票の反対票を入れれば、とりあえずは終了です。	の拡張を中止するには、3票必要です。
カナダを含む42カ国からの約660人の囚人が収容されており、その多くはアフガニスタンでのアルカイダ・ネットワークとの戦いの間に捕らえられたものです。	グアンタナモ湾の海軍基地には42カ国から660人の囚人が収容されており、その多くはアフガニスタンでの対アルカイダ戦争で捕らえられたものです。
カンザス州を担当するJohn A. Dvorakへのお問い合わせは、電話 ( 816 ) 234-7743 または電子メール (jdvorak @ kctar.com ) でお願いします。	ブラッド・クーパー（ジョンソン郡市記者）への連絡は、電話 ( 816 ) 234-7724 または電子メールを bcooper @ kcstar.com に送ってください。
ジム・ハーディン検事はこの判決を キャサリン・ピーターソンさんの家族の勝利と呼びました .	キャサリン・ピーターソンさんのご家族は欠席されました。
一見したところ、Do-not-call登録の作成者によって描かれた区別は、まさに正しい場所に線を引いているように見えるでしょう。	一見したところ、レジストリの作成者は、除外される通話と禁止される通話の境界線を正しい場所に引いたように見えます。
と、ストーン・カウンティ・ナーシング・アンド・リハビリテーション・センターの社会部長であるアレシャ・バグリーは今週、語った。	そして今は、彼が言いたいことは何でも言える」ストーン・カウンティ看護リハビリテーションセンターのソーシャルディレクター、アレーシャ・バグレーに確認した。
エピスコパル教会の全米宗派は、230万人の会員を有し、7700万人の会員を有する英国国教会の米国支部である。	エピスコパル教会には230万人の会員がおり、7700万人の信者を持つ世界的な聖公会のアメリカ支部である。
「と、フィオリーナが語った。	" まだまだやるべきことはたくさんありますが、hpはもはや統合の話ではないと、私は確信しています。"
英国警察は火曜日未明、テムズ川で発見されたアフリカ人少年の儀式殺人容疑に関連して、21人を逮捕しました。	警察は、テムズ川で発見された首と手足のないナイジェリアの幼い子供の殺害に関連して、21人を逮捕しました。
調査官にできることは、孤立したビジネス上の意思決定の過程と内容について小言を言うこと、そして経営者としての能力を問うことです。"	エバースの弁護士、リード・ウェインガーテンは、徹底的な調査にもかかわらず、「調査官ができるのは、孤立したビジネス上の意思決定の過程と内容について、小言を言うことだけだ」と述べた。"
午後遅くには、ダウ平均株価は12.81ドル（0.1％）高の9,331.77ドルとなり、月曜日に201ポイント上昇して2002年7月以来の高値となりました。	午前中の取引では、ダウ平均は8.76ドル（0.1％）安の9310.20ドルで、月曜日には201ポイント上昇していた。
ウクライナとロシアの国境紛争がさらに悪化しているため、ウクライナのレオニード・クチマ大統領は本日、ラテンアメリカへの訪問を取りやめた。	この問題により、ウクライナのクチマ大統領はラテンアメリカへの公式訪問を取りやめた。
司法省は木曜日、連邦当局が「不穏な」少年虐待と「不当な」条件と呼ぶ2つの州営施設を終わらせなかったとして、ミシシッピ州を提訴した。	司法省は木曜日、ミシシッピ州に対し、州が運営する2つの施設で少年犯罪者が虐待を受けているとする市民権に関する訴訟を起こしました。
チェルシーのDFマルセル・デサイリーは、最近になって発言している。	フランス代表キャプテンでチェルシーのディフェンダーであるマルセル・デサイリーは、後者が真実であると考えている。
モスクワの支援を受けるチェチェン共和国の政府関係者は、反政府勢力の頻繁な標的となっており、紛争で荒廃したチェチェンで来週日曜日に行われる大統領選挙を前に緊張が高まっている。	モスクワに支援されているチェチェン共和国政府の役人は、しばしば反政府勢力の標的となり、戦争で荒廃した地域で日曜日に行われる大統領選挙を前にして緊張が高まっている。
エリック・ギャングは9回目の完璧なピッチングで23回目のセーブを達成。	gagneは9回を2三振で完璧に抑え、23個目のセーブを達成しました。
は、ナスダックでちょうど彼らの52週間の高値の下に閉じた , で $ 32.17 , アップ $ 1.54 .	echostarの株式の取引は32.17ドルの52週間の高さで火曜日を閉じた , 最大1.54ドル .
彼女は部隊で唯一の女性で、チームスターズローカル995のメンバーだった。	彼女は、倉庫作業員や重機オペレーターとして雇用された唯一の女性であり、所属するチームスターで唯一の女性でした。
ジャニス・ケリー氏は、夫がmodの高官から自分の名前が公表されないという保証を受けたと語った。	彼女は、夫が名乗り出たとき、ライン・マネージャーや省庁の高官から名前が公表されないという保証を受けていた、と調査団に語った。
もし有罪になれば、11の訴因それぞれについて、最高で5年の懲役と25万ドルの罰金に処されます。	有罪判決を受けた場合、それぞれ最高5年の禁固刑と、関与した利益の額に応じて25万ドル以上の罰金に直面します。
特別警察は、土曜日未明、彼の飛行機が給油を行ったシベリアの都市ノボシビルスクで、ホドルコフスキーを拘束した。	ホドルコフスキーは、土曜日未明にシベリア・ノボシビルスクで給油した際、警察に拘束された。
また、ソニー・エリクソンは、収益性を高めるため、ドイツのミュンヘンにあるGSM/UMTSの研究開発センターを閉鎖すると発表しました。	また、ソニー・エリクソンは、ドイツのミュンヘンにあるgsmおよびumts端末の研究開発拠点を閉鎖する予定であると発表しました。
しかし、13億人の人口のほとんどが住む広大な田舎に広がるのを防ぐために、国は躍起になっている。	中国は、13億人の人口のほとんどが住む田舎への病気の蔓延を食い止めようと躍起になっている。
カンザス州保健環境局の記録によると、昨年、14歳以下の少女に行われた中絶は88件だった。	カンザス州保健環境局の統計によると、昨年は11,844件の人工妊娠中絶が行われた。
北米で発生した史上最大の停電からウォール街が立ち直ろうとする中、金曜日のスポット取引で米国社債の利回りスプレッドが縮小した。	金曜日の米国株は、北米で過去最大の停電が発生した後、ウォール街が再編成されたため、羽のように軽い出来高でわずかに上昇しました。
乗客は何が起こっているのか知らされていなかったが、避難はスムーズに行われたと、ハントは言った。	の乗客は、何が起こっているのか知らされていなかったが、スムーズに避難することができたという。
「このマップバグがクローン病患者の大部分に存在するという発見は、それが腸の炎症を引き起こしていることはほぼ間違いないということを意味します。	研究者によれば、クローン病患者の大部分にマップバグが存在するという事実は、それが腸の炎症を引き起こしていることはほぼ間違いないとのことである。
1993年から2002年の間に、142件の性的暴行の申し立てが報告された。	1993年から2002年の間に、アカデミーで報告された性的暴行は142件でした。
と言っただけであったという。	事故後の数秒間、スミス機長は "oh my god. "とだけ言ったと彼女は付け加えた。"
2001年に生まれた男の子の平均寿命は74.4歳で、1990年から2歳延びています。	この報告書によると、平均寿命は1990年から2年近く伸びています。
クーリーは、ムハンマドも同様に、マルヴォの公判前審問で証人として召喚されると予想している。	リー・ボイド・マルボは 水曜日に証人として呼び出されます 同じく狙撃手のジョン・アレン・モハメド容疑者の 公判前審問で．．．
「彼は本当に笑顔で、最後の言葉もなく、私たちを残していきました」と娘のリンダ・ホープが言った。	「彼は本当に笑顔で、最後の言葉もなく、私たちを残していきました...彼は私たちそれぞれにキスをして、それで終わりでした...」と彼女は言いました。
12ヶ月間を通して、高速ケーブル・モデム接続は49％増加しました。	2003年6月30日に終了した通期では、高速回線は45％増加しました。
また、証券業界から永久に追放される可能性もあります。	には、罰金、資格停止、証券業界からの永久追放の処分が下されます。
「彼らは、無私で勇気のある、感動的なカップルだった」と、オスカー受賞の映画監督は語った。	私心なく、勇気のある、感動的なカップルでした。
この報告書は、裁判所が裁定した内容と完全に一致しており、この部門の行動は完全に法律の範囲内であると信じています...。	コムストックによると、いくつかの連邦裁判所は、拘束は完全に法律の範囲内であると判断しているとのことです。
2人目の犠牲者マイケル・ウォーカー（23）は胴体を撃たれ、弾丸は彼の肺を貫通した。	もう一人の被害者、マイケル・ウォーカー（バーベイ通り550番地）は首を殴られました。
この4ヶ月で約25の政府が署名し、そのうちの約半数はこの3週間で署名した。	国務省のリストによると、過去4ヶ月で約25カ国が、過去3週間で約半数が二国間協定に調印しています。
犯罪学者であるヒーリーは、インタビューの中で、この国や全米の立法者たちの感情の多くが、死刑に対する警戒心であることを認めた。	犯罪学者であるヒーリー女史はインタビューの中で、多くの議員がここと全米で死刑に対する警戒心を共有していると述べた。
フランクリン郡のテレサ・バートンによると、消防士が雷に打たれ、フランクフォート地域医療センターに運ばれたそうです。	郡消防士が落雷に遭い、フランクフォート地域医療センターで安定した状態にあります。
また、ジャカルタで1人、ジャワ島中部のマゲランで1人の計2人が逮捕されたことを、警察のエドワード・アリトナン准将が土曜日に確認した。	警察のエドワード・アリトナン准将は昨日、ジャカルタで1人、中部ジャワのマゲランで1人の計2人が逮捕されたことを明らかにした。
連邦判事のウィリアム・バーバーは火曜日、アバンツが残忍な殺害に反省していないため、最高刑を科したと述べた。	連邦地裁のウィリアム・バーバー判事は、アバンツが反省していないため、最高刑を科したと述べています。
しかし、自称ワーカホリックのワイル氏は、今後も会社に深く関与していくつもりだという。	それでも、ワイル氏は依然として会社の重要な権力者であることに変わりはない。
約120人の陪審員候補が、長いアンケートに答えるよう求められていた。	陪審員は40人ずつのグループに分かれて法廷に入り、アンケートに答えるよう求められた。
また、5人の補欠審査員も選ばれ、最終審査員は金曜日の朝に選ばれることになっています。	また、5人の補欠審査員が選ばれ、6人目の補欠審査員は金曜日に選ばれる予定です。
元投資銀行家のグレゴリー・パルセギアンが最高経営責任者に就任しました。	グレッグ・パーセギャンが新CEOに就任しました。
カリフォルニア州農業局は、コメントを求める電話にはすぐに応答しませんでした。	カリフォルニア州農業局は、火曜日の判決に対して、すぐには公式な反応を示さなかった。
報告書は、バリ島爆弾テロの作戦司令官とされるムクラスと、「国際的で教養のある若い女性」ファリダとの結婚を挙げている。	報告書は、ジが結婚を利用して成長する方法の例として、バリ島爆破テロの作戦司令官とされるムクラスの結婚を挙げている。
自由への揺りかご協議会は、ナショナルグループのスタンスに逆らう最初のものではありません。	フィラデルフィアの議会は、国の政策に逆らった最初の議会ではありません。
しかし、首相はbbcに、世論調査は気にしないし、正しいと信じることをやり続けると語った。	彼は、世論調査は気にしないし、外交と内政の両方で、正しいと信じることをやり続けると言った。
サトラーGMは、アデン湾とインド洋を拠点とする統合任務部隊を率いています。	サトラー将軍は司令船マウント・ホイットニー号で統合任務部隊を率いています。
というのも、「そんなのバカバカしい」と、ファニーサイドのトレーナー、バークレイ・タグは言った。	一方、ファニーサイドのトレーナーであるバークレイ・タグは、この疑惑を「馬鹿げている」と述べています。"
委員会は、商務省に対し、60日以内に関税の数字を修正するよう命じた。	60日以内に回答するよう商務省に要請した。
トムソン・ファースト・コールによると、ウォール街のアナリストは1株当たり22セントを予想していました。	この結果は、Thomson First Callが調査したアナリストの予測を3セント下回るものでした。
この判決は、ヒューレット・パッカード社が同社に入札するのではないかという3日間に及ぶ激しい憶測を受けたものです。	この判決は、パソコン大手のヒューレット・パッカード社がリム社に入札するかもしれないという憶測をめぐり、リム社の株価が乱高下した3日間に続くものだ。
昨年、キューバ当局によると、ロサンゼルスで開催されたグラミー賞に出席するため、ノミネートされた20人近いキューバ人ミュージシャンのうち、時間通りに米国ビザを取得した人はいなかった。	キューバ当局によると、昨年、ノミネートされた約22人のキューバ人ミュージシャンのうち、ラテン系グラミー賞に出席するために米国のビザを取得した人はいなかったという。
この研究結果は、7月1日発行のAnnals of Internal Medicineに掲載されました。	この研究結果は、本日、Annals of Internal Medicine誌に掲載されました。
早ければ金曜日にも上院本会議で取り上げられる可能性があります。	ラットリフは、金曜日までにこの2つの法案を上院本会議に提出することを望んでいる。
エンロンの広報担当者エリック・ソードは、調停命令についてコメントを避けた。	エンロンの広報担当者、エリック・ソードは「素晴らしいニュースだと思う」と述べた。
労働省のアナリストは、企業調査による給与統計は、より多くのサンプルに基づいているため、より正確な経済状況を把握できると考えている。	アナリストによると、給与統計はより多くのサンプルに基づいているため、より正確な経済状況を把握できると考えているそうです。
両親は彼女が生き続けることを望むが、夫は彼女が人為的に生かされることを望まなかったと言う。	マイケル・スキアボは、妻は決して人工的に生かされることを望んでいなかったと主張している。
以前、彼はフランス・インターラジオに、「今起きていることを本物の流行病として認定できると思う」と語った。"	「私は、今起こっていることを本物の伝染病として認定できると思います」ジャン・フランソワ・マッテイ保健相は、フランス・インター・ラジオでそう語った。
テリー・スキアボ（39歳）は、過去数年間過ごしたタンパ地域のホスピスで、今後2週間以内に死亡すると予想されている。	テリー・スキアボ（39）は、数年前から住んでいるタンパベイエリアのホスピスで処置を受けたと、彼女の父親であるボブ・シンドラーは言った。
同社は、この夏の終わりに800のホットスポット、または「Wi-fiゾーン」を開始し、年末までに2,100以上を持つことを計画しています。	このサービスは、今年の夏以降に800ヶ所で開始され、スプリントは年末までに2,100ヶ所を計画しています。
コダック入社以前は、プロクター・アンド・ギャンブル社に勤務し、フォルジャーズシャンプーなどの製品を管理していました。に勤務し、フォルジャーズやパンテーンシャンプーなどの製品を管理していました。	Eastman Kodak入社以前は、Procter & Gamble社でマーケティングの上級職を務めていました。
マクデビット氏は、ソロモン諸島の警察活動の3つの重要な局面をコントロールすることを認められたのです。	マクデビット氏は、ウィリアム・モレル警視総監から警察活動の3つの側面を管理することを許可された。
金の上昇は、他の貴金属を高く引っ張られ、銀は4.77 / 79ドルから1オンス、最後にニューヨークで引用された4.81 / 83ドルにシャントする。	金のバウンスは、他の貴金属を高く引っ張っ、銀は4.83 / 82ドルから1オンス85ドル最後のニューヨークで引用された送信します。
ロッキンガムのノースカロライナスピードウェイの関係者と連絡が取れませんでした。	火曜日、ナスカーの関係者からのコメントは得られていません。
子供はナッソー・カウンティ・メディカル・センターに運ばれ、経過観察中とのことです。	少年はナッソー大学医療センターに運ばれ、スタッフの話では「大丈夫」だったそうです。"
グローバル・クロッシングの広報担当者であるティシャ・クレスラーは、コメントを拒否しました。	グローバルクロスの担当者からは、すぐにコメントは得られませんでした。
lendtreeの株式はナスダック株式市場の午後の取引で$ 5.99 、または40.1パーセント、$ 20.68に急騰しました。	lendingtreeの株式は6.21ドル、または42％上昇し、以前に21.36ドルを打った後、20.90ドル。
組合は3月にも5日間のストライキを行い、イェール大学の1つの食堂を除くすべての食堂を閉鎖に追い込みました。	組合は3月にも5日間のストライキを行い、過去10回の契約のうち8回はストライキに突入している。
リック・ペリー州知事は、ギャンブルの拡大に反対しているが、宝くじ委員会の継続に拒否権を行使するのは不本意だろうと述べている。	リック・ペリー州知事はギャンブルの拡大に反対しているが、宝くじの日没法案を拒否することは「難しい」と述べている。
午後の取引では、ナスダック総合指数は8.34（0.5%）上昇し、1,790.47となりました。	ナスダック総合株価指数（IQ）は8.59ポイント（0.48%）下がり、1,773.54となりました。
ケンタッキー州では、民主党の司法長官ベン・チャンドラーが下院議員アニー・フレッチャーと対決しています。	ケンタッキー州：共和党のアーニー・フレッチャー下院議員（3期）が、民主党のベン・チャンドラー州司法長官と争っている。
ダウ平均株価は98.32ドル（約1.1％）下がり、9011.53ドルとなりました。	ダウ平均株価は98.32ポイント安の9,011.53で取引を終えました。
エンロンの401（k）プランには、約2万人の従業員、退職者、受益者が含まれていました。	エンロンの株式は、労働者の401（k）ポートフォリオの61％を占めていました。
米国上院司法委員会は昨日、アスベスト被害者に支払うための信託基金を設立する戦いにおいて、重要なハードルを乗り越えた。	火曜日、上院司法委員会は、アスベスト被害者に支払うための信託基金を設立する戦いにおいて重要なハードルを乗り越えたが、最も困難な障害が残っている。
しかし、彼女は2004-05年の2年間の1174億ドルの予算を認定するかどうかは言わなかった。	彼女は、予算を認定するかどうかまだ分からないと言った。
リモートプロシージャコール（RPC）脆弱性の潜在的な危険性を過大評価するのは難しいでしょう。	この欠陥は、コンピュータ間の通信を扱うリモートプロシージャコール（rpc）プロトコルに関係します。
肥満が健康問題のリスクを高めることができますが、懐疑論者は主張するので、喫煙や高コレステロールを行う。	肥満が健康上の問題のホストのリスクを高めることができますが、懐疑論者は主張するので、喫煙や高コレステロールは、病気と見なされません。
ミッシェル・ウィーは日曜日、第27回米国女子アマチュア・パブリック・リンクス選手権でビラダ・ニラパトポーンに1アップで勝利した際に、チップを投げています。	日曜日に開催されたUS女子アマチュア・パブリック・リンクスで優勝し、初のトロフィーを手にしました。
ソニーは、PSPが4.5インチの液晶画面、メモリースティック拡張スロットを搭載すると発表した。	また、4.5インチのバックライト付き液晶画面とメモリ拡張機能を備えています。
ハンティントンビーチの3つのサンプリング地点のうち1つで、6月16日に160、6月23日に120のバクテリアが検出されました。	ハンティントンビーチにある3つのサンプリングサイトのうち1つで、6月16日に160、6月23日に120という数値が出たのです。
アメリカの保守派は、司教教会内では明らかに少数派です。	この書簡は、バチカンが司教区内の保守派を強化することに関心を持っていることを示している。
過去数十年間、延縄で100本の針に10匹の魚がかかっていたのが、今では1匹しかかからないという幸運に見舞われているのです。	「以前は100本の針に10匹の魚がかかっていたのに、今は1匹がやっとだ」とマイヤーズ。
ニューヨークの上院議員の新刊「リビングヒストリー」がベストセラーになるようだ。	ニューヨークの上院議員で元大統領夫人のヒラリー・クリントンが、「リビング・ヒストリー」というタイトルの本を月曜日に出版するそうです。
カーニバル社の株式は、水曜日の昼間の取引で31.29ドルで取引され、72セント（2.25％）減少した。	カーニバル社の株価は、ニューヨーク証券取引所で2.5％（81セント）下がり、31.20ドルでした。
しかし、火曜日、上院の下院案に対する批判は、いくつかの側面からなされた。	そして、上院の共和党員の何人かは、下院の地図について不機嫌です。
その結果、マーフィーはストライアの妹であるエセル・セルニックを管財人にするよう求めた。	マーフィーによると、ストライアの妹のエセル・セルニックはその時、法廷にいたが、ストライアはいなかった。
それは治療の8週間のコースごとに約20,000ドルの費用がかかります , 他の注入された癌治療と同等 , 広報担当者は言った .	それは治療の平均コースあたり約20,000ドルの費用がかかります - 16〜17週間。
このルールは、グループがいつでも候補者を宣伝、支持、攻撃、または反対する広告を放映することを禁じています。	それは、同じグループがいつでも促進、サポート、攻撃または候補に反対する広告を放映することを禁止するフォールバックルールを支持した。
シスコは売上低迷を補うために支出を削減した。	売上が伸び悩む中、シスコは支出を抑えた。
カンザスシティは、ペンシルベニア州のケネディ・ケニック高校出身のクリス・ルバンスキー外野手を5位で指名した。	ロイヤルズは、ペンシルベニア州出身の打率.528の高校生外野手、クリス・ルバンスキーを5位で指名した。
ポンドは1.5875ドルで、ドルに対して0.8％ダウンしていたGBP = 。	ドルは日本の通貨に対して0.15％上昇し、115.97円となりました。
ダウ平均株価は41.61ポイント（0.44％）上昇し、9,415.82となりました。	ダウ・ジョーンズは金曜日、41.61ポイント上昇し、一日で0.4％、一週間で0.7％の上昇となった。
「最初から、誰も給料を減らされるのを見たくなかったんだ。	しかし、クロスビー氏は、「最初から、誰かが給料を減らすのを見たくはなかった。
このように、「官僚的・管理的なミスシグナルが多く、責任者は一人ではない」とgehmanは言う。	NIMAのオファーを断るにあたって、ゲーマンは「ここでは官僚的・管理的なシグナルが数多く見落とされていた」と述べています。
デブリーズは水曜日にソレダッド警察署で性犯罪者として登録するために街に立ち寄りました。	児童虐待で有罪判決を受けたブライアン・デブリースは、水曜日の午後、ソレダッド警察署で性犯罪者として登録した後、地域社会の怒りに応えて発言したのです。
日本時間午後5時、グレースの中心は北緯25.6度、西経93.7度付近、またはコーパスクリスティの東南東約280マイルに位置していた。	日本時間午前11時、フェビアンの中心は北緯18.1度、西経53.2度付近、すなわち風下の約550マイル東にあった。
土曜日には、アガシに対する149mphのサーブが、ルセドスキーの世界記録に匹敵しました。	土曜日には、ロディックが149mphのサーブを打って、アンドレ・アガシを破り、世界記録に並びました。
ある公園では、立ち入り禁止区域に検査官が何人も入っていき、他の検査官は写真を撮ったりしていました。	ある公園では、検査官のチームが従業員に止められることなく立ち入り禁止区域に入ったり、警備上重要な区域で誰にも邪魔されることなく写真を撮ったりしていました。
より広い範囲のスタンダード＆プアーズ500インデックス.spxは10ポイント（1.10%）上昇し、943となった。	ナスダック総合株価指数（IXIC）は43.64ポイント（2.89%）上昇し、1,553.73となりました。
10月のヒーティングオイル先物は、0.85セント低い69.89セント1ガロンで決済されました。	10月のヒーティングオイルは、0.41セント減の1ガロン70.74セントで終了しました。
レビーン氏は、コーエン・アロン氏がワールドカップ期間中にこの話を売ろうとしたことを確認しました。	コーエン・アロン氏の弁護士であるドナルド・レヴィーン氏は、彼女が2月にこの話を売ろうとしたことを認めた。
バンクヘッド氏は犯行現場から犯人は "非常に几帳面 "であったと述べています。"	GBIのスポークスマン、ジョン・バンクヘッドは、殺人現場は犯人が非常に几帳面であることを示していると述べた。
コロンビア事故調査委員会のメンバーであるハバード氏は、「これは、泡がこのようなダメージを与えることができるということに、かなり近づいた」と述べている。	「泡がこのようなダメージを与えるということに、かなり近づいたと思います」とハバードは言った。
「と、マイクロソフトのスポークスマン、ショーン・サンドウェルは語った。	「マイクロソフトは、アステイクの内部人事の決定とは全く関係がない」とサンドウォールは言う。
エジプト学者は火曜日、最も有名な古代エジプト人の一人であるネフェルティティ女王のミイラを発見した可能性があるという探検隊の主張に疑問を投げかけた。	エジプト学者は、古代世界の伝説的な美女の一人であるネフェルティティ女王の長年の懸案であったミイラを特定した可能性があるとみている。
同一のローバーは、ロボット地質学者として機能し、過去の水の証拠を検索します。	ローバーは、ロボットの地質学者として機能する , 6つの車輪の上に移動する .
国庫証券の長期的な計画では、すべての国庫証券のリテール購入者が、単一の口座で保有証券をオンラインで管理できるようにすることです。	国庫は、すべての国庫証券の個人購入者に、最終的には単一の口座で保有資産をオンラインで管理する能力を与えたいと述べています。
「カナダは小さな国ですが、このような会社、このような取引を必要としています。"	熱烈なナショナリストであるダレッサンドロ氏は、「カナダは小さな国であり、このような企業がもっと必要である。"
彼は昨夜、キングスカウンティ病院センターで重体だが安定した状態であると警察は発表した。	その被害者はニュージャージー州の住民で、病院では重体だが安定している。
30年債US30yt = RRは1-3 / 32を成長させ、4.30パーセントの利回りで、水曜日後半の4.35パーセントから低下した。	午前11時（1500 GMT）、10年債US10YT = RRは、11 / 32アップ3.40パーセント水曜日から3.36パーセントの利回りであった。
ピュアチューンズの代表者からは、水曜日、すぐにコメントを得ることができませんでした。	ピュアチューンズの代表者は木曜日、この訴訟についてコメントするために場所を見つけることができませんでした。
iacの株価は34.19ドルで2.81ドル（7.6パーセント）ダウン昨日閉鎖した。	インタラクティブコープの株式は、ナスダック株式市場で$ 34.19、ダウン$ 2.81、または7.6パーセントで終了しました。
上院の議場から発言したバード氏は、「演説のために戦士の服装をする、机に向かう大統領の動機に疑問を持っている」と述べた。"	"しかし、机上の空論に終始する大統領が" "演説のために戦士の服装をする動機には疑問がある。"
国防省は、英国兵士にレイプされたという数百人のケニア人女性から2000万ドルの補償請求を受けている。	英国兵士に襲われレイプされたと主張する何百人ものケニア女性が、国防省を相手に裁判を起こすため、政府の法律扶助を受けた。
警察当局のS.K.トナピはロイターに対し、少なくとも40人が死亡し、100人以上が負傷したと語った。	州内務省のバサント・ピトケ報道官はロイターに対し、少なくとも42人が死亡し、112人が負傷したと述べた。
USAインタラクティブの株式は、ナスダック株式市場の複合取引で金曜日に2.28ドル、7％、34.96ドルに上昇し、今年53％増加している。	lendtreeの株式は6.03ドル、41％上昇し、昨日のナスダック株式市場で20.72ドルで終了しました。
同様の法案は下院を2度通過したが、上院では否決された。	2年前、下院は同様の法案を可決しましたが、上院で挫折しました。
ショーの終了は、第3四半期の1株当たり利益に1円影響を与えました。	同社は、このことが1株当たり1円の収益に影響を与えたと述べています。
私はまだ戦うチャンスを持っている、しかし、 "ヒューイットは、センターコートでダビデンコ6-3 4-6 6-3 7-6（7-5 ）に打ち勝った後に語った。	「私はまだ赤ホットお気に入りではない、 "ヒューイットは、センターコートでダビデンコ6-3 4-6 6-3 7-6 （7-5）をダウンさせるために戦った後に述べた。
「ジェレミーはいい奴だ」とバーバーは言い、「ジェレミーはニューヨークのアスリートの夢のような人生を送っている。	また、ショッキーは「ニューヨークのアスリートの夢のような生活を送っている」とも言っている。
この女性は6月15日に入院したと、カンザス州保健当局が発表した。	ミズーリ州保健当局によると、彼は入院しておらず、回復しているとのこと。
過去3ヶ月に渡って上昇を続けてきた楽観的な見方が、相次ぐ利益警告によって払拭され、水曜日の午後には優良株が下落に転じました。	水曜日の早朝取引で、米国株は利益警告が相次ぎ、過去3ヶ月間の上昇を牽引してきた楽観的な見方が失われたため、下落しました。
技術系のナスダック総合指数< .ixic >は、5.91ポイント（0.29％）増の2,053.27となった。	テクノロジーに特化したナスダック総合指数 < .ixic > は6ポイント（0.30%）上昇の2,053となり、それまでの損失を帳消しにした。
しかし、三菱東京フィナンシャル・グループ（JP : 8306）は3000円（0.65%）下落し、45万6000円となった。	三井住友ファイナンス（JP : 8316 : ニュース, チャート, プロフィール）は、198,000円で2.5％下落しました。
容疑者にはクウェート人2人とヨルダンのパスポートを持つパレスチナ人6人が含まれているという。	クウェート人2名とパレスチナ人6名がヨルダンのパスポートを持ち、残りはイラク人とサウジアラビア人だという。
彼女の誕生日である4月21日は祝日とされ、レセプションと舞踏会に出席した。	1947年に彼の祖母、当時のエリザベス王女が21歳になったとき、その日は祝日とされ、彼女はレセプションと舞踏会に出席した。
司法妨害の陰謀と大陪審への嘘の罪に直面しているソーキンは、別々に裁判を受けることになっていた。	ソルキンは大陪審への陰謀と嘘の罪で別に裁判にかけられるはずだった。
午後3時前にレイクサイドの郵便局に侵入した男は、午後6時30分ごろに保安官代理に身柄を引き渡した。	午後3時前、メイン通りのウッドサイドアベニューにある郵便局に男が侵入しました。
「モスクを訪問することを含む調査を行ったFBIのオフィスは10以下であると司法省は述べている。	また、司法省によると、FBIはモスクへの訪問に関わる捜査を10件未満しか行っていない。
法廷の外では、最大25年の懲役に直面するsriyantoは、彼が何か悪いことをしたことを否定した。	裁判所の外で、Sriyantoは、彼が何か悪いことをしたことを否定しました。
ミシガン大学のメアリー・スー・コールマン学長は、同大学のウェブサイト上で「我々の基本的な価値観は変わっていない」と声明を発表した。	「私たちの基本的な価値観は変わっていない」と、同大学のメアリー・スー・コールマン学長はアナーバーで声明を発表した。
木星の周辺を調査していた2人の天文学者は、新たに20個の月を検出し、巨大惑星の合計が60個になったことを明らかにした。	天文学者は、木星を周回する8つの衛星を発見し、その合計が60個になったことを明らかにした。
comcastのクラスA株は、ナスダック株式市場の午前中の取引で30.50ドルと8セント上昇した。	昨日、ナスダック株式市場の取引で、株価は48セント上昇して30ドルになった。
トーマスはレーンクィストと、オコナー、スケリアが部分的に参加した。	彼は、ウィリアム・H・レーンキスト最高裁判事、サンドラ・デイ・オコナー、アントニン・シェリア両判事とともに参加しました。
「彼らがしたことは、憲法を回避するための薄っぺらい試みである」と彼女は言った。	教会の弁護士であるシャーリー・フェルプス＝ローパーは、「彼らが行ったことは、憲法を回避しようとする薄っぺらな試みだ」と明言した。
一線を越えたとき、あなたは憲法上の権利を侵害したのです」と、カリフォルニア大学バークレー校のチャールズ・ワイゼルバーグ法学教授は述べています。	カリフォルニア大学バークレー校で法律を教えるチャールズ・ワッセルバーグは、「あなたが一線を越えたとき、あなたは憲法上の権利を侵害したのです」と述べています。
空港で二人が一緒にいるところを目撃されたわけではないとのこと。	彼らはパキスタンのパスポートを持っていて、夕方、空港で一緒にいるところを目撃されたという。
昨日、トロントでは64件のSARSの可能性があるケースと9件の疑いがあるケースが発生した。	水曜日の時点で、トロント地区で65件のSARSの可能性があります。
ナスダック総合指数は13.70（0.8％）上昇し、1700.34となりました。	技術系のナスダック総合指数（IXIC）は13.73ポイント（0.81％）上昇し、1,700.34で終了しました。
オーストラリア第2位の輸送会社であるトール社は先週、トランツ・レイル社に1株75ニュージーランドドルでの買収を提案した。	トール社は先週、1株75カナダドル（約1億5800万円）で同社の買収を提案した。
6番染色体上の約1,557個の遺伝子が機能していると考えられています。	残りの1,557個の遺伝子は、すべて機能的であると考えられている。
世界中の70万人の顧客のために電子メールサーバーをアウトソーシングしているメッセージラボは、木曜日の朝の時点で、115カ国で27000通の感染した電子メールをフィルタリングしたと発表しました。	世界中の70万人の顧客のために電子メールサーバーをアウトソーシングしているmessagelabsは、このワームを「高リスク」と位置づけ、120カ国で31000件以上の感染が報告されています。
第2四半期の販売量は、4800万ボイルから4600万ボイルに減少すると予想しています。	第2四半期の生産量は、前年同期の4,800万バレルから4,600万バレルに減少しました。
サダム・フセインの故郷であり、バース党支持者の地域の中心であるティクリート近郊で5時間にわたる掃討作戦の間、米軍は何の抵抗も受けなかった。	ティクリットはサダム・フセインの故郷であり、その周辺はバース党の支持者や元イラク軍高官の温床として知られている。
女性は脅されていると感じ、奉行所に行ったと警察は言っている。	女性は脅迫されていると感じ、地元の判事の事務所でスタックハウスの逮捕状を取ったと報告した。
モンテネグロ自由同盟のミオドラグ・ジブコビッチ氏が31％の得票率、無所属のドラガン・ハジュコビッチ氏が4％の得票率であった。	独立派の野党リベラルアライアンスのリーダー、ミオドラグ・ジブコビッチ氏は31％の得票率で2位となった。
カールソンは火曜日、この件から身を引くつもりはないと言った。	カールソンはこの事件から身を引くことを拒否したとサービス当局が発表しました。
オラクルの株式も高く、$ 13.60で12セントを取引された。	レッドウッドショアを拠点とするオラクルの株価は14セント上昇し、13.62ドル。
前年同期比では、26百万円の税引前利益を計上しました。	一昨年は2600万ポンドの利益を計上しました。
すべての選挙区で、レキシントン出身の3期目の下院議員であるフレッチャーは、57％という圧倒的な得票率を獲得しました。	すべての選挙区で、フレッチャーの得票数は88,747票、つまり全体の57％を占めた。
木曜日までに、オラクルによると、3475万株のピープルズソフトが入札されたそうです。	3470万株の応募があった、とオラクルは発表しています。
香港では、7人の公立病院職員がインフルエンザのような症状を呈したため、24人の患者が水曜日に隔離された。	公立病院の医療従事者7人がインフルエンザのような症状で倒れたことを受けてのことです。
上方では、コカ・コーラ社（NYSE : KO - NEWS - PEOPLE）は、欧州の需要に支えられ、木曜日の早い段階で四半期利益の増加を報告しました。( nyse : ko - news - people ) は、木曜日の早い段階で、ヨーロッパの需要に助けられ、四半期の利益が増加したと報告しました。	コカ・コーラ株式会社( ko ) は、ヨーロッパの需要に助けられ、木曜日の早い段階で、四半期利益の増加を報告しました。
ユカイパはドミニクを所有していたが、1998年に25億ドルでセーフウェイに売却した。	ユカイパは、1995年にドミニクを6億9300万ドルで買収し、1998年に18億ドルでセーフウェイに売却した。
失業率は10分の1ポイント上昇し、6.1％となり、1994年7月以来の高水準となりました。	失業率は1％ポイント上昇し、6.1％になると予測される。
デレーニー氏は取引の一環として継続的な捜査に協力することに合意しました。	デイブ・デレイニーは連邦検察に協力することで合意し、司法取引を行いました。
はアルバカーキから、Villafrancaはオースティンから、Ratcliffeはラレードから報告されました。	ラレドからはピート・スローバーが、アルバカーキからはグロマー・ジェファースが報告しました。
25％の値上げで、学部の授業料は年間約5,247ドルになり、雑費やキャンパスでかかる費用を含む。	25％の値上げにより、UCの学部の年間授業料は4,794ドル、大学院の年間授業料は5,019ドルになりました。
