熱や化学的な処理で、吸収可能な物質に変換する。	化学的作用、熱、または水分によって軟化または崩壊すること。
より大きなオブジェクトの付属品である取り外し可能なデバイス。	補助的な部品または付属品.
しきべつめい	製品またはサービスの名称です。
ライン , カバー	前面または表面を覆う。
標準を決定する；容量または測定値を推定する	を見積もる。
かいしゃくじっこう	意味や意義の精神的な表現.
最適な動作になるように微調整する；一定の規模に調整する。	微調整をしたり、印をつけた間隔に分割して最適な測定ができます。
詠歌	なんども繰り返し歌われる。
職に就かせる	に任命する。
収納キャビネット家具	書類整理用の容器からなるオフィス家具。
かぶしきがいしゃ	会社の資本金が分割され、その所有権が株券によって証明される均等割当てのいずれか。
(通信の内容	文字や音声、または信号で行われるコミュニケーション（通常は短い）。
部分入れ歯	欠損した歯の両隣の歯に固定する義歯。
を完全に囲む、カバーやボーダーを持つかのように、閉じます。	を完全に囲い込む。
しゅうりょう	語末（接尾語や屈折語尾、最終形態素）．
ジグザグに走る	をクランク状に曲げる。
困らせる、嫌がらせをする、嘲笑する、おそらく遊び半分で。	揶揄する
熟慮する	本質的な特徴や意味を見出すために、詳細に検討し、分析すること。
重い放射性金属元素、原子番号92	毒性の強い銀白色の放射性金属元素で、多くの同位体が存在する。
文句を言う、または誰かに意地悪を言う．	悪口を言う
ゲームポイント	試合におけるチームや個人の達成度を表す数字です。
を見つける、場所を決定する。	の場所、サイト、または限界を決定する、または示す、計器または調査によってのように。
を行うこと、または違法・不正な活動を行うこと。	を行うことであり、その目的は詐欺や違法行為である。
もどる、もどす、よみがえる	前の状態に戻る
(あることを立証する事実上の証拠（発見または展示）。	というのは、あることが真実であれば、必然的に他のことが起こるということを示す、正式な一連の声明である。
忌み言葉	空白文字
を物理的に接触させる、おそらく物理的に操作する効果を持つ。	を短時間接触させる。
国家元首	共和国の最高責任者
を、権威あるテキストまたは対応する引用文.	いっぴつけいじょう
視覚認識の一例.	( しばしば `of ' を伴って) 大きい数または量または範囲.
苦痛の緩和	良い方向への変化。
宗教団体への入会式。	洗礼を受けた人が教会に完全に参加することを認める聖餐式です。
御挨拶	尊敬の念を込めた丁寧な表現（言葉や行動で）。
遷る	一つのコマンドを実行させる。
入れ替わる	互いに与え合い、また受け合う。
句読点	は、宣言文の最後や略語の後に置かれます。
獣のような、人間のような、高い声で話す。	高い音を出す .
知の一分野	人間が関わる過去の出来事を記録し、解釈する学問分野。
キー、ピッチ、トーン、またはボリュームを変更します。	を変更し、音楽.
傷付ける	の表面を削る。
植物体の頂上付近の構造物.	キノコなどの有茎肉質菌の頂部を形成する傘や円錐に似た結実構造物。
にんしんじょうたい	他人の正直さや信頼性を信じる性質がある。
清潔にする、しっかり洗う	強くこすってきれいにする。
保存する , 安全を保つ , 質素に使う	砂糖で保存する.
発展過程	大きくなること、長くなること、数が増えること、重要性が増すこと．
そなえる	に役立つもの、必要なものを与える。
がくをおさめる	本を読んで学ぶ。
鞭打つ	むち打つ
する	形や影響を与える;方向を与える。
しゃかいけん	特定の環境または人生の歩み.
垂直方向の静的なレイアウト（テキストや数値など	数字などの縦書き配列.
ある活動の速度を制御するための装置、例えば、化学的または機械的に	流体の流れ、圧力、温度などを調整または制御するための様々な制御装置またはデバイスのいずれか。
美的または概念的な全体像を形成する。	を、統一された、整然とした、美学的に一貫した全体を形成する原因となります。
人間の脚、インフォーマル使用	脚のための非公式な用語．
並べる、平行にする	平行または直線になるように配置する。
窓やドアにメスを入れる	ネットで構成された保護カバーで、フレームに取り付けることができます。
救出	損失または危険からの回復または保護.
制限する、制御下に置く、抑止する、禁止する	によって、またはあたかも脅しによって、強制的にまたは抑止すること。
突き出す、突き出る	はみ出したり、空間に突き出したりする。
のホスト役を務める。	せわをやく
ぶぶんぜんたい	結果において、ある人が果たす役割。
最も軽い最も豊富な元素、原子番号1	非金属の一価の元素で、通常は無色無臭の非常に可燃性の二原子ガスであり、宇宙で最も単純で軽く、最も豊富な元素です。
掛け値なしに	一契機一契機
動き回る	上下または波打つように動く、揺れる．
暦数	365日（または366日）の期間。
( 医学 ) 生物が病気から身を守る能力。	( 医学 ) 生物が病気に抵抗できる状態。
声明文、言語によるアイデア	簡単な説明．
せっそう	戦闘による軍人の犠牲者。
葬儀の演出	葬儀屋という職業.
引火する	火がつく．
薬物	薬や麻薬として使用される物質。
問題解決方法	問題解決に成功した行動．
達す	ポジティブに展開する .
立ち位置を変える	は、非常にわずかに移動します。
導く、引き通す	を越える、横切る、通過する。
縁をつける	枠で囲む、または枠で囲む。
捕らえる , 囲む , 現場を発見する	偶然に、突然に、または予期せず、発見すること。
開始 , 創立 , 導入	何かを初めて始めること；新しいものを導入すること．
社会的行動、センス、判断力を鍛える、指導する、磨く	を教える、または洗練された味や判断にする。
強調する；注目する；下線を引く	線を引く
将来性	病気の経過を予測するものである．
かなしみのこころじょうたい．	厭世的で活動的でないことを特徴とする精神状態.
転地	轉位(てんい)
(させる）空間、回路またはシステムを通じて移動し、出発点に戻る。	ぐるぐる動く .
合わす	複数のものを）調和させる、または調和させる。
時を決める	スケジュールを立てる；イベントの時間と場所を計画する。
賽の目	切欠き
たらしめる	を動かす、またはある位置や状態にさせる。
抗う	反対行為
立て替え金	銀行などに預けられているお金。
パフォーマンス , ルーチン	長いプログラムの一部である短い劇場のパフォーマンス。
コンピュータサーバ	( コンピュータサイエンス ) コンピュータネットワークの共有資源として、クライアントステーションにファイルやプリンタへのアクセスを提供するコンピュータ 。
禁ずる	こうほうをふせぐ
コンピュータテキストファイル	( コンピュータサイエンス ) 7 ビットのアスキー文字を使用したテキスト ( 場合によってはフォーマット命令も ) を含むコンピュータファイル。
勝敗を決する	形や影響を与える;方向を与える.
アレンジメント	分割された要素の論理的または理解しやすい配置.
あたえる	ができるようにする。
公立中等教育学校、9-12年生	通常、9年生から12年生までを含む公立の中等学校。
ベンジャミン・ラッシュ、医師、アメリカの革命家.	医師、アメリカ革命の指導者、独立宣言の署名者（1745-1813 ） 。
にもつしつ	ラゲッジルーム
より簡単な分子化合物に還元する	分解してより単純な化合物に還元する。
物理的な接触を必要としない、感情的または知性的な結合を維持すること。	を、「感情的な」または「知性的な」状態で維持します。
エクスプレスよりも安い料金で貨物を商業的に輸送する行為。	エクスプレスよりも安い料金で貨物を商業的に輸送すること。
(天然資源の保全や管理。	環境と天然資源の保全と慎重な管理。
さやを取る、殻を取る	鞘や殻から落ちる.
焼けるように熱い、または痛い	熱くなる、痛くなる .
(返り討ちに遭わせる	断られたのにまた来る。
きのうそんしつ	正常な機能の喪失.
アドミニストレータ , リソースを管理する者	資源と支出をコントロールする人.
洗口液で口をすすぐ、うがいをする	洗口液で口とのどを洗う。
軸をとる	軸または中心を軸に、またはその周りに回転させる。
縁談	婚姻の申出．
媚を売ったり、服従や恐怖を見せたりして、好感を得ようとする.	服従や恐怖を表す．
公示送達	法律文書を公文書に記載すること。
萎む、枯れる、成熟しない、花のように。	萎む、枯れる、成熟しない．
認知過程と記憶する能力.	過去の経験を記憶するための認知プロセス。
は、破壊されたもの、または分解されたものの残骸。	壊れてしまったもの、壊れてしまったもの。
ある物質をある剤で処理する；ある剤を添加する.	を扱い、...に加える。
食道を通る	飲食の際に食道を通過する.
縦横無尽に動く	を、境界のある空間の中で自由に移動または操作できるようにします。
水を吐く	涙や唾液のように、水を分泌したり形成したりする。
に平等な権利を与える、投票権のように。	女性やマイノリティに平等な権利を与える。
じょういしちょうかん	直感的な理解
せきをもうける	ごちそうにあずかる。
コンピュータプログラムを書く.	コンピュータのプログラムを書く.
法治国家	法則に従った秩序がある状態．
電子記憶装置.	電子記憶装置.
じゅんばんせん	レタリングで文字を揃えるための補助線。
献身性、目的意識の高さ	誠実で揺るぎない目的意識を持つという特性。
各要素の相対的な重要度を示すために、頻度分布の要素に割り当てられる係数。	(統計学）頻度分布の要素に割り当てられる係数で、相対的な重要度を表します。
の医療を提供する。	のための獣医学的ケアを提供する。
の表面をコーティング、カバー、または処理する。	被膜を張る；表面を覆う；表面を整える .
重複、一致	重複または一致.
陣営に住む人々	キャンプで一緒に生活する人たち。
一般に普及させる／一般的に使用する	大衆の好みに合わせて、一般に普及させる、提示する；一般的または共通に使用させる.
不浄にする、放射性にする	不浄にする
(左側に回るようにする．	船の左舷に回る。
わりふる	は、特定のタスクに割り当てる。
コンピュータの主要な情報処理装置であるマイクロプロセッサのチップ。	( コンピュータサイエンス ) コンピュータの一部（マイクロプロセッサチップ）で、データ処理の大部分を行うもの。
改めて検討する	一旦投票された法案を再度検討し、それを変更すること。
キャンセル、リバース、アニュール	行為またはその効果を取り消し、取り消し、または逆にしてください。
定義する；本質的な性質を決定する	の本質的な品質を決定します。
満足し切っている状態。	でいっぱいいっぱい。
候補者として誰かを推薦すること。	任命や選挙に適した候補者として提案されたことが条件となる。
シギを狩る	シギを狩る、撃つ。
タカを狩る	タカを狩る
波動伝播	伝播する波（光や音）が表面から投げ返される現象。
鋭く打つ、おそらくスポーツのように。	鋭く打つ、スポーツのように。
グライダーに乗る	グライダーで飛ぶ、またはグライダーのように飛ぶ．
しはんぶん	一年の四分の一、三ヶ月。
けんりょくをあたえる	権力と権威を提供する。
コンクリート打込用金型	コンクリート打ち込み用金型
摩擦を起こす; 磨耗する	磨耗する、侵食される．
瓶に入れる	液体や気体を）ボトルで保管する。
スキップ、リープ、または上下や横に移動するような動作.	スキップ、リープ、または上下や横への移動.
御洒落番長	ファッショナブルなエリートたち。
偽りの、あるいは不正な方法で制御すること。	不正な方法で操作する．
光源から安定した、均一な光を放つ。	は、炎を出さずに安定した均一な光を放ちます。
じょおうばち	社会蜂（特にミツバチ）のコロニーにいる、女王蜂と交尾することだけが役割の、刺すことのできない雄蜂。
邪魔されるのが煩わしいという感覚．	邪魔されたり批判されたりするのがうっとうしいという気持ち.
うごきまわる	車輪の上に、あるいは車輪のついた乗り物のように移動する．
[新しい、または別の休息場所を提供する	新しいシートで提供する。
地中からの採掘作業	地中から鉱石や石炭などを取り出すこと。
或いは或いは或いは或いは或いは或いは或いは或いは或いは或いは或いは......。	匹敵
害源	痛みや怪我、損失の原因.
分かりやすくする	明瞭にする、理解しやすくする。
穴をあける	穴をあける。特に先の尖った電動工具や手工具で。
新しい部品で（古いものを）修理する；改良する .	古いものを新しいもので補う。
システムの目的または機能を変更する .	を変更する。
具備する	を提供することです。
鼻梁	鼻の上部を形成する硬い隆起。
光らせる	光らせる
もとの状態にもどる	もとにもどす
スピードアップ	を促進させる。
(三球目を空振りする	を空振り三振、3.を見逃し三振。
格が上がる	格上げ
高熱伝染性ウイルス病	急性熱性高伝染性ウイルス性疾患。
大きさを揃える	サイズにする；適当な大きさにする．
木の切り株を取り除く	伐採した樹木の切り株を除去する。
舌を這わす , 舌で受け止める	舌を通す．
コンピュータで作成された視覚イメージ	コンピュータによって生成される画像。
相打ちになる	競争、レース、紛争で有利になる。
抗重力	翼に作用する空気力学的な力のうち、重力に対抗する成分。
場内放送	( 放送 ) ネットワーク番組に挿入されるローカルアナウンス。
抱き込む	を含む、または保持する；内に持っている。
特定の地点の周りを行ったり来たりして、その付近に留まります。	行き交う．
不愉快なものを我慢する；誰かや権威に対して敬意を示す．	不愉快なことを我慢する。
新しいものを作るという人間の行為.	何かを初めて始めること；新しいものを導入すること．
お金を稼ぐためにする主な活動。	お金を稼ぐために行う人生の主要な活動.
かんりょうつきいいんかい	監督権限を有する委員会
機械の動きを反対方向に変えるための歯車	歯車は、機械の動きを逆行させることができます。
食後歩く	散歩をする 健康のため、または消化を助けるために、食後に 。
差し込む、閉じる	を詰める、または栓をするようにしっかり閉める.
コンピュータ間でデジタル情報を交換し、それを利用する能力	( コンピュータサイエンス ) 情報を交換して使用する能力 ( 通常、いくつかのローカルエリアネットワークで構成される大規模な異種ネットワーク ) 。
力行	いきなり力を入れること．
を指揮する；権限を行使する；制御する.	に対する権威的な制御または権力を行使する。
円を描くように器具を動かし、混ぜる	道具を動かす
金属製スパースを装備しています。	スパーを備える。
物質から水分を除去する .	から水を取り除く。
やにがかかる	黴菌に侵される
愛想よく話す、または振舞う；セックスする。	愛想よく話す、または振舞う、真剣な意図がない。
口頭または書面によるアクセス要求。	援助や雇用、学校への入学を口頭または書面で要請すること。
徒歩で移動する .	徒歩でクロス．
動物の識別のための革またはロープのバンド。	馬具として、または識別のために動物の首にかける革またはロープのバンド。
特に家具を提供する、または装備する。	家具を提供する、または装備する.
を（頭や体を）素早く下へ、または（何かから）遠ざける。	を素早く下へ、または遠ざける。
妊娠させる；受精させ、成長させる．	肥料を与え、成長させる。
伝達手段または伝達機関。	を表現するための手段または機関である。
バラバラにする	バラバラにする
長いプログラムの一部である短い演劇のプログラム。	長いプログラムの一部である短い劇場のパフォーマンス。
命令を下す	命令を下す
会議終了	会議終了後．
の音量を上げる。	を増量する。
民族・人種を問わない	あらゆる人種や民族のメンバーに開かれた（場所）。
フライを打つ	フライを打つ
釣り出し	を引っ張らせることで、排気することができます。
は、音素のクリックを生成します。	をクリックします。
鉤縄角	水中で釣り針と糸を引いている角度。
おおがしら	けんめん
女物の袖なし下着	女性の袖なし下着.
組み合わせて新しい実体を作る	コンポーネントやメンバを組み合わせて作成します。
あかるくする	明るくする、明るくする.
天国に召される	魂を天に召す
個人的または社会的な活動での規律.	個人的・社会的な活動においての規律.
突発的な	突発的なもの．
被削材を工具で加工する	工具を使った作業 .
政党が推薦する候補者のリスト。	公職選挙に立候補するために政党が推薦する候補者のリスト。
かぜをとおす	を通過させる。
つかいまわす	使い切る
(...を)しっかりくっつける、閉じる。	をしっかりつけること。
主張すること、何かを所有すること、またはそれに対する権力を持つこと。	を所有すること、または権力を持つことです。
( 野球 ) 走者にタグを付けてアウトにする。	走者をタグ付けしてアウトにする。
熱、光、衝撃波として反射する ;.	熱、音、光、衝撃波として反射される。
やまごもる	イニングの終わりに塁に出ること、選手の.
ほとんどの生物が分けられる2つのカテゴリー（オスとメス）のどちらか、またはカテゴリーを区別する重要な特性。	ほとんどの生物は、2つのカテゴリー（オスとメス）のどちらかに分かれています。
( 科学 ) 他の元素のある重量と同じ結合能力を持つ元素の原子量。	ある重量の他の元素と同じ結合能力を持つ元素の原子量。
トグルで提供する	トグルで提供する。
(前後左右に動く	を往復させます。
淵を計る	測線で水深を測る。
一休さん	来航すること。
らせん状になる、またはらせん状に動く .	螺旋状またはジグザグ状に移動する．
嫌気・嫌悪感・反感	嫌気・反感の感情.
放つ	化学反応や物理的な分解の結果として、（ガスやエネルギーを）放出すること。
( コントラクトブリッジ ) 最高値の入札が、入札者が行わなければならないトリック数を設定したコントラクトとなります。	( コントラクトブリッジ ) 最高値のビッドがコントラクトになり、ビッダーが作らなければならないトリックの数が決まります .
征途に上る	戦地に赴く．
呼応する	刺激や命令に反応する.
放射線、熱、化学物質による皮膚の損傷	熱や化学物質、放射線にさらされることによって起こる傷害.
因縁をつける	論理的または因果的な接続を行う.
コンディショナーをつけると、なめらかでツヤのある肌になります。	コンディショナーをつけると、なめらかでツヤのある肌になります。
記憶力を発揮する	を行使する、またはその力を持つ、記憶力．
12ヶ月の会計期間	12ヶ月の任意の会計期間.
再び開く、新たに開く	再び、あるいは新たに開く.
概念的な定式化；何かを想像する方法。	発想法
いたたまれなくなる	食べたくなる
触れ合う	直接の物理的な接触がある;接触する。
噛み切る	歯や顎で、あるいは歯や顎で引き裂くように、握る、切り取る、あるいは裂く。
という疑心暗鬼。	という印象。
タッチダウン後のポイントに成功した投球またはトライ。	フリースローの成功やタッチダウン後のポイントトライ.
聞こえるように表現する；音を発する（必ずしも言葉ではない）；示す.	を表現する；音を発する（必ずしも言葉ではない）.
動機付けとなる理由を与える。	行動へのインセンティブを与える。
強引に捕らえる	力ずくで捕らえる．
( 薬 ) ギブスを装着する。	ギプスを着ける
時間を割り当てる	イベントに新しい時間と場所を割り当てる。
対価価値	対価を得るためにしなければならないこと。
人の注意を引く活動。	人の注意を引く活動。
せきをもうける	饗応する
誰かの計画や努力を邪魔する行為。	誰かの計画や努力を邪魔する行為。
外国軍隊による一国支配の期間。	外資系企業による軍事的な支配。
( コンピュータサイエンス ) コンピュータによって生成される不正確な結果の発生。	( コンピュータサイエンス ) コンピュータによって生成される不正確な結果の発生。
キリストの変貌になぞらえて理想化する	キリストの変容を連想させるような、理想化するような。
心不全	正常な身体機能を維持するのに十分な血液を心臓が送り出すことができないこと.
順応する	新しいまたは異なった条件に自分を合わせる。
を供給する食品を食べる準備ができている , パーティーや宴会のように .	パーティーや宴会で、すぐに食べられる料理を提供する。
異論を唱える	異議や抗議や批判を表明したり、反対意見を述べたりすること.
痛める , 身体の痛みを感じる	身体的苦痛を感じる .
うわさを流す	うわさを流す
もとにもどす	もとにもどす
病気や怪我を特別なケアや治療で治そうとする；慎重に扱う。	病気や怪我を特別なケアで治そうとすること。
鋭利な切り口	鋭利な刃物による強い切れ味。
一時的にでも居住している住所。	一時的でない滞在をする住所。
植物学 -- 芽や葉や節を持たない植物の通常地下の器官で、水とミネラル塩を吸収し、通常、植物を地面に固定する。	( 植物学 ) 芽や葉や節を持たない、通常は地下の器官；水とミネラル塩を吸収する；通常、植物を地面に固定する。
を再現する、または正確なコピーを作る;作る、行う、または再び実行する。	の複製または正確なコピーを作成します。
的を射る	適切であること、関連性があること、または適用可能であること。
煮込む	液でじっくりと長時間煮込む。
の地図を作る；その特徴や詳細を示す；地図を作る目的で探検や調査をする.	の地図を作成する；の詳細の特徴を示すか、または確立する。
その力が要求する行動指針に人を縛り付ける社会的な力．	その力が要求する行動指針にあなたを縛り付ける社会的な力．
満たすこと、答えること、または実行することを避ける、または避けようとする。	を避ける、または（義務、質問、または問題を）満たす、答える、または実行することを避けようとする。
維持する、主張する、または主張する	を維持・主張する。
以前の状態またはより良い状態に戻すことによって改善する。	以前の状態またはそれ以上の状態に戻す.
項数が無制限に増加するため、限界に近づく；特に数学用語。	期数が無制限に増加するため、限界に近づきます。
連邦政府の管理下に置く	連邦政府の管理・権限の下に置く。
性的快感を得るために性器周辺を手動で刺激すること.	性的快感を得るために性器周辺を手で刺激すること．
ヒューズを付ける	ヒューズを装備する；ヒューズを提供する。
アメリカ独立戦争終結	アメリカン・レボリューションの成功裏の終結．
(数学）最小の整数、またはこの数を表す数字。	最小の整数またはその数を表す数字．
自然物の全部または一部の物理的な部分で、そのクラスまたは全体の例として収集され保存されるもの.	自然物の全部または一部が、そのクラスの例として収集され保存されているもの。
出力回路の電力の一部を入力回路に作用させることにより、電子電流を増幅させる。	出力回路の電力の一部を入力回路に作用させることにより，（電子）電流を増幅させる。
拮抗する	対等な重さ、力。
(飛翔して空中に衝突させる。	飛行中の空気にぶつかる．
缶や瓶に保存する。	缶や缶に保存する。
ループ状の原子鎖	( 化学 ) 閉じたループを形成している分子内の原子の鎖。
平らにする	表面を平らにする、または滑らかにする。
冷却、洗浄、または消毒の目的で、ある液体の一定流量を供給すること。	冷却、洗浄、または消毒の目的で、ある液体の一定の流れまたは散水で供給すること。
薄く塗る / 金属	塗るを塗る。
( 神学 ) 罪から救い出す、または悪から救う行為 。	(神学）罪から救い出す、または災いから救う行為。
油で調理する。	脂身を利用して高温で調理する。
より大きな地域の中で中心的な役割を果たす地域。	ある大きな地域のほぼ中央に位置する地域。
個人的に主権を持たずに、数、量、力、地位、または重要性でより大きくなること。	数で勝る、量で勝る、力で勝る、地位で勝る、重要である。
身を委ねる	特定の人物、活動、または大義にすべてを捧げる。
親指の隣の指、人差し指	親指の横の指。
改めて検討する	を再度検討する；通常、変更することを目的として、新たな検討を行う。
くうぐんたいきょく	小隊以下の航空部隊。
雇い入れ	仕事を与えるということ
圧力や張りの喪失から、またはそのように、垂れ下がる、沈む、落ち着く；強さが弱くなる。	圧力や張りの喪失から、またはそのように垂れ下がる、沈む、または沈む。
を引用する；(議論において)頼る.	を引用する。
特定の目的または用途のために取り置く、または割り当てる。	特定目的・用途のために用意されたものである。
即席で作る	部品から作る（即興で作ることが多い）。
習うより慣れろ	反復して学ぶ．
参加登録する	参加者またはメンバーとして正式に登録する。
活字体で書く	筆記体でなく、活字体で書く。
禽獣を撃墜する	鳥を撃墜する。
( 化学 ) イオンと安定した化合物を形成することによって、隔離を受ける。	イオンと安定な化合物を形成することで封じ込めを受ける。
空気を循環させたり、気体を逃がすための開口部を設けたもの。	空気を循環させたり、ガスを逃がすための開口部を設けたもの。
12ヶ月の会計期間	12ヶ月の任意の会計期間.
dnaの鎖にある遺伝情報をrnaの鎖に変換する.	dnaの鎖）にある遺伝情報をrnaの鎖、特にメッセンジャーrnaに変換すること。
調理や加工のために、沸騰した液体に浸す、または浸されること。	煮え湯を注ぐ。
リース契約が有効である期間。	財産を人に譲る契約が有効である期間.
土嚢で守る、補強する。	土嚢で保護する、強化する、止める.
市政の長	市政の長である.
舌を這わす , 舌で受け止める	舌で受け止める．
イングランド南部のバーシャー州にあるテムズ川沿いの都市。	イングランド南部、バークシャー州のテムズ川沿いにある都市。
不完全であること、または不足であること。	不完全であること、または完全でないこと。
特に顎の下を撫でたり、揉んだりする。	あごでなでまわす
損失や犠牲のために、( 誰か )に弁償する。	損害の補償をする。
鼻緒で剃刀を研ぐ	ストラップで削る .
長めのモールス信号	モールス信号のうち、長いほうの信号。
首と上腕の間の体の部分、またはその下位の部分。	首から上腕にかけての部分。
雨や雹、雪が強く降ったり、雷や稲妻を伴う風が強く吹くこと。	雨やひょう、雪が激しく降り、風が強く、雷や稲妻がよく発生する。
停止子音時に溜まった圧力を解放すること.	停止子音咬合時に発生する圧力の終端強制解放.
(ぽたぽた落ちる	滴り落ちさせる。
